2,113587336,7020,IL1B,2050,,113594356
6,31543343,2769,TNF,4431,,31546112
12,125396190,3397,UBC,3444,,125399587
19,45409005,3647,APOE,3418,,45412652
7,55086724,188307,EGFR,3408,,55275031
6,43737945,16278,VEGFA,3144,,43754223
7,22766760,4861,IL6,3118,,22771621
19,41836227,23561,TGFB1,2860,,41859788
1,11845786,20374,MTHFR,2784,,11866160
6,152128813,295595,ESR1,2356,,152424408
6,32546546,11067,HLA-DRB1,2336,,32557613
4,103422485,115974,NFKB1,2242,,103538459
1,206940947,4892,IL10,2201,,206945839
17,61554421,21320,ACE,2137,,61575741
17,41196311,81189,BRCA1,2085,,41277500
2,113587336,7020,IL1B,2050,,113594356
14,105235686,26394,AKT1,2017,,105262080
21,27252860,290278,APP,1965,,27543138
14,62164339,50638,HIF1A,1917,,62214977
20,44637546,7654,MMP9,1889,,44645200
1,110230417,5950,GSTM1,1829,,110236367
12,6898637,31339,CD4,1806,,6929976
17,37844336,40579,ERBB2,1779,,37884915
1,186640943,8616,PTGS2,1765,,186649559
17,28521336,41650,SLC6A4,1738,,28562986
6,31321642,3380,HLA-B,1699,,31325022
9,21967750,7382,CDKN2A,1690,,21975132
X,66763873,186588,AR,1656,,66950461
3,41240941,40998,CTNNB1,1622,,41281939
7,87133178,209461,ABCB1,1612,,87342639
4,74606222,3211,CXCL8,1605,,74609433
3,12329348,146507,PPARG,1585,,12475855
7,150688143,23544,NOS3,1572,,150711687
22,22113946,108024,MAPK1,1557,,22221970
3,186560462,15790,ADIPOQ,1549,,186576252
9,120466452,13317,TLR4,1547,,120479769
17,40465342,75171,STAT3,1481,,40540513
12,68548549,4972,IFNG,1435,,68553521
1,159682078,2301,CRP,1415,,159684379
18,60790578,196035,BCL2,1384,,60986613
22,19929262,28236,COMT,1364,,19957498
12,48235319,63495,VDR,1358,,48298814
2,136871918,1895,CXCR4,1349,,136873813
10,89623194,108493,PTEN,1322,,89731687
6,32627240,7226,HLA-DQB1,1318,,32634466
3,46411632,6065,CCR5,1317,,46417697
16,68771192,98253,CDH1,1316,,68869445
12,25357722,46143,KRAS,1316,,25403865
12,102789644,84779,IGF1,1294,,102874423
6,29910246,3415,HLA-A,1287,,29913661
13,32889616,84193,BRCA2,1263,,32973809
11,67351065,3059,GSTP1,1260,,67354124
11,27676441,65885,BDNF,1244,,27742326
7,117120016,188702,CFTR,1239,,117308718
16,55515468,25135,MMP2,1220,,55540603
12,69202796,36528,MDM2,1215,,69239324
11,46740715,20343,F2,1209,,46761058
6,36646455,8661,CDKN1A,1208,,36655116
8,128748314,5366,MYC,1185,,128753680
7,140433812,190752,BRAF,1175,,140624564
1,169481191,74578,F5,1162,,169555769
7,127881330,16352,LEP,1147,,127897682
11,69455872,13370,CCND1,1128,,69469242
17,43971747,133952,MAPT,1111,,44105699
4,90645249,113101,SNCA,1104,,90758350
9,4985244,142939,JAK2,1089,,5128183
7,100770369,12178,SERPINE1,1085,,100782547
16,30128157,6473,MAPK3,1075,,30134630
5,1253286,41876,TERT,1056,,1295162
20,35973087,60748,SRC,1034,,36033835
6,35995453,83560,MAPK14,1033,,36079013
17,32582295,1925,CCL2,1011,,32584220
1,11166587,156021,MTOR,994,,11322608
4,154605403,22009,TLR2,993,,154627412
10,90750315,26503,FAS,985,,90776818
11,65421066,9377,RELA,978,,65430443
10,33189245,58048,ITGB1,942,,33247293
4,185548849,21780,CASP3,927,,185570629
19,10381516,15775,ICAM1,926,,10397291
5,132009677,8693,IL4,925,,132018370
19,44047463,32267,XRCC1,918,,44079730
1,59246462,3323,JUN,911,,59249785
11,108093558,146268,ATM,910,,108239826
11,113280316,65685,DRD2,905,,113346001
13,48877882,178144,RB1,903,,49056026
17,45331207,58870,ITGB3,900,,45390077
10,44865600,14945,CXCL12,900,,44880545
17,76210276,11440,BIRC5,892,,76221716
1,230838271,12065,AGT,889,,230850336
15,75011882,6069,CYP1A1,889,,75017951
14,64693750,67378,ESR2,882,,64761128
7,94927668,26216,PON1,863,,94953884
2,113875469,16124,IL1RN,858,,113891593
21,33031934,9309,SOD1,858,,33041243
2,204732510,6173,CTLA4,855,,204738683
5,148206155,2042,ADRB2,852,,148208197
12,53773978,36248,SP1,838,,53810226
22,42522500,4383,CYP2D6,830,,42526883
22,41488613,87468,EP300,825,,41576081
3,119540801,272463,GSK3B,823,,119813264
6,31236525,3388,HLA-C,822,,31239913
3,178866310,91571,PIK3CA,818,,178957881
5,142657495,125759,NR3C1,816,,142783254
6,26087508,7961,HFE,813,,26095469
1,32757707,41517,HDAC1,806,,32799224
2,113531491,11484,IL1A,779,,113542975
19,49458116,6403,BAX,778,,49464519
7,6414125,29473,RAC1,777,,6443598
4,55524094,82787,KIT,775,,55606881
12,12870203,5113,CDKN1B,769,,12875316
3,37034840,57497,MLH1,764,,37092337
11,35160416,93533,CD44,759,,35253949
10,49514681,132721,MAPK8,759,,49647402
3,148415657,45133,AGTR1,748,,148460790
16,50731049,35939,NOD2,744,,50766988
14,102547074,59012,HSP90AA1,742,,102606086
9,139388884,51354,NOTCH1,737,,139440238
11,112013973,20867,IL18,736,,112034840
10,96698414,50734,CYP2C9,734,,96749148
11,116706466,2200,APOA1,733,,116708666
11,102660640,8326,MMP1,728,,102668966
6,32605182,6247,HLA-DQA1,715,,32611429
1,11917520,1472,NPPB,710,,11918992
10,96522437,90525,CYP2C19,697,,96612962
22,35777059,13148,HMOX1,695,,35790207
1,226548391,47410,PARP1,693,,226595801
15,99191767,315992,IGF1R,693,,99507759
17,64298925,507937,PRKCA,690,,64806862
12,6058039,175802,VWF,680,,6233841
3,49396568,52962,RHOA,675,,49449530
19,45854648,19197,ERCC2,675,,45873845
3,10327433,7198,GHRL,673,,10334631
4,88896801,7762,SPP1,665,,88904563
7,116312443,125997,MET,664,,116438440
4,123372625,5025,IL2,659,,123377650
2,202098165,54269,CASP8,656,,202152434
16,3775055,155066,CREBBP,656,,3930121
10,43572516,50436,RET,652,,43622952
4,55944425,47337,KDR,651,,55991762
6,52051184,4252,IL17A,648,,52055436
17,73314156,87633,GRB2,647,,73401789
9,133710641,52421,ABL1,646,,133763062
5,112073555,108381,APC,646,,112181936
7,116165062,36177,CAV1,646,,116201239
11,2181008,1431,INS,646,,2182439
2,47630205,80162,MSH2,635,,47710367
20,4666796,15438,PRNP,631,,4682234
5,1392904,52639,SLC6A3,629,,1445543
7,99354582,27229,CYP3A4,628,,99381811
6,12290528,6899,EDN1,628,,12297427
17,26083791,43764,NOS2,624,,26127555
2,21224300,42645,APOB,623,,21266945
6,160100095,14265,SOD2,622,,160114360
11,5246695,1606,HBB,619,,5248301
10,62538088,8739,CDK1,618,,62546827
3,172223297,18000,TNFSF10,616,,172241297
10,54525139,6321,MBL2,615,,54531460
8,141668480,342932,PTK2,608,,142011412
2,191833761,45215,STAT1,608,,191878976
19,11200037,44468,LDLR,606,,11244505
13,20761603,5511,GJB2,603,,20767114
15,51500253,130542,CYP19A1,601,,51630795
1,196621007,95627,CFH,601,,196716634
8,19796581,28189,LPL,601,,19824770
2,203070902,32420,SUMO1,601,,203103322
X,49106896,14392,FOXP3,598,,49121288
11,532241,3326,HRAS,591,,535567
10,69644938,33209,SIRT1,591,,69678147
6,29794755,4144,HLA-G,590,,29798899
14,73603142,87257,PSEN1,590,,73690399
8,18248754,9969,NAT2,584,,18258723
12,56360552,6021,CDK2,584,,56366573
12,40618812,144274,LRRK2,582,,40763086
13,47405676,65535,HTR2A,580,,47471211
20,5095598,11670,PCNA,575,,5107268
5,140011312,1723,CD14,573,,140013035
20,463337,61145,CSNK2A1,572,,524482
3,10183318,12036,VHL,570,,10195354
2,178095030,33829,NFE2L2,569,,178128859
4,123747862,71528,FGF2,567,,123819390
11,119076985,101874,CBL,566,,119178859
7,81328323,71191,HGF,565,,81399514
5,170814707,19024,NPM1,563,,170833731
3,53195222,31511,PRKCD,562,,53226733
3,189349215,265853,TP63,560,,189615068
11,100900354,100190,PGR,557,,101000544
11,102706527,7893,MMP3,556,,102714420
9,107543283,147244,ABCA1,555,,107690527
17,48261456,17544,COL1A1,550,,48279000
11,637304,3401,DRD4,550,,640705
1,172628147,7865,FASLG,549,,172636012
10,135340866,11754,CYP2E1,548,,135352620
17,34198495,8882,CCL5,548,,34207377
15,67418053,69480,SMAD3,543,,67487533
20,32263291,10919,E2F1,542,,32274210
12,112856701,91021,PTPN11,541,,112947722
7,45951843,9028,IGFBP3,540,,45960871
6,32148744,3355,AGER,539,,32152099
20,30252254,58647,BCL2L1,533,,30310901
1,155158299,4407,MUC1,532,,155162706
6,161768589,1380245,PARK2,532,,163148834
1,156095907,13973,LMNA,529,,156109880
7,99245811,31838,CYP3A5,525,,99277649
4,110834039,100196,EGF,523,,110934235
4,89011415,141059,ABCG2,522,,89152474
12,6437922,13361,TNFRSF1A,519,,6451283
16,56995834,21922,CETP,517,,57017756
5,132387661,53048,HSPA4,515,,132440709
6,31540070,2030,LTA,513,,31542100
2,234668918,13027,UGT1A1,513,,234681945
18,48556582,54829,SMAD4,505,,48611411
5,67588395,9254,PIK3R1,505,,67597649
2,216225162,75629,FN1,502,,216300791
5,131993864,2937,IL13,499,,131996801
19,7112265,182048,INSR,497,,7294313
10,114710008,217428,TCF7L2,496,,114927436
X,154064063,186935,F8,492,,154250998
1,3607235,45530,TP73,491,,3652765
13,28959687,109578,FLT1,485,,29069265
1,65886334,214777,LEPR,484,,66101111
21,36160097,100890,RUNX1,481,,36260987
11,2150341,9863,IGF2,481,,2160204
20,44746892,11492,CD40,480,,44758384
14,35870715,3245,NFKBIA,479,,35873960
22,39473009,10739,APOBEC3G,479,,39483748
13,31032052,8050,HMGB1,477,,31040102
19,14202506,26053,PRKACA,477,,14228559
X,47441689,4501,TIMP1,477,,47446190
13,28577410,97319,FLT3,476,,28674729
19,45910590,16587,ERCC1,475,,45927177
6,111981534,213121,FYN,474,,112194655
18,657603,15896,TYMS,472,,673499
17,56347216,11080,MPO,471,,56358296
3,52255095,5084,TLR9,470,,52260179
3,9791627,7462,OGG1,469,,9799089
10,75670858,6400,PLAU,469,,75677258
16,226649,872,HBA1,467,,227521
10,131265447,300437,MGMT,466,,131565884
16,53737874,410505,FTO,466,,54148379
1,94994731,12682,F3,465,,95007413
8,119935795,28588,TNFRSF11B,465,,119964383
7,150642043,33359,KCNH2,464,,150675402
11,32409321,47760,WT1,463,,32457081
22,24236564,845,MIF,462,,24237409
4,3076407,169280,HTT,459,,3245687
12,112204690,43099,ALDH2,454,,112247789
2,227596032,67474,IRS1,452,,227663506
10,129894924,29544,MKI67,452,,129924468
16,69743303,17230,NQO1,451,,69760533
6,114257319,35040,HDAC2,451,,114292359
2,187464931,80698,ITGAV,450,,187545629
X,43514154,91917,MAOA,449,,43606071
9,127997126,6540,HSPA5,448,,128003666
10,104590287,7003,CYP17A1,445,,104597290
6,31783290,2429,HSPA1A,445,,31785719
15,40987377,36979,RAD51,444,,41024356
1,22379119,40317,CDC42,443,,22419436
3,12625099,80601,RAF1,442,,12705700
22,29083730,54092,CHEK2,441,,29137822
2,208394615,76098,CREB1,440,,208470713
16,23690092,11596,PLK1,438,,23701688
15,74287013,48704,PML,437,,74335717
X,153295685,67503,MECP2,436,,153363188
14,94843083,12070,SERPINA1,436,,94855153
14,20923289,2642,APEX1,435,,20925931
20,54944444,22949,AURKA,434,,54967393
8,48685668,187075,PRKDC,433,,48872743
19,6677845,42848,C3,431,,6720693
22,46546498,93155,PPARA,430,,46639653
11,36505316,26547,TRAF6,430,,36531863
1,32739711,12057,LCK,429,,32751768
13,43148290,33859,TNFSF11,428,,43182149
X,146993468,39179,FMR1,426,,147032647
2,38294745,8578,CYP1B1,425,,38303323
10,123237843,120129,FGFR2,425,,123357972
1,101185195,19406,VCAM1,425,,101204601
20,6748744,12181,BMP2,423,,6760925
7,148504463,76978,EZH2,421,,148581441
3,38589552,101611,SCN5A,419,,38691163
17,57918626,72,MIR21,419,,57918698
5,158741790,15691,IL12B,418,,158757481
18,29171729,7257,TTR,416,,29178986
11,2466220,404120,KCNQ1,413,,2870340
7,5566778,3454,ACTB,408,,5570232
4,23793643,98057,PPARGC1A,407,,23891700
3,46395234,7179,CCR2,407,,46402413
4,186990308,15944,TLR3,405,,187006252
19,44150246,24252,PLAUR,404,,44174498
X,135730335,12214,CD40LG,403,,135742549
11,122928199,4844,HSPA8,402,,122933043
1,114356432,57949,PTPN22,401,,114414381
6,31371343,11749,MICA,400,,31383092
18,45359465,98052,SMAD2,398,,45457517
X,122994016,53813,XIAP,397,,123047829
13,113760101,14894,F7,394,,113774995
9,93563961,96881,SYK,394,,93660842
10,6052656,51677,IL2RA,392,,6104333
1,154934773,8450,SHC1,391,,154943223
20,57466357,19894,GNAS,389,,57486251
7,106505722,43701,PIK3CG,388,,106549423
6,132269316,3202,CTGF,386,,132272518
14,55595934,16214,LGALS3,385,,55612148
1,150547026,5188,MCL1,385,,150552214
6,154360236,93253,OPRM1,385,,154453489
15,75041183,7758,CYP1A2,384,,75048941
8,42128819,61352,IKBKB,384,,42190171
4,76942268,2421,CXCL10,383,,76944689
21,46305868,35097,ITGB2,383,,46340965
17,7387697,30238,POLR2A,383,,7417935
10,101948054,41313,CHUK,382,,101989367
16,27325229,50870,IL4R,382,,27376099
10,17270257,9335,VIM,382,,17279592
19,7733971,1369,RETN,381,,7735340
14,104163953,17870,XRCC3,379,,104181823
4,1795038,15561,FGFR3,377,,1810599
1,11072678,12871,TARDBP,377,,11085549
9,101867370,49103,TGFBR1,376,,101916473
12,58141509,4721,CDK4,375,,58146230
1,161475204,14156,FCGR2A,375,,161489360
14,23305741,11067,MMP14,374,,23316808
7,75931874,1740,HSPB1,373,,75933614
15,39873279,17842,THBS1,373,,39891121
17,61994552,1660,GH1,372,,61996212
1,169691780,11440,SELE,372,,169703220
6,159186772,53684,EZR,371,,159240456
6,121756722,14168,GJA1,370,,121770890
3,30647993,87640,TGFBR2,368,,30735633
1,43391045,33802,SLC2A1,367,,43424847
8,90945563,51336,NBN,364,,90996899
9,35056064,16675,VCP,364,,35072739
20,43029895,31590,HNF4A,363,,43061485
1,12227059,42218,TNFRSF1B,363,,12269277
4,74269955,17246,ALB,362,,74287201
2,209100950,18232,IDH1,362,,209119182
6,31132113,2834,POU5F1,362,,31134947
3,142168076,129592,ATR,361,,142297668
12,6950017,6542,GNB3,361,,6956559
19,572453,11040,BSG,357,,583493
X,31137344,2220382,DMD,357,,33357726
8,27454433,17895,CLU,356,,27472328
11,118307204,90335,KMT2A,356,,118397539
4,55095263,69149,PDGFRA,356,,55164412
12,121416370,23944,HNF1A,356,,121440314
11,125495030,51120,CHEK1,355,,125546150
9,130548304,4748,CDK9,354,,130553052
17,42449548,17421,ITGA2B,354,,42466969
5,52285155,105454,ITGA2,353,,52390609
9,130911708,4026,LCN2,353,,130915734
9,137218308,114124,RXRA,352,,137332432
8,101930803,34418,YWHAZ,352,,101965221
7,17338275,47500,AHR,350,,17385775
20,23614293,4392,CST3,350,,23618685
14,75745480,3457,FOS,350,,75748937
22,42017345,42707,XRCC6,350,,42060052
6,88849584,26183,CNR1,349,,88875767
17,29421944,282751,NF1,349,,29704695
9,139780964,40103,TRAF2,349,,139821067
8,32453343,172132,NRG1,348,,32625475
11,116660085,3051,APOA5,347,,116663136
19,33790839,2631,CEBPA,345,,33793470
8,38268655,57697,FGFR1,345,,38326352
19,10244019,61792,DNMT1,344,,10305811
1,236958580,108701,MTR,344,,237067281
X,153770454,22807,IKBKG,343,,153793261
20,48807119,2108,CEBPB,342,,48809227
19,7804880,7584,CD209,342,,7812464
22,23522551,137673,BCR,341,,23660224
4,155484131,9784,FGB,340,,155493915
5,179233387,31690,SQSTM1,340,,179265077
7,44836234,6488,PPIA,338,,44842722
17,38465422,48473,RARA,337,,38513895
5,36152144,31998,SKP2,337,,36184142
3,50367216,11151,RASSF1,337,,50378367
16,23847299,384633,PRKCB,335,,24231932
16,1359627,17392,UBE2I,335,,1377019
2,216974019,96997,XRCC5,334,,217071016
5,68462836,11234,CCNB1,333,,68474070
1,226013001,20261,EPHX1,333,,226033262
19,51358170,5850,KLK3,332,,51364020
1,15817895,33045,CASP9,332,,15850940
4,15969848,115746,PROM1,332,,16085594
1,229566992,2851,ACTA1,331,,229569843
15,60639349,50836,ANXA2,330,,60690185
14,90863326,11293,CALM1,330,,90874619
19,30302900,12324,CCNE1,330,,30315224
7,155594933,10034,SHH,330,,155604967
2,29415639,728838,ALK,329,,30144477
3,121902529,102815,CASR,328,,122005344
13,41129800,110934,FOXO1,327,,41240734
6,33043702,13771,HLA-DPB1,327,,33057473
11,102391238,10246,MMP7,327,,102401484
11,116700623,3164,APOC3,326,,116703787
6,108882068,123903,FOXO3,326,,109005971
17,38544772,29430,TOP2A,326,,38574202
12,57522281,84844,LRP1,325,,57607125
6,170863420,18538,TBP,325,,170881958
11,77033059,152049,PAK1,324,,77185108
2,198351307,13333,HSPD1,323,,198364640
5,137801180,3824,EGR1,322,,137805004
9,130577290,39762,ENG,322,,130617052
6,45296053,222766,RUNX2,321,,45518819
4,142557748,97392,IL15,321,,142655140
8,56792385,132621,LYN,321,,56925006
5,149493401,42021,PDGFRB,318,,149535422
9,136287119,37406,ADAMTS13,318,,136324525
19,39734271,1340,IFNL3,318,,39735611
2,242792032,9026,PDCD1,317,,242801058
19,11071597,101361,SMARCA4,316,,11172958
7,148395932,102270,CUL1,316,,148498202
17,76352857,3303,SOCS3,316,,76356160
1,169558087,41290,SELP,314,,169599377
17,76849058,72414,TIMP2,314,,76921472
3,113847498,50401,DRD3,313,,113897899
1,161511549,8344,FCGR3A,312,,161519893
X,153576899,26107,FLNA,312,,153603006
4,177604684,109215,VEGFC,312,,177713899
7,105888731,36907,NAMPT,312,,105925638
10,115803805,2862,ADRB1,311,,115806667
20,39766160,38197,PLCG1,310,,39804357
15,66679210,104672,MAP2K1,310,,66783882
9,22002901,6411,CDKN2B,308,,22009312
2,128175995,10827,PROC,308,,128186822
7,80267831,35903,CD36,307,,80303734
7,100318422,2901,EPO,306,,100321323
8,42032235,33007,PLAT,306,,42065242
2,111878490,47532,BCL2L11,306,,111926022
14,54416454,7126,BMP4,305,,54423580
11,17406795,3411,KCNJ11,305,,17410206
18,58038563,1438,MC4R,304,,58040001
10,60094738,35775,UBE2D1,304,,60130513
16,31102162,4158,VKORC1,304,,31106320
12,117645946,153661,NOS1,303,,117799607
2,46524540,89302,EPAS1,301,,46613842
1,2005085,111749,PRKCZ,301,,2116834
4,100227543,15056,ADH1B,300,,100242599
8,6357174,63610,ANGPT2,300,,6420784
10,22610138,10276,BMI1,300,,22620414
20,36755788,38043,TGM2,300,,36793831
2,61705068,60350,XPO1,300,,61765418
8,37820513,3671,ADRB3,299,,37824184
3,14186647,33525,XPC,299,,14220172
12,49082240,28541,CCNT1,298,,49110781
19,8023456,47073,ELAVL1,298,,8070529
5,141000442,15981,HDAC3,298,,141016423
21,44473300,22740,CBS,297,,44496040
2,204571197,32439,CD28,297,,204603636
19,50162825,6307,IRF3,297,,50169132
2,162848754,82298,DPP4,296,,162931052
5,63255874,2245,HTR1A,296,,63258119
9,21077103,859,IFNB1,296,,21077962
2,48010220,23872,MSH6,295,,48034092
7,19155090,2205,TWIST1,295,,19157295
15,45003684,6673,B2M,294,,45010357
6,161123224,51861,PLG,294,,161175085
16,2097895,40826,TSC2,294,,2138721
5,76011867,19738,F2R,293,,76031605
11,118964584,1593,H2AFX,293,,118966177
3,159706622,7184,IL12A,292,,159713806
16,3292027,14600,MEFV,292,,3306627
15,58724174,136899,LIPC,291,,58861073
12,7060433,10046,PTPN6,291,,7070479
14,81421868,190778,TSHR,291,,81612646
12,56473891,5510,ERBB3,290,,56479401
2,201983268,54143,CFLAR,290,,202037411
12,54789044,24006,ITGA5,289,,54813050
1,115247084,12431,NRAS,289,,115259515
1,8021713,23629,PARK7,289,,8045342
22,36677322,106790,MYH9,288,,36784112
2,37332283,51907,EIF2AK2,288,,37384190
8,143991974,7285,CYP11B2,287,,143999259
2,45879042,536087,PRKCE,287,,46415129
21,48018530,6505,S100B,287,,48025035
3,133464976,32874,TF,287,,133497850
10,103113789,203289,BTRC,287,,103317078
22,38071612,4197,LGALS1,285,,38075809
3,20081523,114373,KAT2B,285,,20195896
17,8108048,5896,AURKB,285,,8113944
13,108921976,38856,TNFSF13B,285,,108960832
4,155504277,7641,FGA,284,,155511918
2,9628614,67335,ADAM17,284,,9695949
15,48700502,237483,FBN1,283,,48937985
17,42422453,8021,GRN,282,,42430474
3,181429711,2512,SOX2,281,,181432223
11,117156401,9985,BACE1,281,,117166386
X,153759604,15629,G6PD,280,,153775233
1,65298905,133347,JAK1,280,,65432252
20,46130600,155021,NCOA3,280,,46285621
11,10326526,2423,ADM,279,,10328949
19,9945882,14483,PIN1,279,,9960365
17,4835569,2756,GP1BA,278,,4838325
3,38179968,4544,MYD88,278,,38184512
2,98330030,26293,ZAP70,278,,98356323
12,6644384,3157,GAPDH,277,,6647541
19,1205797,22637,STK11,277,,1228434
11,14990047,3785,CALCA,276,,14993832
11,34460471,33136,CAT,276,,34493607
16,72088490,6465,HP,276,,72094955
6,31973358,3354,CYP21A2,275,,31976712
1,155204238,6831,GBA,274,,155211069
5,7869216,32019,MTRR,274,,7901235
5,133492081,20643,SKP1,273,,133512724
6,6144310,176614,F13A1,272,,6320924
1,154377668,64258,IL6R,272,,154441926
16,16043433,193497,ABCC1,272,,16236930
2,232319458,9747,NCL,272,,232329205
17,57970406,57380,RPS6KB1,272,,58027786
19,35773248,2797,HAMP,269,,35776045
5,42423876,298104,GHR,267,,42721980
18,18529702,162110,ROCK1,267,,18691812
3,195776154,32878,TFRC,267,,195809032
16,11348273,1766,SOCS1,267,,11350039
1,55505148,25378,PCSK9,267,,55530526
5,76114801,16339,F2RL1,266,,76131140
6,91223291,73729,MAP3K7,266,,91297020
16,730110,2658,STUB1,266,,732768
8,11700033,25626,CTSB,265,,11725659
17,17714662,25663,SREBF1,265,,17740325
16,89984286,3099,MC1R,264,,89987385
19,13049413,5891,CALR,263,,13055304
12,131356538,5685,RAN,263,,131362223
22,24129117,47588,SMARCB1,263,,24176705
20,48599512,5908,SNAI1,263,,48605420
17,40439884,24076,STAT5A,263,,40463960
12,4477392,11502,FGF23,262,,4488894
8,22877647,49053,TNFRSF10B,262,,22926700
22,41347350,21669,RBX1,262,,41369019
12,48366747,31538,COL2A1,261,,48398285
3,59733003,1504132,FHIT,261,,61237135
7,94023872,36672,COL1A2,260,,94060544
4,99792834,57409,EIF4E,260,,99850243
1,43147905,21569,YBX1,260,,43169474
12,121570630,53724,P2RX7,260,,121624354
11,73685715,8174,UCP2,260,,73693889
2,9724095,47089,YWHAQ,260,,9771184
8,27179918,136990,PTK2B,259,,27316908
16,88709696,7796,CYBA,258,,88717492
9,21440452,863,IFNA1,258,,21441315
8,39771327,14982,IDO1,258,,39786309
1,156785541,66101,NTRK1,258,,156851642
1,208059882,24801,CD34,257,,208084683
17,49230919,8531,NME1,257,,49239450
5,133532147,29803,PPP2CA,257,,133561950
20,39657457,95669,TOP1,257,,39753126
3,187439164,15121,BCL6,256,,187454285
19,17513747,2710,BST2,256,,17516457
5,131409484,2379,CSF2,256,,131411863
11,128328655,128798,ETS1,256,,128457453
9,5450502,20065,CD274,256,,5470567
1,247579457,32949,NLRP3,256,,247612406
8,30890777,140500,WRN,255,,31031277
16,31191430,14762,FUS,254,,31206192
6,35310334,85634,PPARD,254,,35395968
5,70220767,28071,SMN1,254,,70248838
2,102759235,37099,IL1R1,253,,102796334
17,15994883,103070,NCOR1,253,,16097953
2,16080559,6570,MYCN,251,,16087129
1,201328135,18693,TNNT2,251,,201346828
5,138940750,67268,UBE2D2,251,,139008018
7,150750898,4154,CDK5,250,,150755052
10,101542354,69595,ABCC2,250,,101611949
20,31350190,46972,DNMT3B,250,,31397162
7,24323806,7678,NPY,250,,24331484
1,153330329,3174,S100A9,250,,153333503
1,67632168,93482,IL23R,250,,67725650
10,104154334,7952,NFKB2,249,,104162286
2,25383721,7999,POMC,249,,25391720
1,198608097,56203,PTPRC,249,,198664300
17,42325757,19745,SLC4A1,249,,42345502
17,1247833,55723,YWHAE,249,,1303556
12,10524951,17702,KLRK1,249,,10542653
11,111779343,4594,CRYAB,248,,111783937
3,49394603,1430,GPX1,248,,49396033
2,218990012,11964,CXCR2,248,,219001976
10,54074040,3377,DKK1,248,,54077417
22,24823529,14799,ADORA2A,247,,24838328
13,113777112,26731,F10,247,,113803843
20,43514239,22936,YWHAB,247,,43537175
12,57489186,16010,STAT6,246,,57505196
6,138188324,16127,TNFAIP3,246,,138204451
1,115828536,52321,NGF,245,,115880857
7,44183869,45153,GCK,244,,44229022
2,20400557,24637,SDC1,244,,20425194
14,100705101,40270,YY1,244,,100745371
14,95552564,47276,DICER1,244,,95599840
4,122737598,7558,CCNA2,243,,122745156
11,1773981,11241,CTSD,243,,1785222
6,30457182,4800,HLA-E,243,,30461982
11,64570985,7203,MEN1,243,,64578188
22,39619363,21697,PDGFB,243,,39641060
4,84213613,42421,HPSE,243,,84256034
17,45728561,32443,KPNB1,242,,45761004
3,154797435,104083,MME,242,,154901518
16,31271287,72926,ITGAM,241,,31344213
9,87284594,146029,NTRK2,241,,87430623
6,18128544,26852,TPMT,241,,18155396
13,52506805,78825,ATP7B,240,,52585630
12,13714409,418613,GRIN2B,240,,14133022
9,113006091,12829,TXN,240,,113018920
3,119499330,38002,NR1I2,240,,119537332
1,25226001,65500,RUNX3,239,,25291501
20,49126857,74443,PTPN1,239,,49201300
10,95351592,9401,RBP4,239,,95360993
4,123533782,8430,IL21,239,,123542212
19,41497203,27098,CYP2B6,238,,41524301
17,66031717,11258,KPNA2,238,,66042975
12,120648241,55333,PXN,238,,120703574
5,180663927,6979,GNB2L1,238,,180670906
9,32455299,71023,DDX58,238,,32526322
19,41349442,6910,CYP2A6,237,,41356352
17,62396776,10307,PECAM1,237,,62407083
19,40736223,55079,AKT2,236,,40791302
21,39751949,281755,ERG,236,,40033704
17,47572654,19728,NGFR,236,,47592382
17,40962149,14184,BECN1,236,,40976333
1,20959947,18057,PINK1,236,,20978004
6,33540322,7748,BAK1,235,,33548070
12,125262173,86346,SCARB1,235,,125348519
6,32407618,5208,HLA-DRA,235,,32412826
5,131817300,9165,IRF1,235,,131826465
15,75661719,86405,SIN3A,235,,75748124
19,55663135,5965,TNNI3,233,,55669100
1,152274650,23029,FLG,232,,152297679
11,6624937,7168,ILK,232,,6632105
6,160952514,134893,LPA,232,,161087407
11,70049268,4240,FADD,231,,70053508
12,124808956,243054,NCOR2,231,,125052010
10,8096666,20498,GATA3,230,,8117164
12,54674473,4557,HNRNPA1,230,,54679030
18,46446222,30859,SMAD7,230,,46477081
11,31806339,26562,PAX6,230,,31832901
6,3064121,51300,RIPK1,230,,3115421
17,4613788,11007,ARRB2,229,,4624795
12,103232103,79278,PAH,229,,103311381
17,1733272,69576,RPA1,229,,1802848
17,16284106,1953,UBB,229,,16286059
8,108261709,248574,ANGPT1,228,,108510283
X,100604434,36778,BTK,228,,100641212
11,61066918,33766,DDB1,228,,61100684
17,70117160,5400,SOX9,228,,70122560
17,40351194,77230,STAT5B,228,,40428424
4,103715539,33566,UBE2D3,228,,103749105
19,15270443,41349,NOTCH3,227,,15311792
17,56078279,6428,SRSF1,227,,56084707
10,45869613,71954,ALOX5,226,,45941567
11,112831968,317190,NCAM1,226,,113149158
6,22287472,10258,PRL,226,,22297730
9,125133283,24699,PTGS1,226,,125157982
13,28536204,7301,CDX2,225,,28543505
17,57697049,77268,CLTC,225,,57774317
3,39304984,17780,CX3CR1,225,,39322764
X,113818550,326074,HTR2C,225,,114144624
11,13513591,3976,PTH,225,,13517567
12,66218239,141832,HMGA2,225,,66360071
18,25530926,226484,CDH2,224,,25757410
14,25100160,3315,GZMB,224,,25103475
17,34415602,1904,CCL3,224,,34417506
5,151040656,25959,SPARC,224,,151066615
5,159912358,99,MIR146A,224,,159912457
7,92234234,231707,CDK6,223,,92465941
6,74225472,5283,EEF1A1,223,,74230755
11,102813720,12743,MMP13,223,,102826463
22,29999544,95045,NF2,223,,30094589
5,40759480,38817,PRKAA1,223,,40798297
17,3468739,31597,TRPV1,223,,3500336
15,91260557,98135,BLM,222,,91358692
2,212240441,1162911,ERBB4,221,,213403352
17,80036213,19893,FASN,221,,80056106
9,86582997,12700,HNRNPK,221,,86595697
17,73163824,15274,SUMO2,221,,73179098
11,3876932,237508,STIM1,221,,4114440
20,23026269,4032,THBD,221,,23030301
11,18501857,46646,TSG101,221,,18548503
X,48660422,22970,HDAC6,221,,48683392
16,222845,864,HBA2,220,,223709
15,89859535,18491,POLG,220,,89878026
17,7533411,3290,SHBG,220,,7536701
4,155525285,8675,FGG,219,,155533960
2,182321618,82037,ITGA4,219,,182403655
2,166845669,84480,SCN1A,219,,166930149
8,18067611,13587,NAT1,218,,18081198
3,46477495,27666,LTF,218,,46505161
2,24807345,186225,NCOA1,218,,24993570
12,21284127,108603,SLCO1B1,218,,21392730
17,1324646,34915,CRK,217,,1359561
11,101981191,122963,YAP1,217,,102104154
6,31633656,4191,CSNK2B,216,,31637847
7,45927958,5309,IGFBP1,216,,45933267
3,24158644,377669,THRB,216,,24536313
21,26946291,65,MIR155,216,,26946356
5,174867674,3489,DRD1,215,,174871163
2,49189295,192371,FSHR,215,,49381666
15,56119116,90213,NEDD4,215,,56209329
1,153516097,2185,S100A4,215,,153518282
9,15464064,46953,PSIP1,215,,15511017
9,75766646,18664,ANXA1,214,,75785310
2,162999378,9536,GCG,214,,163008914
6,30687977,5226,TUBB,214,,30693203
11,64037299,14877,BAD,213,,64052176
15,32322685,139699,CHRNA7,213,,32462384
X,153275956,9386,IRAK1,213,,153285342
4,146403956,76369,SMAD1,213,,146480325
11,47279467,11117,NR1H3,213,,47290584
12,72332625,93596,TPH2,213,,72426221
11,2398546,20103,CD81,212,,2418649
1,45794913,11229,MUTYH,212,,45806142
20,30193085,1232,ID1,211,,30194317
5,35856976,22729,IL7R,211,,35879705
11,94150468,76572,MRE11A,211,,94227040
1,171604556,17217,MYOC,211,,171621773
15,72491369,32596,PKM,211,,72523965
2,179390716,281434,TTN,211,,179672150
7,30951308,13824,AQP1,210,,30965132
6,33286334,4459,DAXX,210,,33290793
7,73442118,42118,ELN,210,,73484236
14,92524895,48070,ATXN3,210,,92572965
17,79476996,2896,ACTG1,209,,79479892
3,186330849,8258,AHSG,209,,186339107
11,65622284,3520,CFL1,209,,65625804
8,7752086,2152,DEFB4A,209,,7754238
8,145515250,23139,HSF1,209,,145538389
12,21525801,7113,IAPP,209,,21532914
9,136130562,20068,ABO,208,,136150630
19,2249277,2795,AMH,208,,2252072
3,48264836,2145,CAMP,208,,48266981
1,203148058,7864,CHI3L1,208,,203155922
19,852208,4038,ELANE,208,,856246
6,26020717,469,HIST1H3A,208,,26021186
12,2162415,644700,CACNA1C,207,,2807115
19,38924339,153865,RYR1,207,,39078204
1,218518625,99336,TGFB2,207,,218617961
20,55743808,97899,BMP7,206,,55841707
11,57529233,57419,CTNND1,206,,57586652
X,138612894,32723,F9,206,,138645617
6,135502452,37859,MYB,206,,135540311
1,153362507,1157,S100A8,206,,153363664
6,32812985,8763,TAP1,206,,32821748
22,33196801,62227,TIMP3,206,,33259028
19,6772678,84699,VAV1,206,,6857377
1,228612545,481,HIST3H3,206,,228613026
11,102217912,31489,BIRC2,205,,102249401
15,75074424,21115,CSK,205,,75095539
11,70244611,38079,CTTN,205,,70282690
7,41724711,17995,INHBA,205,,41742706
X,153126968,14532,L1CAM,205,,153141500
2,173292282,78901,ITGA6,204,,173371183
4,41258897,11549,UCHL1,204,,41270446
3,55499742,15684,WNT5A,204,,55515426
9,110247132,4869,KLF4,204,,110252001
11,102188180,21955,BIRC3,203,,102210135
11,104896236,9648,CASP1,203,,104905884
22,29663997,32518,EWSR1,203,,29696515
12,10310898,13892,OLR1,203,,10324790
2,239969863,352780,HDAC4,203,,240322643
4,153242409,61255,FBXW7,203,,153303664
15,58887402,154775,ADAM10,202,,59042177
17,38710021,11715,CCR7,202,,38721736
13,103498190,30161,ERCC5,202,,103528351
X,48644981,7736,GATA1,202,,48652717
12,57853917,12130,GLI1,202,,57866047
6,34204576,9432,HMGA1,202,,34214008
1,11905766,2074,NPPA,202,,11907840
1,204123943,11522,REN,202,,204135465
6,31795511,2520,HSPA1B,201,,31798031
6,44214694,6931,HSP90AB1,201,,44221625
6,136878186,235470,MAP3K5,201,,137113656
17,1665218,15650,SERPINF1,201,,1680868
11,18042083,20252,TPH1,201,,18062335
X,37639269,33445,CYBB,200,,37672714
16,2138710,47189,PKD1,200,,2185899
X,12885201,23279,TLR7,200,,12908480
17,43861645,51549,CRHR1,199,,43913194
X,70835765,2602,CXCR3,199,,70838367
12,53342842,3843,KRT18,199,,53346685
14,23881946,22949,MYH7,199,,23904895
17,64208146,17410,APOH,198,,64225556
19,11487880,7138,EPOR,198,,11495018
5,55230924,59897,IL6ST,198,,55290821
5,179673027,46044,MAPK9,198,,179719071
11,65479472,7605,KAT5,198,,65487077
9,35673914,7240,CA9,197,,35681154
9,98205263,65568,PTCH1,197,,98270831
11,2185158,7877,TH,197,,2193035
15,29991570,123136,TJP1,197,,30114706
4,2845583,86219,ADD1,196,,2931802
4,100257648,16554,ADH1C,196,,100274202
1,209859524,48771,HSD11B1,196,,209908295
15,91411821,14867,FURIN,196,,91426688
22,18216905,40356,BID,195,,18257261
1,43824625,4248,CDC20,195,,43828873
12,11802787,245538,ETV6,195,,12048325
9,80331189,315176,GNAQ,195,,80646365
20,30639990,49667,HCK,195,,30689657
17,47481409,10811,PHB,195,,47492220
17,66508519,21051,PRKAR1A,195,,66529570
2,31749655,56385,SRD5A2,195,,31806040
19,1609288,40998,TCF3,195,,1650286
16,75262927,36978,BCAR1,195,,75299905
X,15579155,41037,ACE2,195,,15620192
10,115439427,51241,CASP7,194,,115490668
8,37888019,29864,EIF4EBP1,194,,37917883
5,131877135,2079,IL5,194,,131879214
8,23048969,33711,TNFRSF10A,194,,23082680
12,9220303,48255,A2M,193,,9268558
10,112836789,3873,ADRA2A,193,,112840662
3,165490690,64570,BCHE,193,,165555260
2,25455829,108955,DNMT3A,193,,25564784
1,16450831,31773,EPHA2,193,,16482604
4,120980578,7435,MAD2L1,193,,120988013
15,90627210,18576,IDH2,192,,90645786
3,157154579,6838,PTX3,192,,157161417
3,25469753,169669,RARB,192,,25639422
16,57406372,12588,CX3CL1,192,,57418960
9,27109138,121038,TEK,192,,27230176
5,135364583,34924,TGFBI,192,,135399507
X,48542185,7632,WAS,192,,48549817
8,79645006,72752,IL7,191,,79717758
17,73717407,36492,ITGB4,191,,73753899
6,134490383,148813,SGK1,191,,134639196
9,6215785,42198,IL33,191,,6257983
1,173872941,13575,SERPINC1,190,,173886516
11,68080076,136667,LRP5,190,,68216743
16,28616907,4458,SULT1A1,190,,28621365
12,104324111,17597,HSP90B1,190,,104341708
12,8754761,10702,AICDA,190,,8765463
X,115301957,4268,AGTR2,189,,115306225
2,189839098,38374,COL3A1,189,,189877472
1,207494816,39495,CD55,189,,207534311
12,2966846,19475,FOXM1,189,,2986321
9,127243514,26185,NR5A1,189,,127269699
6,32485153,12853,HLA-DRB5,189,,32498006
9,117781853,98683,TNC,189,,117880536
3,69985750,31738,MITF,189,,70017488
6,46672052,31378,PLA2G7,189,,46703430
5,131892615,87698,RAD50,189,,131980313
19,59055835,6247,TRIM28,189,,59062082
8,67955314,19248,COPS5,189,,67974562
5,179125929,32710,CANX,188,,179158639
1,167399876,87971,CD247,188,,167487847
3,121774208,65780,CD86,188,,121839988
10,6469104,153159,PRKCQ,188,,6622263
2,188343305,75927,TFPI,188,,188419232
22,21903735,74588,UBE2L3,188,,21978323
13,113863818,55574,CUL4A,188,,113919392
3,33840062,71137,PDCD6IP,188,,33911199
4,15779887,74979,CD38,187,,15854866
7,107301079,57173,SLC26A4,187,,107358252
1,151227196,12758,PSMD4,187,,151239954
1,231762560,414459,DISC1,187,,232177019
16,58191811,39971,CSNK2A2,186,,58231782
4,72607410,42669,GC,186,,72650079
17,42987034,5886,GFAP,186,,42992920
17,48133331,34518,ITGA3,186,,48167849
2,48913912,68968,LHCGR,186,,48982880
14,24686056,15520,NEDD8,186,,24701576
8,101715143,19172,PABPC1,186,,101734315
11,5684424,21915,TRIM5,186,,5706339
19,13317255,300019,CACNA1A,185,,13617274
2,175936977,95957,ATF2,185,,176032934
12,53290970,29283,KRT8,185,,53320253
5,86564069,123674,RASA1,185,,86687743
10,81697495,11366,SFTPD,185,,81708861
11,17414431,83961,ABCC8,185,,17498392
2,70674411,106736,TGFA,185,,70781147
19,10596795,16686,KEAP1,185,,10613481
12,122692208,18907,DIABLO,185,,122711115
1,154554533,45923,ADAR,184,,154600456
2,203241049,191425,BMPR2,184,,203432474
X,70443055,2010,GJB1,184,,70445065
10,124221040,53384,HTRA1,184,,124274424
13,33590570,49712,KL,184,,33640282
20,43248159,32240,ADA,183,,43280399
4,74301935,19567,AFP,183,,74321502
1,204159468,6151,KISS1,183,,204165619
3,93591880,101054,PROS1,183,,93692934
14,36985603,3827,NKX2-1,183,,36989430
15,43699411,85943,TP53BP1,183,,43785354
9,100437190,22501,XPA,183,,100459691
13,110406183,32731,IRS2,183,,110438914
19,18496769,3218,GDF15,183,,18499987
18,24432001,13807,AQP4,182,,24445808
13,46627321,51890,CPB2,182,,46679211
1,207669472,145638,CR1,182,,207815110
1,110453232,20384,CSF1,182,,110473616
9,140033608,29606,GRIN1,182,,140063214
19,55327892,14341,KIR3DL1,182,,55342233
1,207925382,43479,CD46,182,,207968861
11,18287771,3752,SAA1,182,,18291523
1,21835850,69055,ALPL,181,,21904905
14,93389444,12194,CHGA,181,,93401638
3,184032282,20864,EIF4G1,181,,184053146
18,74690788,38267,MBP,181,,74729055
12,88886569,87681,KITLG,181,,88974250
14,75408532,13935,PGF,181,,75422467
12,28115253,9663,PTHLH,181,,28124916
1,169659805,21038,SELL,181,,169680843
2,174771186,57761,SP3,181,,174828947
10,33486546,137287,NRP1,181,,33623833
Y,21152525,2275,CD24,181,,21154800
20,10618331,36363,JAG1,180,,10654694
14,50359735,4037,ARF6,180,,50363772
14,103243815,134022,TRAF3,180,,103377837
12,49578577,4530,TUBA1A,180,,49583107
11,67033904,20125,ADRBK1,179,,67054029
14,96671134,39532,BDKRB2,179,,96710666
13,78469615,80243,EDNRB,179,,78549858
19,17935592,23249,JAK3,179,,17958841
11,67165651,3725,PPP1CA,179,,67169376
1,227058272,25532,PSEN2,179,,227083804
1,112162404,96913,RAP1A,179,,112259317
4,39289068,78933,RFC1,179,,39368001
17,36046433,58636,HNF1B,179,,36105069
12,110719031,69866,ATP2A2,178,,110788897
17,7093209,27739,DLG4,178,,7120948
6,132129155,87140,ENPP1,178,,132216295
7,95034173,30211,PON2,178,,95064384
6,32793186,13361,TAP2,178,,32806547
15,25582395,101780,UBE3A,178,,25684175
16,14014013,32192,ERCC4,177,,14046205
5,180034752,41872,FLT4,177,,180076624
1,204485506,41742,MDM4,177,,204527248
1,33116748,35064,RBBP4,177,,33151812
8,74857372,27150,TCEB1,177,,74884522
5,159848916,6835,PTTG1,177,,159855751
1,9211726,110,MIR34A,177,,9211836
10,90694830,56324,ACTA2,176,,90751154
9,123714613,97941,C5,176,,123812554
5,137890570,20748,HSPA9,176,,137911318
17,61905043,4344,PSMC5,176,,61909387
3,129247481,6706,RHO,176,,129254187
2,191894301,122021,STAT4,176,,192016322
9,90340973,5411,CTSL,175,,90346384
16,30483982,50524,ITGAL,175,,30534506
2,47596286,17881,EPCAM,175,,47614167
4,148999914,363758,NR3C2,175,,149363672
4,108968700,121412,LEF1,175,,109090112
15,35080296,7631,ACTC1,174,,35087927
4,122589151,28996,ANXA5,174,,122618147
11,116691417,2594,APOA4,174,,116694011
10,96796528,32726,CYP2C8,174,,96829254
5,141971742,94318,FGF1,174,,142066060
8,11561659,55852,GATA4,174,,11617511
1,27189632,1315,SFN,174,,27190947
16,9847261,429350,GRIN2A,174,,10276611
7,26229555,10858,HNRNPA2B1,174,,26240413
2,39208689,138915,SOS1,174,,39347604
18,55714457,354315,NEDD4L,174,,56068772
3,119243139,35342,CD80,173,,119278481
9,90113449,210100,DAPK1,173,,90323549
12,91537053,39848,DCN,173,,91576901
6,160390130,142404,IGF2R,173,,160532534
1,186798031,160082,PLA2G4A,173,,186958113
7,97361270,8514,TAC1,173,,97369784
10,31610063,208679,ZEB1,173,,31818742
9,123664670,26781,TRAF1,173,,123691451
15,90931472,114003,IQGAP1,173,,91045475
17,72744750,20749,SLC9A3R1,173,,72765499
11,74971165,91710,ARRB1,172,,75062875
12,57910370,3930,DDIT3,172,,57914300
1,97543299,843316,DPYD,172,,98386615
1,8921058,10577,ENO1,172,,8931635
9,124062078,33042,GSN,172,,124095120
3,136649316,21136,NCK1,172,,136670452
5,137620953,46613,CDC25C,171,,137667566
6,52656177,12588,GSTA1,171,,52668765
16,10971054,47786,CIITA,171,,11018840
1,45976706,11856,PRDX1,171,,45988562
5,58264865,924756,PDE4D,171,,59189621
9,135766734,53286,TSC1,171,,135820020
2,225334866,115248,CUL3,171,,225450114
1,23345940,64244,KDM1A,171,,23410184
8,141541263,104383,AGO2,171,,141645646
12,56732662,1532,IL23A,171,,56734194
2,215590369,84066,BARD1,170,,215674435
5,176513872,11271,FGFR4,170,,176525143
2,219027567,4149,CXCR1,170,,219031716
3,169940219,83551,PRKCI,170,,170023770
19,4090319,33807,MAP2K2,170,,4124126
4,56294067,118032,CLOCK,170,,56412099
12,100867550,90095,NR1H4,170,,100957645
12,68642024,5257,IL22,170,,68647281
1,202909952,17572,ADIPOR1,170,,202927524
14,95078713,11677,SERPINA3,169,,95090390
12,6309481,37956,CD9,169,,6347437
9,136501484,22982,DBH,169,,136524466
7,128580723,9373,IRF5,169,,128590096
17,39910858,32106,JUP,169,,39942964
21,35818985,65588,KCNE1,169,,35884573
17,39679868,4773,KRT19,169,,39684641
7,99690350,9213,MCM7,169,,99699563
18,61144143,28175,SERPINB5,169,,61172318
5,70220767,28075,SMN2,169,,70248842
6,10396915,15692,TFAP2A,169,,10412607
8,117962511,226442,SLC30A8,169,,118188953
15,78887646,25991,CHRNA3,168,,78913637
15,78857861,29750,CHRNA5,168,,78887611
3,46283871,24326,CCR3,168,,46308197
10,94211440,46078,IDE,168,,94257518
1,26210676,22317,STMN1,168,,26232993
16,55690351,47349,SLC6A2,168,,55737700
20,10199445,88623,SNAP25,168,,10288068
7,75956107,32235,YWHAG,168,,75988342
7,30464142,54251,NOD1,168,,30518393
16,67596309,76779,CTCF,168,,67673088
1,156638555,8634,NES,168,,156647189
9,75515577,52656,ALDH1A1,167,,75568233
20,3063201,2169,AVP,167,,3065370
11,33724555,33470,CD59,167,,33758025
17,38171613,2453,CSF3,167,,38174066
1,182808438,48679,DHX9,167,,182857117
3,193310932,104668,OPA1,167,,193415600
4,57844805,52523,POLR2B,167,,57897328
17,34431219,1795,CCL4,167,,34433014
1,228270360,16553,ARF1,166,,228286913
1,12123433,80831,TNFRSF8,166,,12204264
3,127317199,24079,MCM2,166,,127341278
9,118916070,248530,PAPPA,166,,119164600
16,2587964,65227,PDPK1,166,,2653191
11,89057521,167212,NOX4,166,,89224733
7,100487614,5978,ACHE,165,,100493592
19,10828728,113858,DNM2,165,,10942586
4,148402068,64038,EDNRA,165,,148466106
1,86046443,3205,CYR61,165,,86049648
18,52889561,366299,TCF4,165,,53255860
14,105886185,50872,MTA1,165,,105937057
8,71021996,294079,NCOA2,165,,71316075
16,78133309,1113255,WWOX,165,,79246564
12,7941991,6666,NANOG,165,,7948657
14,69340839,105244,ACTN1,164,,69446083
19,43011457,21204,CEACAM1,164,,43032661
8,67088611,2269,CRH,164,,67090880
19,50180408,11299,PRMT1,164,,50191707
2,217498126,31032,IGFBP2,164,,217529158
11,47352956,21297,MYBPC3,164,,47374253
2,223158348,5367,PAX3,164,,223163715
3,19988571,38096,RAB5A,164,,20026667
1,27425299,56322,SLC9A1,164,,27481621
11,47376408,23719,SPI1,164,,47400127
5,147204142,14652,SPINK1,164,,147218794
6,43139032,10212,SRF,164,,43149244
14,76424403,23962,TGFB3,164,,76448365
1,223282747,33877,TLR5,164,,223316624
11,88911039,117888,TYR,164,,89028927
7,50344264,128534,IKZF1,164,,50472798
1,32479294,30188,KHDRBS1,164,,32509482
9,27546543,27321,C9orf72,164,,27573864
19,45417811,4795,APOC1,163,,45422606
17,62494371,8268,DDX5,163,,62502639
6,137518620,21947,IFNGR1,163,,137540567
1,20301923,5009,PLA2G2A,163,,20306932
18,59992519,62424,TNFRSF11A,163,,60054943
6,15523038,140251,DTNBP1,163,,15663289
5,110407389,6333,TSLP,163,,110413722
12,52908358,5885,KRT5,162,,52914243
X,64887510,74283,MSN,162,,64961793
20,50003493,175877,NFATC2,162,,50179370
12,118573688,9705,PEBP1,162,,118583393
9,131445933,12742,SET,162,,131458675
8,49830238,3761,SNAI2,162,,49833999
17,38219067,31053,THRA,162,,38250120
10,124214178,2690,ARMS2,162,,124216868
20,61974661,18087,CHRNA4,161,,61992748
22,21271713,36324,CRKL,161,,21308037
8,42195972,33359,POLB,161,,42229331
12,6456008,28897,SCNN1A,161,,6484905
16,337439,65237,AXIN1,161,,402676
12,122064454,15492,ORAI1,161,,122079946
19,39138255,82917,ACTN4,160,,39221172
5,68530621,42636,CDK7,160,,68573257
10,50662525,84644,ERCC6,160,,50747169
1,161592987,8766,FCGR3B,160,,161601753
1,120477735,134582,NOTCH2,160,,120612317
17,15133093,35581,PMP22,160,,15168674
5,133307565,33259,VDAC1,160,,133340824
6,26021906,372,HIST1H4A,160,,26022278
19,8959519,132499,MUC16,160,,9092018
1,94458393,128312,ABCA4,159,,94586705
8,86376130,17591,CA2,159,,86393721
22,30636435,6405,LIF,159,,30642840
11,3732783,86239,NUP98,159,,3819022
6,37137921,5283,PIM1,159,,37143204
1,167298280,98302,POU2F1,159,,167396582
14,30045686,351213,PRKD1,159,,30396899
16,2821414,5883,TCEB2,159,,2827297
22,29190547,6013,XBP1,159,,29196560
10,112631552,28212,PDCD4,159,,112659764
19,55525074,24558,GP6,159,,55549632
11,64948685,30792,CAPN1,158,,64979477
4,1205227,37681,CTBP1,158,,1242908
4,120238404,4912,FABP2,158,,120243316
14,55308723,60819,GCH1,158,,55369542
1,245013601,14226,HNRNPU,158,,245027827
19,54385437,25464,PRKCG,158,,54410901
1,26872342,29178,RPS6KA1,158,,26901520
17,32612686,2513,CCL11,158,,32615199
21,46934628,27757,SLC19A1,158,,46962385
7,73113534,20483,STX1A,158,,73134017
12,93802087,33939,UBE2N,158,,93836026
5,82373227,276352,XRCC4,158,,82649579
1,149856009,2223,HIST2H2BE,158,,149858232
14,21156931,5414,ANG,157,,21162345
22,39916563,2128,ATF4,157,,39918691
11,61560108,4606,FEN1,157,,61564714
4,74735108,1911,CXCL1,157,,74737019
4,83274466,20683,HNRNPD,157,,83295149
3,122140747,93039,KPNA1,157,,122233786
19,1086577,8814,POLR2E,157,,1095391
10,72357103,5428,PRF1,157,,72362531
12,109015679,10175,SELPLG,157,,109025854
X,70586088,99767,TAF1,157,,70685855
16,69389463,30428,TERF2,157,,69419891
11,73711325,8957,UCP3,157,,73720282
17,74380689,3252,SPHK1,157,,74383941
10,81370694,4505,SFTPA1,157,,81375199
3,196769430,256017,DLG1,156,,197025447
X,47494918,15085,ELK1,156,,47510003
1,161632904,15540,FCGR2B,156,,161648444
5,74632992,24934,HMGCR,156,,74657926
Y,2654895,887,SRY,156,,2655782
19,49496704,22548,RUVBL2,156,,49519252
12,64845839,50060,TBK1,156,,64895899
20,32951040,148538,ITCH,156,,33099578
22,39436672,3756,APOBEC3F,156,,39440428
17,4534213,10747,ALOX15,155,,4544960
17,45195062,71616,CDC27,155,,45266678
X,41193414,16126,DDX3X,155,,41209540
16,89803958,79107,FANCA,155,,89883065
11,5269501,1586,HBG1,155,,5271087
17,26694298,3075,VTN,155,,26697373
16,8985950,44636,USP7,155,,9030586
10,127700953,376174,ADAM12,155,,128077127
15,40453209,60128,BUB1B,154,,40513337
5,139712427,13761,HBEGF,154,,139726188
9,132575220,11221,TOR1A,154,,132586441
3,10068070,75551,FANCD2,154,,10143621
2,27719705,26845,GCKR,154,,27746550
7,79765070,83655,GNAI1,154,,79848725
12,120105760,13669,PRKAB1,154,,120119429
17,11924134,123014,MAP2K4,154,,12047148
2,219246751,14866,SLC11A1,154,,219261617
20,33759739,5426,PROCR,154,,33765165
21,46875423,58211,COL18A1,154,,46933634
6,31913720,6141,CFB,153,,31919861
12,56119226,4231,CD63,153,,56123457
5,149432853,33350,CSF1R,153,,149466203
1,110276553,7107,GSTM3,153,,110283660
10,94449680,5728,HHEX,153,,94455408
10,78629358,768219,KCNMA1,153,,79397577
3,196466727,92791,PAK2,153,,196559518
1,237205701,791587,RYR2,153,,237997288
15,63334837,23455,TPM1,153,,63358292
12,54624730,28640,CBX5,153,,54653370
1,212738675,55444,ATF3,152,,212794119
16,66400509,38180,CDH5,152,,66438689
11,2904447,2548,CDKN1C,152,,2906995
6,78170564,3175,HTR1B,152,,78173739
14,64854758,71967,MTHFD1,152,,64926725
18,77155771,133552,NFATC1,152,,77289323
2,109335936,66331,RANBP2,152,,109402267
4,6271576,33416,WFS1,152,,6304992
12,49372235,4161,WNT1,152,,49376396
12,7623411,33003,CD163,152,,7656414
3,185360918,181926,IGF2BP2,152,,185542844
X,100098312,31022,NOX1,152,,100129334
5,149599053,70350,CAMK2A,151,,149669403
16,82660398,1169817,CDH13,151,,83830215
1,24200459,39358,CNR2,151,,24239817
5,172195092,3111,DUSP1,151,,172198203
2,234580543,101408,UGT1A9,151,,234681951
6,20534687,697947,CDKAL1,151,,21232634
5,148810208,88,MIR145,151,,148810296
8,6728096,7433,DEFB1,150,,6735529
X,100652778,10223,GLA,150,,100663001
2,228678557,3723,CCL20,150,,228682280
17,7185053,6314,SLC2A4,150,,7191367
4,38797875,8537,TLR1,150,,38806412
12,109535922,12876,UNG,150,,109548798
22,32340478,13112,YWHAH,150,,32353590
15,68346516,137286,PIAS1,150,,68483802
17,79650961,18190,HGS,150,,79669151
10,13142081,38195,OPTN,150,,13180276
5,68788589,65342,OCLN,150,,68853931
17,5336098,6373,C1QBP,149,,5342471
6,41902670,113962,CCND3,149,,42016632
3,148890289,49543,CP,149,,148939832
4,187187117,23718,F11,149,,187210835
15,44038589,26215,PDIA3,149,,44064804
12,52416615,36676,NR4A1,149,,52453291
X,133594174,40524,HPRT1,149,,133634698
3,8792094,19206,OXTR,149,,8811300
7,142457318,3609,PRSS1,149,,142460927
21,46225531,12513,SUMO3,149,,46238044
4,24797084,5383,SOD3,149,,24802467
3,190023489,16746,CLDN1,149,,190040235
1,156211752,1371,BGLAP,148,,156213123
13,110801304,158200,COL4A1,148,,110959504
11,102582525,13160,MMP8,148,,102595685
4,88928798,70133,PKD2,148,,88998931
10,75757871,122043,VCL,148,,75879914
1,150782180,67064,ARNT,147,,150849244
1,116915794,31602,ATP1A1,147,,116947396
5,176829138,7439,F12,147,,176836577
5,37812778,27004,GDNF,147,,37839782
11,5274420,1591,HBG2,147,,5276011
11,102733459,12305,MMP12,147,,102745764
1,17345224,35441,SDHB,147,,17380665
3,48198667,31134,CDC25A,146,,48229801
11,44587140,54175,CD82,146,,44641315
3,186435097,27102,KNG1,146,,186462199
16,67973786,4229,LCAT,146,,67978015
21,42792484,38657,MX1,146,,42831141
7,6010555,38182,PMS2,146,,6048737
3,184018368,8474,PSMD2,146,,184026842
1,35649200,9543,SFPQ,146,,35658743
9,2021944,171679,SMARCA2,146,,2193623
22,42229082,74230,SREBF2,146,,42303312
19,10461203,30045,TYK2,146,,10491248
8,134249413,60134,NDRG1,146,,134309547
2,163123588,51630,IFIH1,146,,163175218
6,31982571,20624,C4B,145,,32003195
1,158149736,6480,CD1D,145,,158156216
12,58156116,4860,CYP27B1,145,,58160976
22,50964180,4334,TYMP,145,,50968514
6,35541361,154999,FKBP5,145,,35696360
3,50284325,12461,GNAI2,145,,50296786
3,4535031,354493,ITPR1,145,,4889524
1,43803474,16661,MPL,145,,43820135
11,17741109,2569,MYOD1,145,,17743678
4,74846541,1300,PF4,145,,74847841
7,103112230,517733,RELN,145,,103629963
19,797391,14936,PTBP1,145,,812327
2,32288679,94027,SPAST,145,,32382706
8,73921096,38891,TERF1,145,,73959987
2,198283520,16297,SF3B1,145,,198299817
17,41831098,5058,SOST,145,,41836156
3,151054630,47970,P2RY12,145,,151102600
7,134127101,16843,AKR1B1,144,,134143944
2,128014865,36887,ERCC3,144,,128051752
14,21677295,60343,HNRNPC,144,,21737638
X,43625856,115865,MAOB,144,,43741721
11,1074874,29542,MUC2,144,,1104416
X,129263337,8678,AIFM1,144,,129272015
12,99039077,90134,APAF1,143,,99129211
9,33252469,12290,BAG1,143,,33264759
11,57365026,17300,SERPING1,143,,57382326
21,44589117,3803,CRYAA,143,,44592920
12,111890017,147463,ATXN2,143,,112037480
8,133879204,267939,TG,143,,134147143
X,76760355,281400,ATRX,142,,77041755
11,49168186,62036,FOLH1,142,,49230222
9,71650478,43515,FXN,142,,71693993
16,57496550,9371,POLR2C,142,,57505921
16,53468350,57210,RBL2,142,,53525560
4,57775078,26932,REST,142,,57802010
11,62623483,32872,SLC3A2,142,,62656355
11,107879407,99081,CUL5,142,,107978488
16,89988416,14089,TUBB3,142,,90002505
19,41732659,35013,AXL,141,,41767672
2,157180943,8344,NR4A2,141,,157189287
17,37560537,46990,MED1,141,,37607527
19,52693054,36624,PPP2R1A,141,,52729678
19,45504706,36750,RELB,141,,45541456
X,20168028,116722,RPS6KA3,141,,20284750
2,75273589,153056,TACR1,141,,75426645
10,35297478,82092,CUL2,141,,35379570
17,7461608,3317,TNFSF13,141,,7464925
7,23349827,160168,IGF2BP3,141,,23509995
12,4382901,31621,CCND2,140,,4414522
14,67827033,26200,EIF2S1,140,,67853233
1,89318320,38981,GTF2B,140,,89357301
19,10764936,31507,ILF3,140,,10796443
12,12268960,150851,LRP6,140,,12419811
6,31462657,16244,MICB,140,,31478901
5,40680031,13806,PTGER4,140,,40693837
2,61108629,46662,REL,140,,61155291
2,170655321,13250,SSB,140,,170668571
5,156512842,23406,HAVCR2,140,,156536248
21,45705720,12382,AIRE,139,,45718102
7,142986680,18109,CASP2,139,,143004789
16,50775960,59886,CYLD,139,,50835846
1,68150859,3162,GADD45A,139,,68154021
19,49468565,1571,FTL,139,,49470136
19,55249973,14531,KIR2DL3,139,,55264504
5,56110899,81079,MAP3K1,139,,56191978
8,144989314,61599,PLEC,139,,145050913
3,127799799,42872,RUVBL1,139,,127842671
2,241526132,12394,CAPN10,139,,241538526
12,14923653,412,HIST4H4,139,,14924065
19,47104406,9633,CALM3,138,,47114039
2,74588280,19202,DCTN1,138,,74607482
22,24999123,25849,GGT1,138,,25024972
1,161274524,5238,MPZ,138,,161279762
6,43543877,44383,POLH,138,,43588260
5,131705400,25906,SLC22A5,138,,131731306
10,60144902,14088,TFAM,138,,60158990
1,13911966,32486,PDPN,138,,13944452
6,87795215,9650,CGA,137,,87804865
8,82390731,4742,FABP4,137,,82395473
13,28494167,6284,PDX1,137,,28500451
X,70503041,17977,NONO,137,,70521018
3,184080770,5613,POLR2H,137,,184086383
7,5632435,13852,FSCN1,137,,5646287
9,131314836,81108,SPTAN1,137,,131395944
20,33146500,1649,MAP1LC3A,137,,33148149
3,48601505,31088,COL7A1,136,,48632593
5,138089074,181649,CTNNA1,136,,138270723
5,79922044,28756,DHFR,136,,79950800
3,39448179,5853,RPSA,136,,39454032
11,18415935,13830,LDHA,136,,18429765
10,52750910,1307200,PRKG1,136,,54058110
3,169482397,451,TERC,136,,169482848
X,12924738,16550,TLR8,136,,12941288
5,82767492,110630,VCAN,135,,82878122
3,128198264,9109,GATA2,135,,128207373
9,21384253,1143,IFNA2,135,,21385396
2,217536827,23445,IGFBP5,135,,217560272
6,32162619,29225,NOTCH4,135,,32191844
11,47440319,7705,PSMC3,135,,47448024
11,75110534,7423,RPS3,135,,75117957
8,41119475,47515,SFRP1,135,,41166990
17,74730196,3297,SRSF2,135,,74733493
19,3594503,12328,TBXA2R,135,,3606831
11,101322294,132365,TRPC6,135,,101454659
6,3153901,3882,TUBB2A,135,,3157783
19,46010687,19553,VASP,135,,46030240
2,113973573,62925,PAX8,135,,114036498
2,55199326,38144,RTN4,135,,55237470
3,138663065,2917,FOXL2,134,,138665982
17,78075324,18357,GAA,134,,78093681
6,33032345,16210,HLA-DPA1,134,,33048555
19,55281264,14514,KIR2DL1,134,,55295778
15,66161796,22533,RAB11A,134,,66184329
17,42154120,46894,HDAC5,134,,42201014
17,45810609,12876,TBX21,134,,45823485
1,161192082,1336,APOA2,133,,161193418
X,77166152,139740,ATP7A,133,,77305892
20,52769987,20529,CYP24A1,133,,52790516
22,37521879,24151,IL2RB,133,,37546030
19,18263987,17356,PIK3R2,133,,18281343
5,35055801,174890,PRLR,133,,35230691
14,23389719,9075,PRMT5,133,,23398794
19,47724078,11945,BBC3,133,,47736023
8,98656406,86082,MTDH,133,,98742488
1,239792372,280345,CHRM3,132,,240072717
9,130965633,51894,DNM1,132,,131017527
16,67465035,6419,HSD11B2,132,,67471454
9,131873966,37259,PPP2R4,132,,131911225
14,35761522,25163,PSMA6,132,,35786685
7,102987970,14944,PSMC2,132,,103002914
2,1417232,129267,TPO,132,,1546499
17,7452374,8833,TNFSF12,132,,7461207
X,128779235,9698,APLN,132,,128788933
13,80910110,5140,SPRY2,132,,80915250
13,20796100,10434,GJB6,132,,20806534
6,31949833,20624,C4A,131,,31970457
3,183892633,9246,AP2M1,131,,183901879
6,7541807,45143,DSP,131,,7586950
2,220436953,3482,INHA,131,,220440435
17,71161159,6903,SSTR2,131,,71168062
1,161009040,5687,USF1,131,,161014727
X,53401069,48608,SMC1A,131,,53449677
X,45605584,110,MIR221,131,,45605694
10,3818187,9286,KLF6,130,,3827473
1,150768683,12234,CTSK,130,,150780917
19,46272966,12849,DMPK,130,,46285815
6,31777395,5440,HSPA1L,130,,31782835
17,2496922,91987,PAFAH1B1,130,,2588909
2,220114432,4898,TUBA4A,130,,220119330
22,44319618,23830,PNPLA3,130,,44343448
X,30322538,4957,NR0B1,129,,30327495
4,75480590,9895,AREG,129,,75490485
10,75572258,62091,CAMK2G,129,,75634349
19,531732,10355,CDC34,129,,542087
19,42212503,21838,CEACAM5,129,,42234341
1,1716723,105833,GNB1,129,,1822556
13,108859791,10925,LIG4,129,,108870716
4,76922494,6182,CXCL9,129,,76928676
1,57110989,70019,PRKAA2,129,,57181008
6,160199529,11206,TCP1,129,,160210735
19,12907633,5091,PRDX2,129,,12912724
11,62186506,4172,SCGB1A1,129,,62190678
1,85731459,11128,BCL10,129,,85742587
1,12040237,33335,MFN2,129,,12073572
19,10501808,12463,CDC37,129,,10514271
20,3827445,29325,MAVS,129,,3856770
4,110609784,14845,CASP6,128,,110624629
21,34697213,34915,IFNAR1,128,,34732128
5,88014057,185865,MEF2C,128,,88199922
17,4848944,3437,PFN1,128,,4852381
7,75544419,71754,POR,128,,75616173
17,19281773,5084,MAPK7,128,,19286857
20,60711782,6732,PSMA7,128,,60718514
1,93297593,9888,RPL5,128,,93307481
3,142443265,83464,TRPC1,128,,142526729
2,145141941,136017,ZEB2,128,,145277958
13,95748024,205676,ABCC4,128,,95953700
7,139246315,231378,HIPK2,128,,139477693
7,25158269,6711,CYCS,128,,25164980
1,149824180,507,HIST2H3C,128,,149824687
16,30064410,17331,ALDOA,127,,30081741
6,167525294,27335,CCR6,127,,167552629
11,64073698,10514,ESRRA,127,,64084212
X,153213007,23812,HCFC1,127,,153236819
5,179041178,9533,HNRNPH1,127,,179050711
5,131396346,2550,IL3,127,,131398896
6,52128811,20868,MCM3,127,,52149679
11,71713909,77830,NUMA1,127,,71791739
3,128444978,88663,RAB7A,127,,128533641
7,74188308,15412,NCF1,127,,74203720
2,127805598,59305,BIN1,126,,127864903
5,86690078,18643,CCNH,126,,86708721
X,153607596,2287,EMD,126,,153609883
1,23037330,210663,EPHB2,126,,23247993
1,51819934,67859,EPS15,126,,51887793
X,132669775,449898,GPC3,126,,133119673
4,111538579,5675,PITX2,126,,111544254
3,171318194,210090,PLD1,126,,171528284
9,110047049,47426,RAD23B,126,,110094475
4,69962191,16514,UGT2B7,126,,69978705
19,39897486,2566,ZFP36,126,,39900052
2,102927961,34599,IL1RL1,126,,102962560
12,110220891,31741,TRPV4,126,,110252632
10,88516395,168550,BMPR1A,125,,88684945
8,92967194,140688,RUNX1T1,125,,93107882
2,220283098,8363,DES,125,,220291461
19,42734337,12399,GSK3A,125,,42746736
X,103031720,15827,PLP1,125,,103047547
11,62529010,5177,POLR2G,125,,62534187
3,46919235,26054,PTH1R,125,,46945289
18,12785476,98858,PTPN2,125,,12884334
9,19376253,3982,RPS6,125,,19380235
X,70752911,42836,OGT,125,,70795747
12,32832133,66451,DNM1L,125,,32898584
4,106067841,133119,TET2,125,,106200960
1,160085519,27855,ATP1A2,124,,160113374
X,153170528,2092,AVPR2,124,,153172620
11,118175294,11596,CD3E,124,,118186890
5,172659106,3209,NKX2-5,124,,172662315
11,612554,3445,IRF7,124,,615999
11,61567096,17433,FADS1,124,,61584529
5,121398889,14029,LOX,124,,121412918
10,102505467,84231,PAX2,124,,102589698
3,138371539,54924,PIK3CB,124,,138426463
17,4710395,16332,PLD2,124,,4726727
12,111157612,23171,PPP1CC,124,,111180783
X,16862774,25204,RBBP7,124,,16887978
8,97505881,118156,SDC2,124,,97624037
21,43782390,4254,TFF1,124,,43786644
6,153071931,8971,VIP,124,,153080902
6,31847535,17448,EHMT2,124,,31864983
2,190425315,20222,SLC40A1,124,,190445537
12,52301201,15944,ACVRL1,123,,52317145
5,149781199,11300,CD74,123,,149792499
11,47236492,24277,DDB2,123,,47260769
15,49715374,64149,FGF7,123,,49779523
15,81489218,115886,IL16,123,,81605104
15,100106132,150561,MEF2A,123,,100256693
18,21111462,55119,NPC1,123,,21166581
6,32808493,4219,PSMB8,123,,32812712
1,25598976,57960,RHD,123,,25656936
16,23313590,79030,SCNN1B,123,,23392620
2,85884439,11425,SFTPB,123,,85895864
17,18231173,35704,SHMT1,123,,18266877
1,149858524,437,HIST2H2AC,123,,149858961
10,5090957,58921,AKR1C3,123,,5149878
1,948846,1073,ISG15,123,,949919
1,243663020,343866,AKT3,123,,244006886
19,8429010,10249,ANGPTL4,123,,8439259
1,231499496,61294,EGLN1,123,,231560790
2,234160216,44104,ATG16L1,123,,234204320
1,113243748,6277,RHOC,122,,113250025
15,74630102,29979,CYP11A1,122,,74660081
12,7023613,9246,ENO2,122,,7032859
20,1349620,24196,FKBP1A,122,,1373816
7,1126442,7009,GPER1,122,,1133451
6,26017259,781,HIST1H1A,122,,26018040
6,391738,19705,IRF4,122,,411443
19,55315066,10906,KIR2DL4,122,,55325972
14,65550456,18806,MAX,122,,65569262
3,195473637,65207,MUC4,122,,195538844
7,536896,22585,PDGFA,122,,559481
4,101944586,324042,PPP3CA,122,,102268628
14,58711522,27205,PSMA3,122,,58738727
1,28218035,23273,RPA2,122,,28241308
3,47627377,196028,SMARCC1,122,,47823405
12,56735381,18656,STAT2,122,,56754037
1,154127779,27946,TPM3,122,,154155725
11,115044344,330897,CADM1,122,,115375241
17,59756546,184374,BRIP1,122,,59940920
1,159259503,18511,FCER1A,121,,159278014
11,61731756,3376,FTH1,121,,61735132
1,226250407,9296,H3F3A,121,,226259703
11,5254058,1800,HBD,121,,5255858
18,721591,90736,YES1,121,,812327
12,49521566,3738,TUBA1B,121,,49525304
2,74756531,4152,HTRA2,121,,74760683
19,3522953,13802,FZR1,121,,3536755
17,79825594,3256,ARHGDIA,120,,79828850
7,136553831,147940,CHRM2,120,,136701771
1,150702671,35762,CTSS,120,,150738433
1,101702304,4772,S1PR1,120,,101707076
19,3976053,9408,EEF2,120,,3985461
2,8822112,2471,ID2,120,,8824583
2,136545409,49341,LCT,120,,136594750
5,126112844,59868,LMNB1,120,,126172712
11,46403260,2127,MDK,120,,46405387
4,100485234,59920,MTTP,120,,100545154
2,70314584,1750,PCBP1,120,,70316334
12,53845885,29061,PCBP2,120,,53874946
2,71693831,220062,DYSF,120,,71913893
6,30667583,17875,MDC1,120,,30685458
7,26240830,12397,CBX3,120,,26253227
2,204801470,24828,ICOS,120,,204826298
16,28510682,7473,IL27,120,,28518155
19,49526125,1507,CGB,119,,49527632
3,46243199,6633,CCR1,119,,46249832
9,97861335,218656,FANCC,119,,98079991
4,68603098,18706,GNRHR,119,,68621804
17,39738530,4617,KRT14,119,,39743147
X,77359665,22659,PGK1,119,,77382324
3,48784011,101272,PRKAR2A,119,,48885283
14,61788160,229538,PRKCH,119,,62017698
13,37006408,10611,CCNA1,119,,37017019
10,133781186,14331,BNIP3,118,,133795517
13,73629113,22567,KLF5,118,,73651680
2,202047620,38763,CASP10,118,,202086383
3,107761940,47995,CD47,118,,107809935
19,7753642,10723,FCER2,118,,7764365
7,27210209,3746,HOXA10,118,,27213955
17,40704575,2657,HSD17B1,118,,40707232
19,55875749,6082,IL11,118,,55881831
17,68165675,10508,KCNJ2,118,,68176183
19,36316273,26622,NPHS1,118,,36342895
22,38349669,15653,POLR2F,118,,38365322
7,102113547,5834,POLR2J,118,,102119381
6,32821937,5691,PSMB9,118,,32827628
19,50879679,6606,NR1H2,118,,50886285
1,27237974,2593,NR0B2,118,,27240567
10,121410881,26448,BAG3,118,,121437329
17,1553922,34254,PRPF8,118,,1588176
13,38136718,36263,POSTN,118,,38172981
20,35520226,60020,SAMHD1,118,,35580246
19,49258815,2772,FGF21,118,,49261587
17,6899383,14672,ALOX12,117,,6914055
13,31287614,50951,ALOX5AP,117,,31338565
1,223889294,74426,CAPN2,117,,223963720
X,107683073,257702,COL4A5,117,,107940775
21,38792601,95078,DYRK1A,117,,38887679
3,172165332,914,GHSR,117,,172166246
1,22148724,115066,HSPG2,117,,22263790
19,17982781,23202,SLC5A5,117,,18005983
1,158580495,76011,SPTA1,117,,158656506
9,35697333,35059,TLN1,117,,35732392
11,61717355,13711,BEST1,117,,61731066
11,113931287,190110,ZBTB16,117,,114121397
1,27022521,86080,ARID1A,117,,27108601
1,206858364,49266,MAPKAPK2,117,,206907630
1,206643585,26638,IKBKE,117,,206670223
17,40985158,10619,PSME3,117,,40995777
6,149639435,93314,TAB2,117,,149732749
17,78518624,421549,RPTOR,117,,78940173
2,87011727,23792,CD8A,116,,87035519
22,38686696,27393,CSNK1E,116,,38714089
7,74071990,103032,GTF2I,116,,74175022
11,113845796,15238,HTR3A,116,,113861034
3,124480794,125358,ITGB5,116,,124606152
5,169675087,49735,LCP2,116,,169724822
15,88520595,279367,NTRK3,116,,88799962
20,3052265,898,OXT,116,,3053163
17,79801033,17511,P4HB,116,,79818544
19,13056627,7830,RAD23A,116,,13064457
19,18942743,36296,UPF1,116,,18979039
1,192778168,3239,RGS2,116,,192781407
16,67188088,5724,TRADD,116,,67193812
9,132500614,14730,PTGES,116,,132515344
1,145438437,4207,TXNIP,116,,145442644
1,193091087,132855,CDC73,116,,193223942
11,66314311,16489,ACTN3,115,,66330800
15,89346673,71912,ACAN,115,,89418585
4,186064416,7122,SLC25A4,115,,186071538
6,131894343,11129,ARG1,115,,131905472
18,43664109,14210,ATP5A1,115,,43678319
5,148875456,55659,CSNK1A1,115,,148931115
21,18885223,57206,CXADR,115,,18942429
X,153991016,14948,DKC1,115,,154005964
14,102430864,86271,DYNC1H1,115,,102517135
3,168801286,62807,MECOM,115,,168864093
6,29691116,3187,HLA-F,115,,29694303
4,26321331,115421,RBPJ,115,,26436752
5,72112417,97798,TNPO1,115,,72210215
11,119179233,8607,MCAM,115,,119187840
19,840984,7191,PRTN3,115,,848175
14,90722893,16073,PSMC1,115,,90738966
1,182542768,15626,RNASEL,115,,182558394
19,42363987,11497,RPS19,115,,42375484
5,131630144,49755,SLC22A4,115,,131679899
6,31606804,13366,BAG6,115,,31620170
4,38825328,33110,TLR6,115,,38858438
12,48128452,24437,RAPGEF3,115,,48152889
20,44441214,4382,UBE2C,115,,44445596
9,137001209,23885,WDR5,115,,137025094
5,156456423,29707,HAVCR1,115,,156486130
1,22963117,3058,C1QA,114,,22966175
6,30856464,11469,DDR1,114,,30867933
2,228029280,150228,COL4A3,114,,228179508
1,207627644,35596,CR2,114,,207663240
3,49507564,65487,DAG1,114,,49573051
2,190920425,7030,MSTN,114,,190927455
11,18343815,44775,GTF2H1,114,,18388590
10,43881064,23632,HNRNPF,114,,43904696
7,27202056,3093,HOXA9,114,,27205149
3,49924435,16635,MST1R,114,,49941070
1,183524696,35043,NCF2,114,,183559739
3,51433297,100721,VPRBP,114,,51534018
19,10982252,51196,CARM1,114,,11033448
1,160313062,15680,NCSTN,114,,160328742
16,23614482,38196,PALB2,114,,23652678
1,228194722,54250,WNT3A,114,,228248972
12,6679247,37352,CHD4,113,,6716599
19,8509802,44200,HNRNPM,113,,8554002
2,128603839,11890,POLR2D,113,,128615729
14,52781015,14307,PTGER2,113,,52795322
1,163038395,8197,RGS4,113,,163046592
12,120907659,28639,DYNLL1,113,,120936298
11,61583674,51152,FADS2,113,,61634826
1,207070787,6697,IL24,113,,207077484
12,44152746,30600,IRAK4,113,,44183346
13,106118564,24819,DAOA,113,,106143383
12,50344523,8141,AQP2,112,,50352664
12,57031958,7894,ATP5B,112,,57039852
3,42299315,8372,CCK,112,,42307687
9,137533650,203038,COL5A1,112,,137736688
1,159175048,1242,ACKR1,112,,159176290
4,144257982,137736,GAB1,112,,144395718
15,72635775,33039,HEXA,112,,72668814
1,209958967,20553,IRF6,112,,209979520
5,52084135,165350,ITGA1,112,,52249485
1,183155173,59089,LAMC2,112,,183214262
22,30658816,4016,OSM,112,,30662832
20,44527258,13745,PLTP,112,,44541003
2,231921577,115963,PSMD1,112,,232037540
1,153430219,2918,S100A7,112,,153433137
9,34709001,1163,CCL21,112,,34710164
20,43953928,23136,SDC4,112,,43977064
16,48394445,5339,SIAH1,112,,48399784
11,35272751,168859,SLC1A2,112,,35441610
11,121322911,181560,SORL1,112,,121504471
8,142431487,11067,PTP4A3,112,,142442554
12,862088,158530,WNK1,112,,1020618
11,128563810,119352,FLI1,111,,128683162
5,161494647,87898,GABRG2,111,,161582545
7,42000547,276071,GLI3,111,,42276618
5,151202073,102324,GLRA1,111,,151304397
19,55344130,15894,KIR2DS4,111,,55360024
10,94352824,62328,KIF11,111,,94415152
11,92702788,13160,MTNR1B,111,,92715948
8,24808468,5915,NEFL,111,,24814383
9,36833271,201205,PAX5,111,,37034476
11,839720,2809,POLR2L,111,,842529
19,40476911,10760,PSMC4,111,,40487671
22,41640780,41241,RANGAP1,111,,41682021
20,35624754,99864,RBL1,111,,35724618
6,16299342,462379,ATXN1,111,,16761721
11,111957547,8978,SDHD,111,,111966525
11,4406126,8800,TRIM21,111,,4414926
1,92145899,205937,TGFBR3,111,,92351836
16,20344372,19828,UMOD,111,,20364200
1,179519673,25414,NPHS2,111,,179545087
8,90769974,33318,RIPK2,111,,90803292
2,11319884,164827,ROCK2,111,,11484711
22,38879442,22903,DDX17,111,,38902345
X,19552082,265835,SH3KBP1,111,,19817917
2,234601511,80440,UGT1A6,111,,234681951
2,237478379,12615,ACKR3,111,,237490994
12,1800246,97599,ADIPOR2,111,,1897845
2,264868,7613,ACP1,110,,272481
6,44191362,10526,SLC29A1,110,,44201888
1,46859938,19582,FAAH,110,,46879520
17,40265128,8254,KAT2A,110,,40273382
1,110091185,47269,GNAI3,110,,110138454
11,117857105,15094,IL10RA,110,,117872199
19,12902309,1816,JUNB,110,,12904125
13,98605928,70622,IPO5,110,,98676550
5,135468533,49889,SMAD5,110,,135518422
9,138453601,5021,PAEP,110,,138458622
9,139871955,4239,PTGDS,110,,139876194
1,109852187,83792,SORT1,110,,109935979
21,32490735,440555,TIAM1,110,,32931290
11,9596233,15080,WEE1,110,,9611313
4,20253527,368657,SLIT2,110,,20622184
19,56165415,20667,U2AF2,110,,56186082
19,45449238,3584,APOC2,109,,45452822
2,47387220,16542,CALM2,109,,47403762
11,60223281,14944,MS4A1,109,,60238225
20,3767418,19350,CDC25B,109,,3786768
19,6379579,13712,GTF2F1,109,,6393291
6,32902405,6442,HLA-DMB,109,,32908847
19,39327027,15952,HNRNPL,109,,39342979
14,23495059,9370,PSMB5,109,,23504429
19,49588396,23474,SNRNP70,109,,49611870
8,38000217,8383,STAR,109,,38008600
21,42836477,43515,TMPRSS2,109,,42879992
6,31497995,12257,DDX39B,109,,31510252
4,78432906,100082,CXCL13,109,,78532988
18,56338617,78754,MALT1,109,,56417371
20,3648611,14726,ADAM33,109,,3663337
11,2016405,2700,H19,109,,2019105
9,116148591,15027,ALAD,108,,116163618
3,105085556,210201,ALCAM,108,,105295757
2,105977282,38293,FHL2,108,,106015575
12,53068519,5672,KRT1,108,,53074191
X,119560002,43202,LAMP2,108,,119603204
8,48872762,17957,MCM4,108,,48890719
19,36604610,1596,POLR2I,108,,36606206
10,73576039,35093,PSAP,108,,73611132
7,42956461,15344,PSMA2,108,,42971805
2,54683453,215130,SPTBN1,108,,54898583
1,173152869,23583,TNFSF4,108,,173176452
4,141481049,8910,UCP1,108,,141489959
6,18224399,40400,DEK,108,,18264799
X,53559056,154618,HUWE1,108,,53713674
16,810764,8101,MSLN,108,,818865
9,140135710,2449,TUBB4B,108,,140138159
5,96110187,33705,ERAP1,108,,96143892
11,126152981,11847,TIRAP,108,,126164828
2,96778622,3362,ADRA2B,107,,96781984
2,20646831,2373,RHOB,107,,20649204
22,51061181,5420,ARSA,107,,51066601
6,31895253,18198,C2,107,,31913451
17,38444145,15268,CDC6,107,,38459413
8,6835170,2444,DEFA1,107,,6837614
1,21543739,62444,ECE1,107,,21606183
1,158979681,45264,IFI16,107,,159024945
2,233924676,191873,INPP5D,107,,234116549
16,81812862,183436,PLCG2,107,,81996298
17,67410837,127633,MAP2K6,107,,67538470
7,136912091,116455,PTN,107,,137028546
1,24018268,4647,RPL11,107,,24022915
11,4115914,44241,RRM1,107,,4160155
4,122800182,72727,TRPC3,107,,122872909
X,47053200,21327,UBA1,107,,47074527
7,152343586,29664,XRCC2,107,,152373250
10,120794540,45794,EIF3A,107,,120840334
16,28996386,5718,LAT,107,,29002104
3,8775485,12966,CAV3,106,,8788451
11,6280903,12454,CCKBR,106,,6293357
10,35415768,86118,CREM,106,,35501886
16,67226067,6754,E2F4,106,,67232821
1,29213602,232956,EPB41,106,,29446558
9,35073834,6179,FANCG,106,,35080013
1,200011952,134598,NR5A2,106,,200146550
19,49199227,9964,FUT2,106,,49209191
6,29570004,30908,GABBR1,106,,29600912
13,114523521,43555,GAS6,106,,114567076
8,25276773,5783,GNRH1,106,,25282556
14,38058756,5569,FOXA1,106,,38064325
2,136597195,36852,MCM6,106,,136634047
8,120569316,81790,ENPP2,106,,120651106
19,50887579,33696,POLD1,106,,50921275
8,101162838,3392,POLR2K,106,,101166230
11,14535511,6480,PSMA1,106,,14541991
15,78832746,8858,PSMA4,106,,78841604
15,55495163,67429,RAB27A,106,,55562592
11,110066285,101152,RDX,106,,110167437
X,38128422,58366,RPGR,106,,38186788
1,2160133,81519,SKI,106,,2241652
14,24718319,14097,TGM1,106,,24732416
11,67250499,8080,AIP,106,,67258579
10,112327448,36944,SMC3,106,,112364392
1,173446485,11461,PRDX6,106,,173457946
8,12940871,32882,DLC1,106,,12973753
1,161736033,197827,ATF6,106,,161933860
19,15357846,33416,BRD4,106,,15391262
3,8918879,86280,RAD18,106,,9005159
7,98625057,116686,SMURF1,106,,98741743
11,1244294,39112,MUC5B,106,,1283406
X,152990322,19894,ABCD1,105,,153010216
15,90328125,29947,ANPEP,105,,90358072
11,832951,5884,CD151,105,,838835
17,7476023,6301,EIF4A1,105,,7482324
17,7210317,5465,EIF5A,105,,7215782
5,161274196,52769,GABRA1,105,,161326965
5,152870083,323346,GRIA1,105,,153193429
6,32916390,4509,HLA-DMA,105,,32920899
14,65007185,2769,HSPA2,105,,65009954
19,51322401,4642,KLK1,105,,51327043
2,169983618,235504,LRP2,105,,170219122
X,123480131,26879,SH2D1A,105,,123507010
22,37621300,19039,RAC2,105,,37640339
12,120634502,4512,RPLP0,105,,120639014
1,113454469,44216,SLC16A1,105,,113498685
X,48553944,13462,SUV39H1,105,,48567406
20,34021144,4826,GDF5,105,,34025970
22,38507501,70260,PLA2G6,105,,38577761
2,239152678,44529,PER2,105,,239197207
2,96940073,31234,SNRNP200,105,,96971307
1,17634689,55806,PADI4,105,,17690495
17,4637803,5420,CXCL16,105,,4643223
1,236849753,78174,ACTN2,104,,236927927
18,904943,7230,ADCYAP1,104,,912173
6,106534194,23620,PRDM1,104,,106557814
3,105374304,213583,CBLB,104,,105587887
11,75273100,10749,SERPINH1,104,,75283849
14,25042723,2743,CTSG,104,,25045466
3,33038099,100623,GLB1,104,,33138722
9,33025200,14706,DNAJA1,104,,33039906
19,14625575,3796,DNAJB1,104,,14629371
15,28000022,344436,OCA2,104,,28344458
18,39535162,126284,PIK3C3,104,,39661446
11,6411643,4585,SMPD1,104,,6416228
1,47681961,15426,TAL1,104,,47697387
22,31003069,19978,TCN2,104,,31023047
17,40761357,5899,TUBG1,104,,40767256
12,104609556,134529,TXNRD1,104,,104744085
20,62328003,2048,TNFRSF6B,104,,62330051
6,17615265,91800,NUP153,104,,17707065
9,86274877,48291,UBQLN1,104,,86323168
13,92002858,84,MIR17,104,,92002942
8,26626328,98432,ADRA1A,103,,26724760
6,7726331,155630,BMP6,103,,7881961
19,47813103,12224,C5AR1,103,,47825327
11,62676150,12862,CHRM1,103,,62689012
19,18893582,8532,COMP,103,,18902114
7,73245192,1831,CLDN4,103,,73247023
6,146350333,408401,GRM1,103,,146758734
X,70327253,4228,IL2RG,103,,70331481
20,62031566,72464,KCNQ2,103,,62104030
15,74218798,25684,LOXL1,103,,74244482
4,4861391,4269,MSX1,103,,4865660
1,9711789,77383,PIK3CD,103,,9789172
17,42030100,51737,PYY,103,,42081837
14,53173895,20821,PSMC6,103,,53194716
11,36589562,11748,RAG1,103,,36601310
14,21359561,946,RNASE3,103,,21360507
10,102106771,17817,SCD,103,,102124588
20,2442280,9219,SNRPB,103,,2451499
3,184089722,6274,THPO,103,,184095996
3,25639395,66468,TOP2B,103,,25705863
7,93514708,5595,TFPI2,103,,93520303
18,47088400,30879,LIPG,103,,47119279
21,43639266,78088,ABCG1,103,,43717354
11,77926335,126591,GAB2,103,,78052926
17,47074773,58734,IGF2BP1,103,,47133507
17,33914281,139155,AP2B1,102,,34053436
15,78916635,16952,CHRNB4,102,,78933587
10,126676417,173213,CTBP2,102,,126849630
6,20403909,90036,E2F3,102,,20493945
1,149754249,9825,FCGR1A,102,,149764074
X,15363712,38823,FIGF,102,,15402535
11,118955586,8673,HMBS,102,,118964259
1,29138653,51555,OPRD1,102,,29190208
2,167051696,180801,SCN9A,102,,167232497
16,23194039,34161,SCNN1G,102,,23228200
20,43880879,2326,SLPI,102,,43883205
16,87863621,39484,SLC7A5,102,,87903105
7,98476112,134754,TRRAP,102,,98610866
14,101193201,11360,DLK1,102,,101204561
10,106014467,12755,GSTO1,102,,106027222
17,46147413,31470,CBX1,102,,46178883
8,74903563,37744,LY96,102,,74941307
16,31212806,1291,PYCARD,102,,31214097
2,158592957,138666,ACVR1,101,,158731623
19,50270179,40190,AP2A1,101,,50310369
15,42651697,52818,CAPN3,101,,42704515
11,118209788,3671,CD3D,101,,118213459
8,59402736,9984,CYP7A1,101,,59412720
2,75059781,60700,HK2,101,,75120481
12,79985744,99046,PAWR,101,,80084790
11,67160775,5108,RAD9A,101,,67165883
11,130029681,50576,ST14,101,,130080257
13,45907605,7814,TPT1,101,,45915419
4,144434615,44027,SMARCA5,101,,144478642
11,62360674,8638,MTA2,101,,62369312
X,70338405,23899,MED12,101,,70362304
3,71247033,386107,FOXP1,101,,71633140
19,4909441,52724,UHRF1,101,,4962165
16,16315043,2285,ABCC6,100,,16317328
18,49866541,1195732,DCC,100,,51062273
8,27348518,53921,EPHX2,100,,27402439
9,34646585,4010,GALT,100,,34650595
11,33880122,11387,LMO2,100,,33891509
18,57567191,4347,PMAIP1,100,,57571538
X,107327434,7440,PSMD10,100,,107334874
16,57438678,11296,CCL17,100,,57449974
6,160542862,36888,SLC22A1,100,,160579750
17,8062464,3829,VAMP2,100,,8066293
16,29831714,27646,MVP,100,,29859360
12,57057124,25068,PTGES3,100,,57082192
2,44066102,39503,ABCG8,100,,44105605
9,116822407,18345,AMBP,99,,116840752
16,56395363,64087,AMFR,99,,56459450
11,118215058,9439,CD3G,99,,118224497
1,154540256,12097,CHRNB2,99,,154552353
14,24974560,2911,CMA1,99,,24977471
5,39371775,53560,DAB2,99,,39425335
14,80663867,33530,DIO2,99,,80697397
4,9783257,2376,DRD5,99,,9785633
18,19749397,33094,GATA6,99,,19782491
10,88809958,44846,GLUD1,99,,88854804
3,193853930,2471,HES1,99,,193856401
19,18390503,1963,JUND,99,,18392466
6,170844203,18214,PSMB1,99,,170862417
2,232573234,5016,PTMA,99,,232578250
15,60780482,139247,RORA,99,,60919729
22,38368318,12221,SOX10,99,,38380539
11,57093458,9893,SSRP1,99,,57103351
7,1855427,417156,MAD1L1,99,,2272583
2,169779448,108385,ABCB11,99,,169887833
7,123321980,67145,WASL,99,,123389125
17,43340485,53945,MAP3K14,99,,43394430
7,18126564,581902,HDAC9,99,,18708466
19,39369194,21308,SIRT2,99,,39390502
19,50410083,22716,NUP62,99,,50432799
1,160965000,26133,F11R,99,,160991133
18,56118305,85,MIR122,99,,56118390
7,143013218,35879,CLCN1,98,,143049097
13,107142078,45310,EFNB2,98,,107187388
21,40177230,19648,ETS2,98,,40196878
11,59856136,9804,MS4A2,98,,59865940
12,2904107,10480,FKBP4,98,,2914587
6,1610680,3449,FOXC1,98,,1614129
2,171673199,44460,GAD1,98,,171717659
6,27834569,790,HIST1H1B,98,,27835359
1,7975930,27295,TNFRSF9,98,,8003225
7,73507485,29370,LIMK1,98,,73536855
4,3505323,28901,LRPAP1,98,,3534224
1,109941652,27418,PSMA5,98,,109969070
17,62015913,34365,SCN4A,98,,62050278
12,56556142,27216,SMARCC2,98,,56583358
21,43731776,3930,TFF3,98,,43735706
12,6976692,3418,TPI1,98,,6980110
4,41746098,4889,PHOX2B,98,,41750987
6,30695485,15143,FLOT1,98,,30710628
17,75277491,219187,9-Sep,98,,75496678
19,55141967,7014,LILRB1,98,,55148981
10,120927210,11167,PRDX3,98,,120938377
11,63952743,19277,STIP1,98,,63972020
17,30264028,64036,SUZ12,98,,30328064
15,50849355,129657,TRPM7,98,,50979012
1,203096835,39698,ADORA1,97,,203136533
11,13299273,109539,ARNTL,97,,13408812
12,6554050,6834,CD27,97,,6560884
18,55212072,41897,FECH,97,,55253969
11,71900958,6409,FOLR1,97,,71907367
6,53362139,47788,GCLC,97,,53409927
19,34856024,37294,GPI,97,,34893318
2,26413503,54091,HADHA,97,,26467594
16,85932773,23438,IRF8,97,,85956211
5,135227934,3582,IL9,97,,135231516
8,109213971,46988,EIF3E,97,,109260959
16,56642477,932,MT2A,97,,56643409
11,76839309,86977,MYO7A,97,,76926286
5,95726039,42946,PCSK1,97,,95768985
17,8043787,11966,PER1,97,,8055753
2,28974625,51181,PPP1CB,97,,29025806
1,151372040,2372,PSMB4,97,,151374412
12,122326636,29135,PSMD9,97,,122355771
7,39663151,84572,RALA,97,,39747723
1,185014550,57190,RNF2,97,,185071740
6,36562089,10155,SRSF3,97,,36572244
6,80714321,37923,TTK,97,,80752244
21,16333555,103571,NRIP1,97,,16437126
1,2487803,9258,TNFRSF14,97,,2497061
16,3115312,4356,IL32,97,,3119668
6,86317501,35139,SYNCRIP,97,,86352640
17,63005406,46486,GNA13,97,,63051892
20,1874812,45728,SIRPA,97,,1920540
19,4815935,15819,TICAM1,97,,4831754
X,118602362,2997,SLC25A5,96,,118605359
X,152760346,14666,BGN,96,,152775012
5,95997860,112525,CAST,96,,96110385
7,100400186,24957,EPHB4,96,,100425143
15,26788693,229530,GABRB3,96,,27018223
10,26505235,88256,GAD2,96,,26593491
4,158141735,145491,GRIA2,96,,158287226
2,121103717,5667,INHBB,96,,121109384
3,160212782,70594,KPNA4,96,,160283376
13,113951468,26273,LAMP1,96,,113977741
3,87308782,16955,POU1F1,96,,87325737
1,151955385,11329,S100A10,96,,151966714
8,22019183,2808,SFTPC,96,,22021991
12,98909350,34807,TMPO,96,,98944157
21,44513065,14623,U2AF1,96,,44527688
3,133319448,61289,TOPBP1,96,,133380737
6,41247276,7207,TREM1,96,,41254483
11,6416353,23988,APBB1,95,,6440341
1,36931643,17272,CSF3R,95,,36948915
12,5153084,2870,KCNA5,95,,5155954
19,55361897,16773,KIR3DL2,95,,55378670
5,79950466,222168,MSH3,95,,80172634
6,11183530,199051,NEDD9,95,,11382581
1,211831598,17374,NEK2,95,,211848972
18,61554938,16186,SERPINB2,95,,61571124
15,64448013,7341,PPIB,95,,64455354
8,26150731,79464,PPP2R2A,95,,26230195
22,50702141,6681,MAPK11,95,,50708822
8,117858172,28933,RAD21,95,,117887105
2,55459038,3951,RPS27A,95,,55462989
17,42282400,15850,UBTF,95,,42298250
18,51677970,73188,MBD2,95,,51751158
2,114648174,70955,ACTR3,95,,114719129
5,151151475,33440,G3BP1,95,,151184915
20,31407698,30513,MAPRE1,95,,31438211
12,20963637,106206,SLCO1B3,95,,21069843
7,151253200,258757,PRKAG2,95,,151511957
8,7738725,1455,DEFB103B,95,,7740180
20,61867234,4625,BIRC7,95,,61871859
2,148602085,86311,ACVR2A,94,,148688396
1,117297051,14800,CD2,94,,117311851
16,68678738,54232,CDH3,94,,68732970
19,52249022,6128,FPR1,94,,52255150
16,75661621,19964,KARS,94,,75681585
19,44270684,14725,KCNN4,94,,44285409
18,21452983,82046,LAMA3,94,,21535029
20,36974813,30840,LBP,94,,37005653
19,42905658,25920,LIPE,94,,42931578
17,8377522,156557,MYH10,94,,8534079
6,76458908,170346,MYO6,94,,76629254
11,72929342,24130,P2RY2,94,,72953472
12,1020901,37987,RAD52,94,,1058888
Y,535078,22480,SHOX,94,,557558
7,100218038,13235,TFR2,94,,100231273
19,15988833,20097,CYP4F2,94,,16008930
9,71736179,133945,TJP2,94,,71870124
5,138609440,57926,MATR3,94,,138667366
5,10250032,16492,CCT5,94,,10266524
20,8112911,752636,PLCB1,94,,8865547
16,88870185,5481,CDT1,94,,88875666
19,45251977,11324,BCL3,93,,45263301
16,28488599,14804,CLN3,93,,28503403
19,40325092,11962,FBL,93,,40337054
7,128470482,28846,FLNC,93,,128499328
17,39868577,3644,GAST,93,,39872221
7,2767740,35034,GNA12,93,,2802774
X,148558520,28364,IDS,93,,148586884
19,17927321,5062,INSL3,93,,17932383
12,52626953,15756,KRT7,93,,52642709
22,35796115,24380,MCM5,93,,35820495
X,38211735,68968,OTC,93,,38280703
1,155259083,12142,PKLR,93,,155271225
16,74330672,9514,PSMD7,93,,74340186
17,30771480,38857,PSMD11,93,,30810337
18,20513294,93155,RBBP8,93,,20606449
1,156278751,29455,CCT3,93,,156308206
2,102608305,32913,IL1R2,93,,102641218
X,119658445,36372,CUL4B,93,,119694817
13,111766965,180577,ARHGEF7,93,,111947542
2,65454828,43562,ACTR2,93,,65498390
1,11086579,20717,MASP2,93,,11107296
7,128594233,100994,TNPO3,93,,128695227
X,135951352,11587,RBMX,93,,135962939
5,31400601,131681,DROSHA,93,,31532282
10,95848782,239366,PLCE1,93,,96088148
8,103264501,160416,UBR5,93,,103424917
2,234590583,91362,UGT1A7,93,,234681945
2,111395274,40410,BUB1,92,,111435684
22,43547519,11729,TSPO,92,,43559248
14,103985994,3202,CKB,92,,103989196
11,44117746,149234,EXT2,92,,44266980
19,52264452,9327,FPR2,92,,52273779
6,38643701,27251,GLO1,92,,38670952
1,153634263,9241,ILF2,92,,153643504
12,21788275,22453,LDHB,92,,21810728
17,33307516,22675,LIG3,92,,33330191
8,15996825,53475,MSR1,92,,16050300
6,86159301,46208,NT5E,92,,86205509
4,152020724,5080,RPS3A,92,,152025804
1,153507075,1642,S100A6,92,,153508717
3,18386879,93386,SATB1,92,,18480265
X,12993225,2121,TMSB4X,92,,12995346
2,31557187,80424,XDH,92,,31637611
19,7828034,6457,CLEC4M,92,,7834491
19,45394476,12470,TOMM40,92,,45406946
5,33987090,21130,AMACR,92,,34008220
3,52719935,8575,GNL3,92,,52728510
19,4007595,31789,PIAS4,92,,4039384
16,46691890,31254,VPS35,92,,46723144
2,44039610,26348,ABCG5,92,,44065958
16,28943259,7409,CD19,91,,28950668
6,44355250,62911,CDC5L,91,,44418161
22,37309674,26805,CSF2RB,91,,37336479
7,101459183,442330,CUX1,91,,101901513
18,29077966,51004,DSG2,91,,29128970
11,62327072,14388,EEF1G,91,,62341460
3,57994126,163856,FLNB,91,,58157982
5,73980968,36145,HEXB,91,,74017113
19,48618701,55159,LIG1,91,,48673860
12,80167342,161893,PPP1R12A,91,,80329235
2,182540832,4560,NEUROD1,91,,182545392
1,164528596,292464,PBX1,91,,164821060
7,87031360,73659,ABCB4,91,,87105019
7,151163097,53913,RHEB,91,,151217010
22,24951617,19315,SNRPD3,91,,24970932
2,88856257,70837,EIF2AK3,91,,88927094
6,106632351,140959,ATG5,91,,106773310
1,161199455,8545,NR1I3,91,,161208000
17,79845710,3752,ALYREF,91,,79849462
22,39795758,32129,TAB1,91,,39827887
5,52776263,6041,FST,91,,52782304
12,69979461,15896,CCT2,91,,69995357
1,45205489,27949,KIF2C,91,,45233438
1,76190031,39332,ACADM,90,,76229363
2,27008882,8573,CENPA,90,,27017455
1,203185206,13654,CHIT1,90,,203198860
10,105791045,54593,COL17A1,90,,105845638
20,47662782,50715,CSE1L,90,,47713497
7,99302659,30164,CYP3A7,90,,99332823
8,143953772,7464,CYP11B1,90,,143961236
20,62119364,11304,EEF1A2,90,,62130668
1,31838099,8036,FABP3,90,,31846135
6,39016556,42523,GLP1R,90,,39059079
5,118788191,89839,HSD17B4,90,,118878030
21,34602199,32863,IFNAR2,90,,34635062
20,60884115,58253,LAMA5,90,,60942368
18,56995055,31453,LMAN1,90,,57026508
5,179220985,2528,LTC4S,90,,179223513
9,117085302,3457,ORM1,90,,117088759
12,56498102,9592,PA2G4,90,,56507694
14,95047705,11752,SERPINA5,90,,95059457
X,19362010,17816,PDHA1,90,,19379826
19,14544165,38514,PKN1,90,,14582679
1,214161277,53570,PROX1,90,,214214847
17,38137020,17193,PSMD3,90,,38154213
9,2621773,34330,VLDLR,90,,2656103
11,85668213,111926,PICALM,90,,85780139
22,38004480,25091,GGA1,90,,38029571
7,127292042,440619,SND1,90,,127732661
14,21484921,54110,NDRG2,90,,21539031
19,1103924,2864,GPX4,89,,1106788
4,100869243,2269,H2AFZ,89,,100871512
17,40336077,1393,HCRT,89,,40337470
12,69742133,5880,LYZ,89,,69748013
14,61201458,233940,MNAT1,89,,61435398
14,24605366,2810,PSME1,89,,24608176
19,47123724,4630,PTGIR,89,,47128354
9,136215068,3212,RPL7A,89,,136218280
4,74861358,3088,CXCL5,89,,74864446
16,56899118,50644,SLC12A3,89,,56949762
3,42530790,48275,VIPR1,89,,42579065
8,143761873,2272,PSCA,89,,143764145
X,40944887,150945,USP9X,89,,41095832
3,52435019,9102,BAP1,89,,52444121
9,36036909,87543,RECK,89,,36124452
X,41374188,408099,CASK,89,,41782287
19,16308664,37492,AP1M1,89,,16346156
11,62392297,21901,GANAB,89,,62414198
11,215029,21333,SIRT3,89,,236362
17,16842397,33005,TNFRSF13B,89,,16875402
11,68451942,6701,GAL,89,,68458643
4,9827847,214025,SLC2A9,89,,10041872
8,22462538,15445,CCAR2,89,,22477983
17,62540734,117652,SMURF2,89,,62658386
7,114055051,278776,FOXP2,89,,114333827
5,38938022,136488,RICTOR,89,,39074510
5,148808480,106,MIR143,89,,148808586
9,21994789,126304,CDKN2B-AS1,89,,22121093
14,96722546,8554,BDKRB1,88,,96731100
16,67063049,71909,CBFB,88,,67134958
7,50526133,102635,DDC,88,,50628768
10,124320180,83072,DMBT1,88,,124403252
8,26371708,143985,DPYSL2,88,,26515693
8,144661891,17954,EEF1D,88,,144679845
5,44305096,83688,FGF10,88,,44388784
8,145729464,3091,GPT,88,,145732555
11,5289579,1794,HBE1,88,,5291373
4,57898403,78148,IGFBP7,88,,57976551
19,18169804,28009,IL12RB1,88,,18197813
11,71935881,14307,INPPL1,88,,71950188
17,38974368,4495,KRT10,88,,38978863
17,39775691,5191,KRT17,88,,39780882
3,123331142,272007,MYLK,88,,123603149
12,5541279,63186,NTF3,88,,5604465
5,145969066,492017,PPP2R2B,88,,146461083
7,150035406,3357,RARRES2,88,,150038763
8,74202873,2996,RPL7,88,,74205869
3,23851933,81198,UBE2E1,88,,23933131
9,134000947,109110,NUP214,88,,134110057
17,63524682,33058,AXIN2,88,,63557740
1,242012032,41209,EXO1,88,,242053241
2,50145642,1114032,NRXN1,88,,51259674
1,161159518,9325,ADAMTS4,88,,161168843
9,117546914,7896,TNFSF15,88,,117554810
1,154245038,3317,HAX1,88,,154248355
18,51795848,28756,POLI,88,,51824604
11,113258512,12628,ANKK1,88,,113271140
17,15848230,30980,ADORA2B,87,,15879210
7,91828282,46946,KRIT1,87,,91875228
11,6633996,6696,TPP1,87,,6640692
7,30691558,48161,CRHR2,87,,30739719
2,208986330,2983,CRYGD,87,,208989313
11,71145456,14021,DHCR7,87,,71159477
1,27938800,14306,FGR,87,,27953106
10,71078602,83035,HK1,87,,71161637
3,11294384,10555,HRH1,87,,11304939
5,156607906,74203,ITK,87,,156682109
20,3190005,14511,ITPA,87,,3204516
13,50273442,93615,KPNA3,87,,50367057
19,16222489,21956,RAB8A,87,,16244445
3,152552481,6747,P2RY1,87,,152559228
8,17780365,107092,PCM1,87,,17887457
7,106685177,117079,PRKAR2B,87,,106802256
19,7968664,10704,MAP2K7,87,,7979368
X,153626405,4275,RPL10,87,,153630680
1,203830712,9568,SNRPE,87,,203840280
3,187386693,1508,SST,87,,187388201
12,104359592,23064,TDG,87,,104382656
6,144612872,561298,UTRN,87,,145174170
17,58677543,66097,PPM1D,87,,58743640
17,30814104,4167,CDK5R1,87,,30818271
1,7844488,60752,PER3,87,,7905240
5,134670070,64858,H2AFY,87,,134734928
9,36214438,62615,GNE,87,,36277053
19,6494329,8530,TUBB4A,87,,6502859
2,112656190,130755,MERTK,87,,112786945
7,142568955,14535,TRPV6,87,,142583490
9,139565053,85,MIR126,87,,139565138
X,45606420,110,MIR222,87,,45606530
2,74120092,26688,ACTG2,86,,74146780
9,33441151,6480,AQP3,86,,33447631
7,99564349,9386,AZGP1,86,,99573735
6,31698357,6738,CLIC1,86,,31705095
13,110959613,205943,COL4A2,86,,111165556
17,80200536,31058,CSNK1D,86,,80231594
17,62120389,87113,ERN1,86,,62207502
2,56093096,58202,EFEMP1,86,,56151298
1,171060017,26942,FMO3,86,,171086959
2,85771842,16815,GGCX,86,,85788657
19,3094407,29593,GNA11,86,,3124000
6,26055967,732,HIST1H1C,86,,26056699
6,32709162,5502,HLA-DQA2,86,,32714664
4,175411327,32722,HPGD,86,,175444049
1,120049825,7856,HSD3B1,86,,120057681
1,119957742,7920,HSD3B2,86,,119965662
4,110661847,61534,CFI,86,,110723381
3,49061761,5114,IMPDH2,86,,49066875
13,111367783,5638,ING1,86,,111373421
17,49242795,6310,NME2,86,,49249105
17,1646129,12430,SERPINF2,86,,1658559
4,86933448,440835,MAPK10,86,,87374283
4,87515467,220861,PTPN13,86,,87736328
12,112842984,4461,RPL6,86,,112847445
16,57392694,7408,CCL22,86,,57400102
8,59465727,29692,SDCBP,86,,59495419
16,1128780,2674,SSTR5,86,,1131454
19,39936185,31123,SUPT5H,86,,39967308
1,223967594,66080,TP53BP2,86,,224033674
20,56964174,61982,VAPB,86,,57026156
14,91334465,192528,RPS6KA5,86,,91526993
2,231772042,17899,GPR55,86,,231789941
2,62095261,20545,CCT4,86,,62115806
11,11984542,45644,DKK3,86,,12030186
6,24775158,11167,GMNN,86,,24786325
1,160846329,8631,ITLN1,86,,160854960
2,234826042,102124,TRPM8,86,,234928166
6,52101483,7815,IL17F,86,,52109298
4,95679127,400474,BMPR1B,85,,96079601
6,56322784,496642,DST,85,,56819426
7,93053798,150244,CALCR,85,,93204042
11,14479048,42393,COPB1,85,,14521441
2,15731744,39491,DDX1,85,,15771235
X,135279054,14464,FHL1,85,,135293518
16,86600856,1681,FOXC2,85,,86602537
21,34775201,34627,IFNGR2,85,,34809828
6,33589155,75193,ITPR3,85,,33664348
1,182992594,122133,LAMC1,85,,183114727
2,210288770,310064,MAP2,85,,210598834
2,66662531,137360,MEIS1,85,,66799891
20,42295658,49478,MYBL2,85,,42345136
6,41040706,29440,NFYA,85,,41070146
X,22050561,218866,PHEX,85,,22269427
6,118869425,13453,PLN,85,,118882878
5,149823791,5528,RPS14,85,,149829319
1,153600872,3641,S100A1,85,,153604513
10,88718287,4730,SNCG,85,,88723017
14,65233116,56750,SPTB,85,,65289866
18,44383187,114308,PIAS2,85,,44497495
7,83587658,236559,SEMA3A,85,,83824217
11,62559597,13367,NXF1,85,,62572964
12,7074514,5402,PHB2,85,,7079916
12,48176493,37270,HDAC7,85,,48213763
17,37784750,8128,PPP1R1B,85,,37792878
11,64894750,7253,SYVN1,85,,64902003
9,96938238,80,MIRLET7A1,85,,96938318
13,50623108,89,MIR16-1,85,,50623197
7,130561505,64,MIR29A,85,,130561569
17,35441926,324976,ACACA,84,,35766902
4,3768295,1958,ADRA2C,84,,3770253
20,32868070,23247,AHCY,84,,32891317
5,150480266,57177,ANXA6,84,,150537443
7,116139654,8941,CAV2,84,,116148595
13,26828240,151133,CDK8,84,,26979373
10,50822082,51068,CHAT,84,,50873150
11,58390145,3060,CNTF,84,,58393205
2,121554866,195363,GLI2,84,,121750229
16,56225250,166106,GNAO1,84,,56391356
12,6484533,16204,LTBR,84,,6500737
15,66994673,79664,SMAD6,84,,67074337
10,51549552,12966,MSMB,84,,51562518
8,23536205,4197,NKX3-1,84,,23540402
17,21191347,27204,MAP2K3,84,,21218551
17,36908965,11519,PSMB3,84,,36920484
9,127115743,62009,PSMB7,84,,127177752
X,71492452,4689,RPS4X,84,,71497141
6,33161361,7112,RXRB,84,,33168473
17,38783975,20128,SMARCE1,84,,38804103
19,46190711,4863,SNRPD2,84,,46195574
3,52485106,2951,TNNC1,84,,52488057
9,136627015,230431,VAV2,84,,136857446
6,13621729,90067,RANBP9,84,,13711796
16,3708037,59561,TRAP1,84,,3767598
12,50382944,36396,RACGAP1,84,,50419340
2,60678301,102332,BCL11A,84,,60780633
10,34398487,705766,PARD3,84,,35104253
11,568088,110,MIR210,84,,568198
3,179280667,25526,ACTL6A,83,,179306193
1,203595914,117295,ATP2B4,83,,203713209
11,68522087,87312,CPT1A,83,,68609399
1,60358979,33491,CYP2J2,83,,60392470
15,91428275,10731,FES,83,,91439006
16,31366454,27864,ITGAX,83,,31394318
10,32297937,47434,KIF5B,83,,32345371
3,47892179,238590,MAP4,83,,48130769
12,15034114,4739,MGP,83,,15038853
Y,2559173,50177,CD99,83,,2609350
12,51379774,40425,SLC11A2,83,,51420199
11,17108123,121420,PIK3C2A,83,,17229543
1,71418114,95377,PTGER3,83,,71513491
17,32597234,2027,CCL7,83,,32599261
9,4490426,97043,SLC1A1,83,,4587469
5,6633434,36241,SRD5A1,83,,6669675
20,43595114,113504,STK4,83,,43708618
6,33267471,14693,TAPBP,83,,33282164
1,211500147,48139,TRAF5,83,,211548286
11,65659606,8391,FOSL1,83,,65667997
15,42787503,37756,SNAP23,83,,42825259
15,49417470,30384,COPS2,83,,49447854
20,44098393,11779,WFDC2,83,,44110172
17,4442190,16491,MYBBP1A,83,,4458681
19,54618789,16361,PRPF31,83,,54635150
17,4574678,32954,PELP1,83,,4607632
8,61591323,189263,CHD7,83,,61780586
20,30946146,14206,ASXL1,83,,30960352
7,27870192,350245,JAZF1,83,,28220437
19,13947253,78,MIR27A,83,,13947331
1,159557615,1046,APCS,82,,159558661
15,80253231,10412,BCL2A1,82,,80263643
21,45193545,2711,CSTB,82,,45196256
4,71859264,37365,DCK,82,,71896629
5,160715435,259695,GABRB2,82,,160975130
1,161494329,2358,HSPA6,82,,161496687
7,107564245,79559,LAMB1,82,,107643804
6,168227670,138123,MLLT4,82,,168365793
12,113344581,13131,OAS1,82,,113357712
8,30643125,27227,PPP2CB,82,,30670352
1,28473676,29779,PTAFR,82,,28503455
16,2012061,2766,RPS2,82,,2014827
2,40339285,318159,SLC8A1,82,,40657444
6,35800810,88147,SRPK1,82,,35888957
5,68660569,5271,TAF9,82,,68665840
X,48886237,14806,TFE3,82,,48901043
1,186280785,63672,TPR,82,,186344457
22,36649116,14461,APOL1,82,,36663577
2,206547223,115634,NRP2,82,,206662857
10,70716195,28630,DDX21,82,,70744825
17,54671059,1892,NOG,82,,54672951
17,42927654,49339,EFTUD2,82,,42976993
17,8924858,222459,NTN1,82,,9147317
17,78109012,11970,EIF4A3,82,,78120982
19,39616419,53627,PAK4,82,,39670046
18,2571509,45125,NDC80,82,,2616634
17,43224683,4785,HEXIM1,82,,43229468
11,65819815,16567,SF3B2,82,,65836382
14,103058995,137918,RCOR1,82,,103196913
7,145813452,2304636,CNTNAP2,82,,148118088
17,7788122,27953,CHD3,81,,7816075
2,88422507,5143,FABP1,81,,88427650
19,50015535,14150,FCGRT,81,,50029685
1,241660856,22229,FH,81,,241683085
1,111215073,2582,KCNA3,81,,111217655
9,100395704,40325,NCBP1,81,,100436029
2,10580496,8184,ODC1,81,,10588680
1,66797790,42472,PDE4B,81,,66840262
20,1959401,14051,PDYN,81,,1973452
19,33877854,134945,PEPD,81,,34012799
4,74852155,1752,PPBP,81,,74853907
12,53604349,21691,RARG,81,,53626040
19,5623045,45444,SAFB,81,,5668489
11,119288650,6188,THY1,81,,119294838
22,19510546,2314,CLDN5,81,,19512860
1,149804220,396,HIST2H4A,81,,149804616
12,93964174,6347,SOCS2,81,,93970521
15,28356182,211116,HERC2,81,,28567298
3,63996224,13058,PSMD6,81,,64009282
2,44113362,109782,LRPPRC,81,,44223144
7,95749531,201928,SLC25A13,81,,95951459
3,195590235,32197,TNK2,81,,195622432
5,150409503,51142,TNIP1,81,,150460645
2,73461363,18787,CCT7,81,,73480150
21,30428642,17476,CCT8,81,,30446118
X,77526968,56220,CYSLTR1,81,,77583188
1,7907671,5433,UTS2,81,,7913104
12,65444403,70943,WIF1,81,,65515346
6,47445524,149472,CD2AP,81,,47594996
7,124462439,107598,POT1,81,,124570037
12,119616594,15957,HSPB8,81,,119632551
22,39410264,4561,APOBEC3C,81,,39414825
2,118845993,21614,INSIG2,81,,118867607
1,160799949,32743,CD244,81,,160832692
12,10269375,13493,CLEC7A,81,,10282868
22,51113069,58571,SHANK3,81,,51171640
11,107992257,26634,ACAT1,80,,108018891
17,40023178,52094,ACLY,80,,40075272
11,925808,86437,AP2A2,80,,1012245
2,241808161,10375,AGXT,80,,241818536
9,133320093,56568,ASS1,80,,133376661
7,44256748,108482,CAMK2B,80,,44365230
1,158223926,4132,CD1A,80,,158228058
10,97471535,165488,ENTPD1,80,,97637023
X,49832214,31678,CLCN5,80,,49863892
21,35888739,97403,RCAN1,80,,35986142
18,28898051,41158,DSG1,80,,28939209
1,1270657,13835,DVL1,80,,1284492
1,216676587,634510,ESRRG,80,,217311097
19,10444451,6059,ICAM3,80,,10450510
2,160956176,100648,ITGB6,80,,161056824
1,209788217,37603,LAMB3,80,,209825820
17,76967334,8727,LGALS3BP,80,,76976061
X,24712063,303039,POLA1,80,,25015102
20,62159775,8948,PTK6,80,,62168723
7,77167351,102037,PTPN12,80,,77269388
20,2844840,174475,PTPRA,80,,3019315
12,7342957,21122,PEX5,80,,7364079
2,65313987,43448,RAB1A,80,,65357435
17,34391631,7210,CCL18,80,,34398841
3,170077410,37227,SKIL,80,,170114637
5,472100,52449,SLC9A3,80,,524549
10,119000583,38358,SLC18A2,80,,119038941
6,160637793,42170,SLC22A2,80,,160679963
7,128828712,24673,SMO,80,,128853385
20,47729875,75032,STAU1,80,,47804907
17,76170159,13126,TK1,80,,76183285
1,1146705,2843,TNFRSF4,80,,1149548
17,17149937,34075,COPS3,80,,17184012
19,6413118,11704,KHSRP,80,,6424822
8,9413444,226412,TNKS,80,,9639856
8,37963310,34288,ASH2L,80,,37997598
10,124913759,11127,BUB3,80,,124924886
1,162332772,7041,NOS1AP,80,,162339813
1,27730729,85969,WASF2,80,,27816698
1,50906934,519002,FAF1,80,,51425936
5,171288555,145322,FBXW11,80,,171433877
11,60658019,16042,PRPF19,80,,60674061
5,176332005,101790,UIMC1,80,,176433795
17,39032140,9355,KRT20,80,,39041495
6,31620186,5801,APOM,80,,31625987
1,9908333,61983,CTNNBIP1,80,,9970316
3,132036210,41480,ACPP,79,,132077690
22,29723668,60904,AP1B1,79,,29784572
1,115215719,22520,AMPD1,79,,115238239
12,89981825,68019,ATP2B1,79,,90049844
16,55836763,30312,CES1,79,,55867075
19,45809670,16565,CKM,79,,45826235
10,30722949,27813,MAP3K8,79,,30750762
2,74776146,8532,DOK1,79,,74784678
18,29027731,30934,DSG3,79,,29058665
11,63606399,72093,MARK2,79,,63678492
22,45898718,60524,FBLN1,79,,45959242
4,145030455,31484,GYPA,79,,145061939
5,147861114,172976,HTR4,79,,148034090
3,3108007,44051,IL5RA,79,,3152058
20,54823787,1084,MC3R,79,,54824871
5,174151574,6328,MSX2,79,,174157902
19,46850250,43982,PPP5C,79,,46894232
1,36065142,42010,PSMB2,79,,36107152
19,39923776,2884,RPS16,79,,39926660
22,32439018,69993,SLC5A1,79,,32509011
5,149737201,42670,TCOF1,79,,149779871
14,23789396,5998,PABPN1,79,,23795394
4,120415549,134432,PDE5A,79,,120549981
17,48712217,33071,ABCC3,79,,48745288
13,113812967,13731,PROZ,79,,113826698
8,110552854,25371,EBAG9,79,,110578225
16,2076868,12159,SLC9A3R2,79,,2089027
18,67530192,94220,CD226,79,,67624412
7,99686582,3240,COPS6,79,,99689822
17,5404718,83114,NLRP1,79,,5487832
14,78183943,43554,SNW1,79,,78227497
8,144873089,24460,SCRIB,79,,144897549
1,67873492,22631,SERBP1,79,,67896123
20,50399255,19807,SALL4,79,,50419062
14,34393420,26864,EGLN3,79,,34420284
12,54385521,110,MIR196A2,79,,54385631
1,209605477,110,MIR205,79,,209605587
10,61786055,114719,ANK3,78,,61900774
X,7137471,135213,STS,78,,7272684
7,73183326,1274,CLDN3,78,,73184600
X,110537006,117368,DCX,78,,110654374
X,68835910,423411,EDA,78,,69259321
8,118811601,312457,EXT1,78,,119124058
4,46245564,146521,GABRA2,78,,46392085
6,101846860,671098,GRIK2,78,,102517958
8,30535579,49907,GSR,78,,30585486
X,53458205,3118,HSD17B10,78,,53461323
11,111783459,1358,HSPB2,78,,111784817
1,23884420,1865,ID3,78,,23886285
17,38599675,14307,IGFBP4,78,,38613982
10,5994333,25817,IL15RA,78,,6020150
12,96394530,34909,LTA4H,78,,96429439
17,43138666,47716,NMT1,78,,43186382
7,129269918,127004,NRF1,78,,129396922
12,86268072,8698,NTS,78,,86276770
1,204391757,67717,PIK3C2B,78,,204459474
17,65334031,28712,PSMD12,78,,65362743
20,48120410,64297,PTGIS,78,,48184707
11,73386682,85519,RAB6A,78,,73472201
22,39708886,6784,RPL3,78,,39715670
1,45241245,3167,RPS8,78,,45244412
2,166095911,152909,SCN2A,78,,166248820
4,76954839,2511,CXCL11,78,,76957350
5,218337,38860,SDHA,78,,257197
5,36606456,81980,SLC1A3,78,,36688436
18,19192229,17977,SNRPD1,78,,19210206
6,21593971,4878,SOX4,78,,21598849
9,130374485,80510,STXBP1,78,,130454995
7,99704692,12789,TAF6,78,,99717481
9,35682922,7131,TPM2,78,,35690053
3,14989090,101696,NR2C2,78,,15090786
21,45773483,89481,TRPM2,78,,45862964
16,28853731,3998,TUFM,78,,28857729
9,111629799,66813,IKBKAP,78,,111696612
19,6661263,9336,TNFSF14,78,,6670599
1,155916629,31707,ARHGEF2,78,,155948336
2,188206689,106332,CALCRL,78,,188313021
1,23631180,39677,HNRNPR,78,,23670857
19,16435636,3837,KLF2,78,,16439473
1,145575987,10559,PIAS3,78,,145586546
8,87354993,125185,WWP1,78,,87480178
8,70378858,194289,SULF1,78,,70573147
1,32573643,68525,KPNA6,78,,32642168
11,69924407,111245,ANO1,78,,70035652
12,133416937,47267,CHFR,78,,133464204
12,67663060,45412,CAND1,78,,67708472
9,104331633,169229,GRIN3A,78,,104500862
11,129939715,74991,APLP2,77,,130014706
3,195295572,15504,APOD,77,,195311076
5,78407603,20510,BHMT,77,,78428113
11,60869929,25394,CD5,77,,60895323
19,6585849,5314,CD70,77,,6591163
2,211342405,201426,CPS1,77,,211543831
X,153845864,1658,CTAG1B,77,,153847522
11,118618472,43185,DDX6,77,,118661657
10,64571755,4385,EGR2,77,,64576140
7,31003635,15511,GHRHR,77,,31019146
1,182347227,14114,GLUL,77,,182361341
7,100271362,5430,GNB2,77,,100276792
9,134452156,160769,RAPGEF1,77,,134612925
11,102641232,10127,MMP10,77,,102651359
3,49721379,4817,MST1,77,,49726196
15,52599479,221768,MYO5A,77,,52821247
8,54138275,25982,OPRK1,77,,54164257
14,37126772,20239,PAX9,77,,37147011
11,111608604,28565,PPP2R1B,77,,111637169
1,84629866,74315,PRKACB,77,,84704181
19,38865189,9275,PSMD8,77,,38874464
11,236807,16177,PSMD13,77,,252984
19,45147097,22331,PVR,77,,45169428
12,69004618,49767,RAP1B,77,,69054385
9,5299865,4746,RLN2,77,,5304611
2,10262862,8684,RRM2,77,,10271546
1,165370158,44434,RXRG,77,,165414592
5,42799981,12043,SEPP1,77,,42812024
2,231280870,129447,SP100,77,,231410317
12,79257772,588016,SYT1,77,,79845788
19,18682611,5659,UBA52,77,,18688270
12,71833549,146539,LGR5,77,,71980088
4,107236766,33615,AIMP1,77,,107270381
X,152965946,23636,BCAP31,77,,152989582
19,14588570,18391,GIPC1,77,,14606961
16,3070312,2071,TNFRSF12A,77,,3072383
12,50355278,4187,AQP5,76,,50359465
14,94770584,19104,SERPINA6,76,,94789688
4,26483017,9025,CCKAR,76,,26492042
11,88053978,16977,CTSC,76,,88070955
21,47401662,23301,COL6A1,76,,47424963
4,24529087,57097,DHX15,76,,24586184
5,140894587,104035,DIAPH1,76,,140998622
17,7128660,9203,DVL2,76,,7137863
17,41605210,18590,ETV4,76,,41623800
7,50657759,142291,GRB10,76,,50800050
17,72838161,17846,GRIN2C,76,,72856007
6,32971959,5430,HLA-DOA,76,,32977389
17,25958173,18413,LGALS9,76,,25976586
12,91497231,8311,LUM,76,,91505542
11,65365225,16495,MAP3K11,76,,65381720
2,232786803,4310,NPPC,76,,232791113
17,44668034,166794,NSF,76,,44834828
1,229406808,34832,RAB4A,76,,229441640
17,56769933,2808,RAD51C,76,,56772741
3,78646387,422222,ROBO1,76,,79068609
15,66791652,5541,RPL4,76,,66797193
3,128338812,30907,RPN1,76,,128369719
19,54704725,6790,RPS9,76,,54711515
15,82821157,3795,RPS17,76,,82824952
4,6695565,3332,S100P,76,,6698897
20,42086503,5741,SRSF6,76,,42092244
16,31483475,5806,TGFB1I1,76,,31489281
16,1290677,1878,TPSAB1,76,,1292555
1,216347291,249447,USH2A,76,,216596738
14,73741917,183369,NUMB,76,,73925286
16,1203240,68532,CACNA1H,76,,1271772
8,72933485,54334,TRPA1,76,,72987819
8,145736666,6544,RECQL4,76,,145743210
1,145507556,5979,RBM8A,76,,145513535
10,27035524,114492,ABI1,76,,27150016
14,21819630,32795,SUPT16H,76,,21852425
3,130612858,122697,ATP2C1,76,,130735555
6,170591293,8404,DLL1,76,,170599697
12,110813271,28264,ANAPC7,76,,110841535
11,1295597,35295,TOLLIP,76,,1330892
11,818900,6671,PNPLA2,76,,825571
7,2945709,137870,CARD11,76,,3083579
19,917341,3674,KISS1R,76,,921015
12,49658781,8340,TUBA1C,76,,49667121
19,41305333,9013,EGLN2,76,,41314346
2,27440257,26403,CAD,75,,27466660
1,20915443,29957,CDA,75,,20945400
1,28844744,20964,RCC1,75,,28865708
1,154947117,4608,CKS1B,75,,154951725
11,30252562,4262,FSHB,75,,30256824
5,132196873,5703,GDF9,75,,132202576
9,131018107,20161,GOLGA2,75,,131038268
5,70330950,32547,GTF2H2,75,,70363497
6,114178513,6139,MARCKS,75,,114184652
X,70315998,7386,FOXO4,75,,70323384
16,15796991,153896,MYH11,75,,15950887
19,42259427,16686,CEACAM6,75,,42276113
11,17298285,54785,NUCB2,75,,17353070
20,43803539,1646,PI3,75,,43805185
1,207101866,17945,PIGR,75,,207119811
12,49396054,16575,PRKAG1,75,,49412629
3,186964141,45669,MASP1,75,,187009810
3,186507681,16609,RFC4,75,,186524290
22,50691330,8858,MAPK12,75,,50700188
18,61322430,6767,SERPINB3,75,,61329197
3,185632357,23567,TRA2B,75,,185655924
16,31044811,6677,STX4,75,,31051488
9,12693385,16881,TYRP1,75,,12710266
10,76969911,21295,VDAC2,75,,76991206
1,203274663,4066,BTG2,75,,203278729
1,32687184,10021,EIF3I,75,,32697205
10,104005254,137402,GBF1,75,,104142656
11,65769549,2068,BANF1,75,,65771617
7,94214535,70986,SGCE,75,,94285521
6,37321747,40767,RNF8,75,,37362514
19,33072093,6265,PDCD5,75,,33078358
17,37006320,3733,RPL23,75,,37010053
1,36348795,41104,AGO1,75,,36389899
9,140069235,13822,ANAPC2,75,,140083057
15,41221530,9728,DLL4,75,,41231258
22,40806284,53160,MKL1,75,,40859444
16,333117,4092,PDIA2,75,,337209
1,26737258,18961,LIN28A,75,,26756219
7,34697896,191694,NPSR1,75,,34889590
12,7072861,68,MIR200C,75,,7072929
1,179068461,43763,ABL2,74,,179112224
Y,1455044,5995,SLC25A6,74,,1461039
11,46698624,23591,ARHGAP1,74,,46722215
12,103351451,2843,ASCL1,74,,103354294
2,227867426,161849,COL4A4,74,,228029275
11,45868668,36131,CRY2,74,,45904799
17,61972267,1754,CSH1,74,,61974021
22,43013845,31560,CYB5R3,74,,43045405
12,89741601,5035,DUSP6,74,,89746636
1,155100348,7038,EFNA1,74,,155107386
12,53585101,15990,ITGB7,74,,53601091
11,128761312,26639,KCNJ5,74,,128787951
19,51376688,7135,KLK2,74,,51383823
1,59041094,2072,TACSTD2,74,,59043166
18,13882042,33493,MC2R,74,,13915535
12,110011499,23576,MVK,74,,110035075
22,37257029,17030,NCF4,74,,37274059
8,120428551,8127,NOV,74,,120436678
1,153651163,15305,NPR1,74,,153666468
9,94484877,227567,ROR2,74,,94712444
9,78505559,471696,PCSK5,74,,78977255
1,145727665,36541,PDZK1,74,,145764206
19,51461886,10342,KLK6,74,,51472228
17,4699438,2360,PSMB6,74,,4701798
5,139493707,5294,PURA,74,,139499001
2,79347583,2962,REG1A,74,,79350545
1,25688739,58624,RHCE,74,,25747363
2,3622852,5657,RPS7,74,,3628509
1,153346183,1892,S100A12,74,,153348075
21,35014783,196019,ITSN1,74,,35210802
12,8071823,17069,SLC2A3,74,,8088892
5,127419482,105898,SLC12A2,74,,127525380
15,25200039,23831,SNRPN,74,,25223870
7,141438406,11882,SSBP1,74,,141450288
17,54965269,26140,TRIM25,74,,54991409
7,2394473,25904,EIF3B,74,,2420377
13,115000319,37882,CDC16,74,,115038201
1,36690016,80941,THRAP3,74,,36770957
21,35736322,7118,KCNE2,74,,35743440
22,30727976,24960,SF3A1,74,,30752936
17,79008946,82286,BAIAP2,74,,79091232
7,16832263,12475,AGR2,74,,16844738
1,112298189,12010,DDX20,74,,112310199
22,22890117,11651,PRAME,74,,22901768
13,23902961,46721,SACS,74,,23949682
7,73007523,31347,MLXIPL,74,,73038870
1,22443797,25722,WNT4,74,,22469519
3,108268717,39774,KIAA1524,74,,108308491
20,361272,16931,TRIB3,74,,378203
2,112525213,116528,ANAPC1,74,,112641741
17,17124484,16018,FLCN,74,,17140502
19,11685474,4121,ACP5,73,,11689595
5,110559934,270648,CAMK4,73,,110830582
4,114372187,310896,CAMK2D,73,,114683083
1,160258376,54978,COPA,73,,160313354
1,53662100,17769,CPT2,73,,53679869
12,109273856,20854,DAO,73,,109294710
X,68048839,13167,EFNB1,73,,68062006
1,35258598,2750,GJA4,73,,35261348
10,120967196,247935,GRK5,73,,121215131
6,30875976,5904,GTF2H4,73,,30881880
20,22561641,3460,FOXA2,73,,22565101
2,219919141,6097,IHH,73,,219925238
1,154669941,172813,KCNN3,73,,154842754
16,128168,7682,MPG,73,,135850
10,17851341,348750,MRC1,73,,18200091
2,242254601,38840,2-Sep,73,,242293441
14,20937537,8628,PNP,73,,20946165
12,32943679,106101,PKP2,73,,33049780
11,48002109,152157,PTPRJ,73,,48154266
22,20103460,11420,RANBP1,73,,20114880
2,38970740,7896,SRSF7,73,,38978636
19,2754711,28643,SGTA,73,,2783354
3,170714136,30632,SLC2A2,73,,170744768
12,114791734,54513,TBX5,73,,114846247
6,50786438,28888,TFAP2B,73,,50815326
18,3449410,8996,TGIF1,73,,3458406
22,19437463,29275,UFD1L,73,,19466738
1,53708040,85781,LRP8,73,,53793821
2,179296140,19344,PRKRA,73,,179315484
1,160175108,10058,PEA15,73,,160185166
1,40026484,16037,PABPC4,73,,40042521
11,65729159,18448,SART1,73,,65747607
7,75398841,20223,CCL26,73,,75419064
X,23685644,18870,PRDX4,73,,23704514
11,47487488,23088,CELF1,73,,47510576
16,69599868,138701,NFAT5,73,,69738569
13,31709110,27048,HSPH1,73,,31736158
20,30326903,62700,TPX2,73,,30389603
1,10270763,170898,KIF1B,73,,10441661
18,5392379,148176,EPB41L3,73,,5540555
16,11038344,181857,CLEC16A,73,,11220201
19,18642561,11845,FKBP8,73,,18654406
10,103338638,9389,POLL,73,,103348027
12,6759703,12605,ING4,73,,6772308
16,87425800,12580,MAP1LC3B,73,,87438380
14,94953619,30562,SERPINA12,73,,94984181
9,32384600,66232,ACO1,72,,32450832
16,71762904,80072,AP1G1,72,,71842976
8,41510743,144397,ANK1,72,,41655140
1,169075946,26014,ATP1B1,72,,169101960
21,30671115,47354,BACH1,72,,30718469
1,214776531,61383,CENPF,72,,214837914
16,3702939,5157,DNASE1,72,,3708096
12,7033625,17859,ATN1,72,,7051484
17,27206356,18359,FLOT2,72,,27224715
19,5842898,8587,FUT3,72,,5851485
4,39699663,84747,UBE2K,72,,39784410
1,67773046,89537,IL12RB2,72,,67862583
7,2281856,8924,NUDT1,72,,2290780
X,43808023,24898,NDP,72,,43832921
2,224839764,64272,SERPINE2,72,,224904036
3,146232966,29662,PLSCR1,72,,146262628
14,24612573,3282,PSME2,72,,24615855
16,89627064,6173,RPL13,72,,89633237
1,152004981,4530,S100A11,72,,152009511
9,34689566,1708,CCL19,72,,34691274
9,17578951,218175,SH3GL2,72,,17797126
13,99336054,68875,SLC15A1,72,,99404929
Y,59213948,62491,VAMP7,72,,59276439
7,139528951,191174,TBXAS1,72,,139720125
15,96869156,14336,NR2F2,72,,96883492
9,84198597,105853,TLE1,72,,84304450
12,6961284,14511,USP5,72,,6975795
10,103911932,11696,NOLC1,72,,103923628
12,111843751,45676,SH2B3,72,,111889427
7,157129709,49309,DNAJB6,72,,157179018
3,57261764,45734,APPL1,72,,57307498
12,88442789,93204,CEP290,72,,88535993
4,38773859,10752,TLR10,72,,38784611
X,65238711,110,MIR223,72,,65238821
12,51157788,57155,ATF1,71,,51214943
21,37442221,3254,CBR1,71,,37445475
7,56119377,12305,CCT6A,71,,56131682
1,1570602,85257,CDK11B,71,,1655859
3,122044010,16805,CSTA,71,,122060815
2,219646471,33545,CYP27A1,71,,219680016
1,220141941,78059,EPRS,71,,220220000
2,163027193,72852,FAP,71,,163100045
X,153665258,6556,GDI1,71,,153671814
9,33110638,56718,B4GALT1,71,,33167356
7,86273229,220963,GRM3,71,,86494192
11,88237743,559103,GRM5,71,,88796846
4,174252526,2983,HMGB2,71,,174255509
5,162887516,31437,HMMR,71,,162918953
2,198364720,3467,HSPE1,71,,198368187
1,19991779,15680,HTR6,71,,20007459
9,21367370,705,IFNA13,71,,21368075
16,79627744,6878,MAF,71,,79634622
X,128674251,52279,OCRL,71,,128726530
12,133200347,63763,POLE,71,,133264110
3,150458909,22354,SIAH2,71,,150481263
11,64532075,13863,SF1,71,,64545938
7,143078359,9847,ZYX,71,,143088206
17,55015560,22851,COIL,71,,55038411
8,117657054,111008,EIF3H,71,,117768062
4,72053002,384802,SLC4A4,71,,72437804
1,155023747,11505,ADAM15,71,,155035252
2,102972742,42493,IL18R1,71,,103015235
1,78414086,30803,FUBP1,71,,78444889
19,4402659,40735,CHAF1A,71,,4443394
9,34634718,3105,SIGMAR1,71,,34637823
12,69633316,34822,CPSF6,71,,69668138
17,7143737,2016,GABARAP,71,,7145753
16,70557690,53881,SF3B3,71,,70611571
1,120254418,32431,PHGDH,71,,120286849
1,63063157,8819,ANGPTL3,71,,63071976
19,1576669,16091,MBD3,71,,1592760
14,52327021,109497,GNG2,71,,52436518
10,102295640,18041,HIF1AN,71,,102313681
1,225674531,166314,ENAH,71,,225840845
10,102747292,6866,C10orf2,71,,102754158
10,14946609,49822,DCLRE1C,71,,14996431
11,62283373,30959,AHNAK,71,,62314332
8,6264112,40828,MCPH1,71,,6304940
1,157647977,22670,FCRL3,71,,157670647
18,6941742,176071,LAMA1,71,,7117813
9,21512113,71,MIR31,71,,21512184
1,207277606,40711,C4BPA,70,,207318317
3,32993065,3338,CCR4,70,,32996403
17,7163221,3291,CLDN7,70,,7166512
19,55385548,17238,FCAR,70,,55402786
2,191745546,54469,GLS,70,,191800015
5,95149552,9025,GLRX,70,,95158577
19,48898131,50057,GRIN2D,70,,48948188
1,156711898,10342,HDGF,70,,156722240
8,133133104,326405,KCNQ3,70,,133459509
19,39390339,9195,NFKBIB,70,,39399534
10,3110818,68179,PFKP,70,,3178997
11,64513860,14327,PYGM,70,,64528187
11,36613492,6337,RAG2,70,,36619829
6,42664332,26026,PRPH2,70,,42690358
14,61111416,4739,SIX1,70,,61116155
6,169615874,38335,THBS2,70,,169654209
2,70436575,39204,TIA1,70,,70475779
1,115572444,4486,TSHB,70,,115576930
12,93166284,156823,EEA1,70,,93323107
16,4475805,30970,DNAJA3,70,,4506775
10,79550548,135800,DLG5,70,,79686348
20,34291530,38728,RBM39,70,,34330258
2,10923516,49095,PDIA6,70,,10972611
14,92335754,78292,FBLN5,70,,92414046
3,48506918,2126,TREX1,70,,48509044
15,33010204,16666,GREM1,70,,33026870
5,74807574,94070,POLK,70,,74901644
16,75681634,9707,TERF2IP,70,,75691341
18,22040592,19329,HRH4,70,,22059921
22,37461475,44128,TMPRSS6,70,,37505603
2,178077421,11266,HNRNPA3,70,,178088687
6,31582985,1817,AIF1,69,,31584802
7,38423296,247871,AMPH,69,,38671167
22,43506753,18965,BIK,69,,43525718
16,71392615,31727,CALB2,69,,71424342
7,134464163,191317,CALD1,69,,134655480
12,9905081,8416,CD69,69,,9913497
8,48649475,1251,CEBPD,69,,48650726
17,40118758,10996,CNP,69,,40129754
10,128593977,656804,DOCK1,69,,129250781
3,172468474,70790,ECT2,69,,172539264
20,57875481,25566,EDN3,69,,57901047
1,147228331,17135,GJA5,69,,147245466
5,150399972,8582,GPX3,69,,150408554
6,32780539,4286,HLA-DOB,69,,32784825
9,21409145,1039,IFNA8,69,,21410184
6,129204285,633425,LAMA2,69,,129837710
5,71403094,102303,MAP1B,69,,71505397
4,187454808,21913,MTNR1A,69,,187476721
19,45349392,43093,PVRL2,69,,45392485
1,205055269,35881,RBBP5,69,,205091150
11,809935,2941,RPLP2,69,,812876
X,23801274,3066,SAT1,69,,23804340
3,63850232,138904,ATXN7,69,,63989136
X,18460343,211406,CDKL5,69,,18671749
20,60549853,91013,TAF4,69,,60640866
12,53894704,5511,TARBP2,69,,53900215
3,53259652,30478,TKT,69,,53290130
19,35759880,10844,USF2,69,,35770724
10,16865964,305852,CUBN,69,,17171816
17,77806954,6259,CBX4,69,,77813213
6,14117864,19284,CD83,69,,14137148
21,28208605,9123,ADAMTS1,69,,28217728
7,91570188,169799,AKAP9,69,,91739987
19,45882891,26716,PPP1R13L,69,,45909607
14,50999799,99985,ATL1,69,,51099784
8,2792874,2059454,CSMD1,69,,4852328
15,73976621,30238,CD276,69,,74006859
5,1317858,27327,CLPTM1L,69,,1345185
16,29823408,3794,PRRT2,69,,29827202
6,31556659,4103,NCR3,69,,31560762
1,1102483,95,MIR200B,69,,1102578
4,113739238,565658,ANK2,68,,114304896
2,69969105,84504,ANXA4,68,,70053609
19,42470733,26886,ATP1A3,68,,42497619
14,23776068,4900,BCL2L2,68,,23780968
8,11351520,70588,BLK,68,,11422108
1,22970117,4486,C1QC,68,,22974603
1,51434366,5940,CDKN2C,68,,51440306
12,107385142,102493,CRY1,68,,107487635
15,75966662,38527,CSPG4,68,,76005189
12,15773074,169436,EPS8,68,,15942510
1,94350755,24399,GCLM,68,,94375154
17,37894575,8963,GRB7,68,,37903538
4,74962753,2244,CXCL2,68,,74964997
13,45694630,163609,GTF2F2,68,,45858239
19,49471381,25229,GYS1,68,,49496610
9,21227241,980,IFNA17,68,,21228221
1,225589203,26612,LBR,68,,225615815
5,38475064,81684,LIFR,68,,38556748
3,187943192,665268,LPP,68,,188608460
12,76438524,40289,NAP1L1,68,,76478813
9,35792405,17323,NPR2,68,,35809728
4,164245116,8831,NPY1R,68,,164253947
6,150070830,61727,PCMT1,68,,150132557
12,48513012,27175,PFKM,68,,48540187
4,159630278,14274,PPID,68,,159644552
22,18900286,23678,PRODH,68,,18923964
11,119531702,67733,PVRL1,68,,119599435
1,160246598,8343,PEX19,68,,160254941
6,117609529,137489,ROS1,68,,117747018
9,130209952,3759,RPL12,68,,130213711
1,6245079,14600,RPL22,68,,6259679
6,34385230,8672,RPS10,68,,34393902
6,33239851,4430,RPS18,68,,33244281
X,18657807,32416,RS1,68,,18690223
3,186739664,56677,ST6GAL1,68,,186796341
16,29674270,7553,SPN,68,,29681823
7,87837517,11882,SRI,68,,87849399
22,41220538,32474,ST13,68,,41253012
X,49044264,12397,SYP,68,,49056661
6,32008931,68220,TNXB,68,,32077151
20,48697660,32075,UBE2V1,68,,48729735
14,100800124,41803,WARS,68,,100841927
10,17686123,72698,STAM,68,,17758821
X,153195279,5328,NAA10,68,,153200607
16,28722737,24313,EIF3C,68,,28747050
5,137523336,25696,CDC23,68,,137549032
11,85955425,34427,EED,68,,85989852
12,56810156,33093,TIMELESS,68,,56843249
15,50716573,76707,USP8,68,,50793280
5,121647763,152151,SNCAIP,68,,121799914
5,271735,43354,PDCD6,68,,315089
6,29523388,4314,UBD,68,,29527702
20,388693,24088,RBCK1,68,,412781
5,32585604,18581,SUB1,68,,32604185
20,60877951,5967,ADRM1,68,,60883918
17,73232686,25788,GGA3,68,,73258474
19,49990810,4754,RPL13A,68,,49995564
16,69345286,13660,VPS4A,68,,69358946
2,234545122,136829,UGT1A10,68,,234681951
3,52579367,140499,PBRM1,68,,52719866
3,150264464,39339,EIF2A,68,,150303803
2,185463092,341122,ZNF804A,68,,185804214
14,104583741,110,MIR203A,68,,104583851
12,52345450,45413,ACVR1B,67,,52390863
4,99992129,17810,ADH5,67,,100009939
1,113162074,52167,CAPZA1,67,,113214241
19,42381189,4250,CD79A,67,,42385439
1,41944445,5909,EDN2,67,,41950354
9,124101265,31317,STOM,67,,124132582
17,41052813,13637,G6PC,67,,41066450
5,177631507,6677,HNRNPAB,67,,177638184
16,82068857,63282,HSD17B2,67,,82132139
6,31826828,3881,NEU1,67,,31830709
6,3000049,20061,NQO2,67,,3020110
4,156129780,8450,NPY2R,67,,156138230
14,57267424,9770,OTX2,67,,57277194
21,47744035,121647,PCNT,67,,47865682
14,102228134,166194,PPP2R5C,67,,102394328
14,52734430,9012,PTGDR,67,,52743442
9,8314245,419701,PTPRD,67,,8733946
1,43996530,92813,PTPRF,67,,44089343
14,68286495,678103,RAD51B,67,,68964598
6,28870778,20990,TRIM27,67,,28891768
6,33176285,4214,RING1,67,,33180499
19,49118583,4092,RPL18,67,,49122675
8,56985367,1773,RPS20,67,,56987140
4,154701741,8487,SFRP2,67,,154710228
8,103661004,5188,KLF10,67,,103666192
12,49412757,36350,KMT2D,67,,49449107
15,69070874,42387,ANP32A,67,,69113261
12,10851675,24278,YBX3,67,,10875953
17,41003200,6947,AOC3,67,,41010147
8,38854504,108275,ADAM9,67,,38962779
6,150004054,35338,LATS1,67,,150039392
19,4838345,29435,PLIN3,67,,4867780
12,106631658,10055,CKAP4,67,,106641713
19,41770078,43610,HNRNPUL1,67,,41813688
1,17312452,26015,ATP13A2,67,,17338467
20,62612430,52023,PRPF6,67,,62664453
5,36876860,189061,NIPBL,67,,37065921
11,66104803,7779,BRMS1,67,,66112582
2,233562014,163275,GIGYF2,67,,233725289
17,27900486,16124,GIT1,67,,27916610
15,45384851,21508,DUOX2,67,,45406359
1,111982511,9419,WDR77,67,,111991930
3,48488113,18941,ATRIP,67,,48507054
11,64358281,11544,SLC22A12,67,,64369825
5,149109814,124771,PPARGC1B,67,,149234585
1,145413190,4355,HFE2,67,,145417545
X,25021812,12253,ARX,67,,25034065
1,1103242,90,MIR200A,67,,1103332
2,233243243,4356,ALPP,66,,233247599
12,15094948,19756,ARHGDIB,66,,15114704
7,128379345,34132,CALU,66,,128413477
9,135937364,9886,CEL,66,,135947250
4,104026962,92604,CENPE,66,,104119566
1,156669399,6209,CRABP2,66,,156675608
5,176883613,17081,DBN1,66,,176900694
9,100615536,3461,FOXE1,66,,100618997
10,117816441,216716,GFRA1,66,,118033157
7,48002884,16338,HUS1,66,,48019222
9,21304612,700,IFNA5,66,,21305312
21,34638664,30875,IL10RB,66,,34669539
15,78730517,63281,IREB2,66,,78793798
19,49519236,1111,LHB,66,,49520347
2,33359663,264912,LTBP1,66,,33624575
X,151934651,3589,MAGEA3,66,,151938240
15,89441913,14787,MFGE8,66,,89456700
4,87856153,206053,AFF1,66,,88062206
9,21802634,63335,MTAP,66,,21865969
X,149737046,104570,MTM1,66,,149841616
10,72191691,9774,NODAL,66,,72201465
17,3799884,20076,P2RX1,66,,3819960
20,56136136,5377,PCK1,66,,56141513
21,45719916,27348,PFKL,66,,45747264
1,68894506,21136,RPE65,66,,68915642
11,17095938,3282,RPS13,66,,17099220
1,153533584,4722,S100A2,66,,153538306
14,70233828,4894,SRSF5,66,,70238722
12,56347888,11958,PMEL,66,,56359846
3,46616044,7908,TDGF1,66,,46623952
4,69512314,24180,UGT2B15,66,,69536494
1,91966403,24918,CDC7,66,,91991321
6,26031816,472,HIST1H3B,66,,26032288
8,63927638,23972,GGH,66,,63951610
X,106143393,30698,CLDN2,66,,106174091
15,90773476,3803,CIB1,66,,90777279
11,9406168,63506,IPO7,66,,9469674
2,74056113,38182,STAMBP,66,,74094295
2,237994083,13406,COPS8,66,,238007489
16,69872639,103005,WWP2,66,,69975644
15,86163180,129409,AKAP13,66,,86292589
4,169418216,431392,PALLD,66,,169849608
5,167719064,180244,WWC1,66,,167899308
17,6327056,11463,AIPL1,66,,6338519
16,28875077,10457,SH2B1,66,,28885534
3,87276412,28286,CHMP2B,66,,87304698
11,62457733,17446,BSCL2,66,,62475179
17,647660,7841,GEMIN4,66,,655501
19,19627018,11995,NDUFA13,66,,19639013
4,83956238,40733,COPS4,66,,83996971
12,121746047,45965,ANAPC5,66,,121792012
2,234627437,54508,UGT1A4,66,,234681945
19,43857810,9514,CD177,66,,43867324
10,73156690,335791,CDH23,66,,73492481
17,8339169,32326,NDEL1,66,,8371495
19,55235951,12052,KIR3DL3,66,,55248003
7,31092075,59018,ADCYAP1R1,65,,31151093
1,22979681,8348,C1QB,65,,22988029
19,35820071,18193,CD22,65,,35838264
X,151995870,3431,CETN2,65,,151999301
10,5005453,14705,AKR1C1,65,,5020158
12,53400041,35958,EIF4B,65,,53435999
1,155278704,11753,FDPS,65,,155290457
21,27107257,37514,GABPA,65,,27144771
8,122625270,28360,HAS2,65,,122653630
9,21239200,778,IFNA14,65,,21239978
9,21165635,1024,IFNA21,65,,21166659
3,190231839,137469,IL1RAP,65,,190369308
X,114238537,13670,IL13RA2,65,,114252207
14,104095524,72364,KLC1,65,,104167888
13,46700057,56402,LCP1,65,,46756459
1,236686738,29541,LGALS8,65,,236716279
X,10413349,175325,MID1,65,,10588674
6,29624757,15392,MOG,65,,29640149
12,111348623,9781,MYL2,65,,111358404
11,57154259,3871,PRG2,65,,57158130
16,67968406,2374,PSMB10,65,,67970780
19,18307610,7264,RAB3A,65,,18314874
12,21621843,32760,RECQL,65,,21654603
13,34392205,19439,RFC3,65,,34411644
19,49999621,3348,RPS11,65,,50002969
2,27530267,1046,UCN,65,,27531313
10,51565107,25627,NCOA4,65,,51590734
3,5021096,5769,BHLHE40,65,,5026865
12,120899470,8088,SRSF9,65,,120907558
3,129149786,9236,MBD4,65,,129159022
19,16999670,3741,F2RL3,65,,17003411
1,150293927,31777,PRPF3,65,,150325704
X,40508794,86010,MED14,65,,40594804
6,151561133,118561,AKAP12,65,,151679694
8,53535017,92009,RB1CC1,65,,53627026
1,150898814,38406,SETDB1,65,,150937220
X,118370207,8222,PGRMC1,65,,118378429
18,9475529,62577,RALBP1,65,,9538106
1,207002221,14105,IL19,65,,207016326
9,88641057,73453,GOLM1,65,,88714510
19,4174105,8496,SIRT6,65,,4182601
2,234526290,155655,UGT1A8,65,,234681945
7,134212343,13823,AKR1B10,65,,134226166
14,77731833,5822,NGB,65,,77737655
8,124025403,29260,DERL1,65,,124054663
1,197053256,62568,ASPM,65,,197115824
8,17913807,28700,ASAH1,64,,17942507
12,63536538,10052,AVPR1A,64,,63546590
11,118754474,12506,CXCR5,64,,118766980
19,51728334,14940,CD33,64,,51743274
4,77079891,55161,SCARB2,64,,77135052
7,107531551,30092,DLD,64,,107561643
11,83166055,2172259,DLG2,64,,85338314
9,113636053,164312,LPAR1,64,,113800365
22,19711065,1232,GP1BB,64,,19712297
17,80009740,5606,GPS1,64,,80015346
6,26234439,777,HIST1H1D,64,,26235216
1,196788860,12459,CFHR1,64,,196801319
7,75162618,205672,HIP1,64,,75368290
10,70091767,11186,HNRNPH3,64,,70102953
9,21206179,963,IFNA10,64,,21207142
12,53491435,4693,IGFBP6,64,,53496128
4,187148624,31004,KLKB1,64,,187179628
12,10598637,7342,KLRC1,64,,10605979
12,10457049,12801,KLRD1,64,,10469850
1,156433512,26879,MEF2D,64,,156460391
17,61699800,73870,MAP3K3,64,,61773670
16,56623266,1734,MT3,64,,56625000
10,6186840,90667,PFKFB3,64,,6277507
15,90207599,15049,PLIN1,64,,90222648
14,39644386,8036,PNN,64,,39652422
1,212475147,60058,PPP2R5A,64,,212535205
2,68405988,73663,PPP3R1,64,,68479651
9,123578331,26968,PSMD5,64,,123605299
7,121513158,188932,PTPRZ1,64,,121702090
5,68665886,44742,RAD17,64,,68710628
19,58898635,7536,RPS5,64,,58906171
19,47278139,12406,SLC1A5,64,,47290545
6,160769404,104207,SLC22A3,64,,160873611
8,23699433,12887,STC1,64,,23712320
8,99466858,487941,STK3,64,,99954799
4,48137799,134015,TEC,64,,48271814
5,133706866,20933,UBE2B,64,,133727799
6,31588449,17105,PRRC2A,64,,31605554
17,34136458,37788,TAF15,64,,34174246
X,51546154,99296,MAGED1,64,,51645450
5,134906370,8599,CXCL14,64,,134914969
17,38249036,7942,NR1D1,64,,38256978
7,36892510,132207,ELMO1,64,,37024717
20,4833001,149144,SLC23A2,64,,4982145
2,152973314,59192,STAM2,64,,153032506
16,46989273,18352,DNAJA2,64,,47007625
17,46802126,3985,HOXB13,64,,46806111
12,57923832,17282,DCTN2,64,,57941114
21,28290230,49209,ADAMTS5,64,,28339439
8,144898513,12766,PUF60,64,,144911279
9,119449580,13999,TRIM32,64,,119463579
6,152442818,515168,SYNE1,64,,152957986
16,2802329,19084,SRRM2,64,,2821413
12,48436680,63411,SENP1,64,,48500091
7,44552134,28780,NPC1L1,64,,44580914
1,212208894,69454,DTL,64,,212278348
15,101812386,5339,VIMP,64,,101817725
19,7587495,11400,MCOLN1,64,,7598895
17,40932648,16436,WNK4,64,,40949084
1,153920147,10985,CRTC2,64,,153931132
19,39786964,2348,IFNL1,64,,39789312
5,159343739,56278,ADRA1B,63,,159400017
7,97481428,20426,ASNS,63,,97501854
8,22022652,36344,BMP1,63,,22058996
1,117061321,52394,CD58,63,,117113715
9,36190852,21207,CLTA,63,,36212059
3,16628300,17997,DAZL,63,,16646297
2,120124499,5628,DBI,63,,120130127
1,10520602,12011,DFFA,63,,10532613
7,13930855,98787,ETV1,63,,14029642
8,72109667,164800,EYA1,63,,72274467
8,82192717,4295,FABP5,63,,82197012
X,108884563,92058,ACSL4,63,,108976621
20,35879489,5822,GHRH,63,,35885311
5,176853686,14668,GRK6,63,,176868354
6,32723874,7456,HLA-DQB2,63,,32731330
X,100663120,6008,HNRNPH2,63,,100669128
4,980784,17561,IDUA,63,,998345
9,21350316,570,IFNA6,63,,21350886
4,185308875,86851,IRF2,63,,185395726
3,112051793,29865,CD200,63,,112081658
1,46049659,34919,NASP,63,,46084578
22,21061978,151122,PI4KA,63,,21213100
3,38048986,17292,PLCD1,63,,38066278
7,94989183,36504,PON3,63,,95025687
12,118454505,15537,RFC5,63,,118470042
6,32938664,10618,BRD2,63,,32949282
4,2471179,46407,RNF4,63,,2517586
7,7676193,82045,RPA3,63,,7758238
20,43835604,2810,SEMG1,63,,43838414
1,160577889,39212,SLAMF1,63,,160617101
19,41256758,14539,SNRPA,63,,41271297
12,115108058,13911,TBX3,63,,115121969
4,1873122,110812,WHSC1,63,,1983934
7,116916685,46658,WNT2,63,,116963343
1,14075875,38699,PRDM2,63,,14114574
14,39583487,22690,GEMIN2,63,,39606177
8,22960326,14624,TNFRSF10C,63,,22974950
6,110421021,80186,WASF1,63,,110501207
19,59067078,3265,UBE2M,63,,59070343
3,40498829,5034,RPL14,63,,40503863
19,42387266,24338,ARHGEF1,63,,42411604
11,45907046,20970,MAPK8IP1,63,,45928016
22,39378403,10381,APOBEC3B,63,,39388784
6,136578000,32989,BCLAF1,63,,136610989
2,161993465,99217,TANK,63,,162092682
3,167401694,50900,PDCD10,63,,167452594
13,21547175,88547,LATS2,63,,21635722
19,56187990,19143,EPN1,63,,56207133
9,32972603,29036,APTX,63,,33001639
6,43490067,53745,XPO5,63,,43543812
5,176560832,166382,NSD1,63,,176727214
1,109822175,3615,PSRC1,63,,109825790
17,12569206,103059,MYOCD,63,,12672265
17,38077293,6764,ORMDL3,63,,38084057
22,42321035,1786,TNFRSF13C,63,,42322821
1,149812258,507,HIST2H3A,63,,149812765
6,149721494,688,SUMO4,63,,149722182
6,105404922,126285,LIN28B,63,,105531207
17,62006095,3619,CD79B,62,,62009714
1,103342022,232030,COL11A1,62,,103574052
15,79214091,23349,CTSH,62,,79237440
Y,25275501,69738,DAZ1,62,,25345239
1,23832919,24793,E2F2,62,,23857712
9,91606323,13746,S1PR3,62,,91620069
11,10818592,11990,EIF4G2,62,,10830582
9,137772657,6709,FCN2,62,,137779366
1,230202941,214935,GALNT2,62,,230417876
16,2034149,3601,GFER,62,,2037750
14,81641795,45501,GTF2A1,62,,81687296
16,4526340,34008,HMOX2,62,,4560348
17,46684594,3789,HOXB7,62,,46688383
11,6452267,9987,HPX,62,,6462254
3,186383740,12289,HRG,62,,186396029
17,39722093,6217,KRT9,62,,39728310
11,1889902,23591,LSP1,62,,1913493
2,201774893,53531,ORC2,62,,201828424
6,41708575,6564,PGC,62,,41715139
12,120759913,5679,PLA2G1B,62,,120765592
7,131185020,56356,PODXL,62,,131241376
1,89149826,152112,PKN2,62,,89301938
6,36098260,14041,MAPK13,62,,36112301
1,78956727,49659,PTGFR,62,,79006386
7,73645831,22957,RFC2,62,,73668788
8,146015149,2682,RPL8,62,,146017831
17,37356535,4445,RPL19,62,,37360980
10,79793517,6956,RPS24,62,,79800473
14,81965153,35052,SEL1L,62,,82000205
3,148747903,56438,HLTF,62,,148804341
4,70706929,18941,SULT1E1,62,,70725870
5,140698056,2295,TAF7,62,,140700351
8,116420723,259516,TRPS1,62,,116680239
13,19747909,8083,TUBA3C,62,,19755992
4,69402902,31343,UGT2B17,62,,69434245
7,158820865,116784,VIPR2,62,,158937649
14,96176303,4230,TCL1A,62,,96180533
6,163835674,163954,QKI,62,,163999628
22,38453261,18447,PICK1,62,,38471708
5,71014989,1886,CARTPT,62,,71016875
12,108915990,39175,SART3,62,,108955165
11,69513005,6101,FGF19,62,,69519106
5,139929651,8027,SRA1,62,,139937678
19,54777674,7359,LILRB2,62,,54785033
3,45984972,4873,CXCR6,62,,45989845
5,147443534,73391,SPINK5,62,,147516925
14,23527773,37050,ACIN1,62,,23564823
19,16940197,50967,SIN3B,62,,16991164
19,18794424,98719,CRTC1,62,,18893143
11,64085559,3736,PRDX5,62,,64089295
X,56590025,3418,UBQLN2,62,,56593443
1,192981495,47028,UCHL5,62,,193028523
10,74033676,2121,DDIT4,62,,74035797
15,89787193,73169,FANCI,62,,89860362
17,12894928,26453,ELAC2,62,,12921381
2,43457974,365139,THADA,62,,43823113
22,20228937,26879,RTN4R,62,,20255816
9,140513443,165402,EHMT1,62,,140678845
12,55038374,3903,DCD,62,,55042277
10,106028630,30546,GSTO2,62,,106059176
X,47420498,10822,ARAF,61,,47431320
5,39284246,80416,C9,61,,39364662
Y,1337692,41136,CSF2RA,61,,1378828
1,57463578,1252633,DAB1,61,,58716211
8,6873390,2426,DEFA3,61,,6875816
18,28645939,36456,DSC2,61,,28682395
2,222282746,154332,EPHA4,61,,222437078
13,22245214,33426,FGF9,61,,22278640
17,47035917,10038,GIP,61,,47045955
6,26156558,785,HIST1H1E,61,,26157343
2,26467615,45718,HADHB,61,,26513333
5,175085039,28206,HRH2,61,,175113245
9,21186617,981,IFNA4,61,,21187598
Y,1405508,46074,IL3RA,61,,1451582
7,155089485,12460,INSIG1,61,,155101945
1,160007256,32795,KCNJ10,61,,160040051
6,117002366,60664,KPNA5,61,,117063030
5,96271345,93770,LNPEP,61,,96365115
16,56672577,1422,MT1A,61,,56673999
17,1367479,28522,MYO1C,61,,1396001
12,57106210,13116,NACA,61,,57119326
5,32711437,80393,NPR3,61,,32791830
12,98987402,8376,SLC25A3,61,,98995778
15,67841341,258114,MAP2K5,61,,68099455
7,141672430,1143,TAS2R38,61,,141673573
5,34905365,10415,RAD1,61,,34915780
4,146019155,31521,ABCE1,61,,146050676
1,151778546,20007,RORC,61,,151798553
8,99053937,3881,RPL30,61,,99057818
20,35807448,62577,RPN2,61,,35870025
19,48373722,15932,SULT2A1,61,,48389654
21,43766466,4742,TFF2,61,,43771208
2,152214105,22457,TNFAIP6,61,,152236562
19,36395302,3909,TYROBP,61,,36399211
6,145946439,110552,EPM2A,61,,146056991
1,149822627,534,HIST2H2AA3,61,,149823161
2,106468203,42527,NCK2,61,,106510730
2,85804613,4543,VAMP8,61,,85809156
11,119225924,26512,USP2,61,,119252436
11,113775517,41766,HTR3B,61,,113817283
6,131895105,54274,MED23,61,,131949379
20,1099235,53655,PSMF1,61,,1152890
14,66974124,674401,GPHN,61,,67648525
9,91975705,118906,SEMA4D,61,,92094611
10,97071529,129408,SORBS1,61,,97200937
12,69864128,109443,FRS2,61,,69973571
12,16035287,21123,STRAP,61,,16056410
20,33302577,67630,NCOA6,61,,33370207
2,11864459,103074,LPIN1,61,,11967533
6,119215240,15095,ASF1A,61,,119230335
17,7465308,9979,SENP3,61,,7475287
7,66452689,7899,SBDS,61,,66460588
8,140629364,85935,KCNK9,61,,140715299
8,75262617,16718,GDAP1,61,,75279335
9,95218488,26356,ASPN,61,,95244844
2,153508106,65869,PRPF40A,61,,153573975
9,104296130,29496,RNF20,61,,104325626
10,104629209,32446,AS3MT,61,,104661655
4,159442865,131656,RXFP1,61,,159574521
15,75639959,7633,NEIL1,61,,75647592
9,19115758,11846,PLIN2,60,,19127604
7,35840595,106120,7-Sep,60,,35946715
14,24780704,6538,LTB4R,60,,24787242
6,33154221,6024,COL11A2,60,,33160245
10,5042102,4104,AKR1C2,60,,5046206
1,3773830,28163,DFFB,60,,3801993
19,46171501,15481,GIPR,60,,46186982
3,128779609,1645,GP9,60,,128781254
X,122318095,306671,GRIA3,60,,122624766
18,56887399,10607,GRP,60,,56898006
14,77787229,10711,GSTZ1,60,,77797940
2,231972949,16875,HTR2B,60,,231989824
3,50337319,3713,HYAL1,60,,50341032
20,33866708,5812,EIF6,60,,33872520
1,152881038,3324,IVL,60,,152884362
12,5019072,8350,KCNA1,60,,5027422
12,57881735,28703,MARS,60,,57910438
18,47795215,12929,MBD1,60,,47808144
7,75677336,19491,MDH2,60,,75696827
6,49398072,32969,MUT,60,,49431041
15,40580097,20077,PLCB2,60,,40600174
20,44518782,8676,CTSA,60,,44527458
19,11546077,15705,PRKCSH,60,,11561782
19,51479734,7586,KLK7,60,,51487320
3,23958294,4053,RPL15,60,,23962347
3,101399933,5630,RPL24,60,,101405563
6,166822851,453188,RPS6KA2,60,,167276039
X,47431299,47957,SYN1,60,,47479256
11,117070039,5469,TAGLN,60,,117075508
11,6632047,1428,TAF10,60,,6633475
X,153639853,10210,TAZ,60,,153650063
8,80947102,45964,TPD52,60,,80993066
2,73612885,224161,ALMS1,60,,73837046
7,6048881,14584,AIMP2,60,,6063465
3,180630233,70306,FXR1,60,,180700539
11,8008866,8853,EIF3F,60,,8017719
19,48972464,13107,CYTH2,60,,48985571
6,57037103,12909,BAG2,60,,57050012
12,62654120,149381,USP15,60,,62803501
X,119384609,7642,ZBTB33,60,,119392251
9,32540541,12085,TOPORS,60,,32552626
8,126444450,6197,TRIB1,60,,126450647
14,74946642,13442,NPC2,60,,74960084
16,23474862,46953,GGA2,60,,23521815
12,66741210,331715,GRIP1,60,,67072925
1,85784167,259879,DDAH1,60,,86044046
21,42539727,114734,BACE2,60,,42654461
8,103216728,34331,RRM2B,60,,103251059
20,31823801,7314,BPIFA1,60,,31831115
8,42691816,6658,THAP1,60,,42698474
5,65222381,154470,ERBB2IP,60,,65376851
5,14704908,166979,ANKH,60,,14871887
3,64501330,172035,ADAMTS9,60,,64673365
1,36197712,37839,CLSPN,60,,36235551
16,2325878,64869,ABCA3,59,,2390747
16,88875876,2466,APRT,59,,88878342
1,19665266,146869,CAPZB,59,,19812135
1,70876900,28634,CTH,59,,70905534
X,69674945,50394,DLG3,59,,69725339
2,207024317,3336,EEF1B2,59,,207027653
3,134514098,465209,EPHB1,59,,134979307
5,75911306,7932,F2RL2,59,,75919238
1,197008320,28077,F13B,59,,197036397
10,103529886,10240,FGF8,59,,103540126
17,7905987,17671,GUCY2D,59,,7923658
22,38201113,2330,H1F0,59,,38203443
2,242166678,45623,HDLBP,59,,242212301
7,27132613,3012,HOXA1,59,,27135625
9,94972489,83549,IARS,59,,95056038
17,62079954,4329,ICAM2,59,,62084283
11,61891444,29191,INCENP,59,,61920635
X,8496914,203314,KAL1,59,,8700228
1,210851656,455801,KCNH1,59,,211307457
3,49158546,12053,LAMB2,59,,49170599
17,37026111,51912,LASP1,59,,37078023
X,152481521,4595,MAGEA1,59,,152486116
8,9911778,374623,MSRA,59,,10286401
2,152341852,249149,NEB,59,,152591001
6,35436177,2381,RPL10A,59,,35438558
14,24836116,12695,NFATC4,59,,24848811
1,52838500,31643,ORC1,59,,52870143
15,101844132,186055,PCSK6,59,,102030187
11,64018994,17930,PLCB3,59,,64036924
10,75196185,59597,PPP3CB,59,,75255782
1,94883932,60328,ABCD3,59,,94944260
17,27046999,4375,RPL23A,59,,27051374
12,122755980,151136,CLIP1,59,,122907116
21,34915343,17630,SON,59,,34932973
20,55204357,9981,TFAP2C,59,,55214338
1,16268363,34264,ZBTB17,59,,16302627
19,6531009,4930,TNFSF9,59,,6535939
6,30710975,1352,IER3,59,,30712327
15,69706584,34182,KIF23,59,,69740766
6,43005354,16329,CUL7,59,,43021683
2,162164785,103443,PSMD14,59,,162268228
1,24969593,30179,SRRM1,59,,24999772
11,66384052,13345,RBM14,59,,66397397
3,69134089,21150,ARL6IP5,59,,69155239
1,202694312,84286,KDM5B,59,,202778598
16,2303116,14222,RNPS1,59,,2317338
14,75598170,45179,TMED10,59,,75643349
2,86371054,51839,IMMT,59,,86422893
16,56463047,22214,NUDT21,59,,56485261
9,135136826,93546,SETX,59,,135230372
1,197237333,210252,CRB1,59,,197447585
3,149235021,186039,WWTR1,59,,149421060
17,35306174,107997,AATF,59,,35414171
16,24741048,96499,TNRC6A,59,,24837547
4,25378847,41273,ANAPC4,59,,25420120
19,4043301,23642,ZBTB7A,59,,4066943
2,100016937,89581,REV1,59,,100106518
1,8071778,14615,ERRFI1,59,,8086393
14,24616658,13212,RNF31,59,,24629870
17,79523910,80269,NPLOC4,59,,79604179
6,90636246,370381,BACH2,59,,91006627
11,65627871,6043,MUS81,59,,65633914
2,62132776,230429,COMMD1,59,,62363205
X,112018104,48250,AMOT,59,,112066354
13,50623254,83,MIR15A,59,,50623337
13,92003318,71,MIR20A,59,,92003389
20,33578178,122,MIR499A,59,,33578300
12,109577201,128829,ACACB,58,,109706030
2,216176678,37818,ATIC,58,,216214496
X,15525430,49222,BMX,58,,15574652
X,85116184,186385,CHM,58,,85302569
X,100075347,20576,CSTF2,58,,100095923
18,71920526,38725,CYB5A,58,,71959251
3,89156673,374611,EPHA3,58,,89531284
5,108083522,449019,FER,58,,108532541
2,176957531,3135,HOXD13,58,,176960666
9,21201467,737,IFNA7,58,,21202204
17,39766030,3049,KRT16,58,,39769079
2,109223616,80086,LIMS1,58,,109303702
9,20341662,280324,MLLT3,58,,20621986
2,110880913,81726,NPHP1,58,,110962639
20,61340188,53935,NTSR1,58,,61394123
12,121647663,24246,P2RX4,58,,121671909
3,48445260,26200,PLXNB1,58,,48471460
1,40538381,24761,PPT1,58,,40563142
6,105725441,125558,PREP,58,,105850999
X,106871653,22603,PRPS1,58,,106894256
1,21922707,73149,RAP1GAP,58,,21995856
5,167913462,32847,RARS,58,,167946309
9,5334931,4942,RLN1,58,,5339873
17,8280833,5732,RPL26,58,,8286565
2,101618690,4195,RPL31,58,,101622885
1,53392900,67004,SCP2,58,,53459904
17,32646065,2356,CCL8,58,,32648421
1,161284165,50370,SDHC,58,,161334535
7,150755298,18316,SLC4A2,58,,150773614
12,96252708,7530,SNRPF,58,,96260238
18,23596216,74395,SS18,58,,23670611
10,105127709,21113,TAF5,58,,105148822
13,114239055,56733,TFDP1,58,,114295788
21,46188494,33257,UBE2G2,58,,46221751
X,107975726,3881,IRS4,58,,107979607
7,72854727,81888,BAZ1B,58,,72936615
10,95517565,40366,LGI1,58,,95557931
18,61056424,33328,VPS4B,58,,61089752
11,46765083,102776,CKAP5,58,,46867859
4,83343716,7662,HNRNPDL,58,,83351378
12,21958107,131521,ABCC9,58,,22089628
X,123094409,142096,STAG2,58,,123236505
14,100150754,42884,CYP46A1,58,,100193638
11,60618397,5047,PTGDR2,58,,60623444
16,75600248,11531,GABARAPL2,58,,75611779
22,46067677,173510,ATXN10,58,,46241187
17,79849588,8821,ANAPC11,58,,79858409
11,63753324,12568,OTUB1,58,,63765892
X,118967988,19003,UPF3B,58,,118986991
15,44854893,100983,SPG11,58,,44955876
20,57594308,7401,TUBB1,58,,57601709
12,50451419,25986,ASIC1,57,,50477405
3,38495789,38844,ACVR2B,57,,38534633
21,46494492,151986,ADARB1,57,,46646478
4,100044807,20642,ADH4,57,,100065449
10,75134858,38985,ANXA7,57,,75173843
16,28891363,24467,ATP2A1,57,,28915830
20,36932551,33354,BPI,57,,36965905
1,55315299,37622,DHCR24,57,,55352921
4,88529680,8345,DSPP,57,,88538025
5,137841781,37208,ETF1,57,,137878989
3,185764105,62796,ETV5,57,,185826901
1,35247910,4057,GJB3,57,,35251967
6,52842745,17433,GSTA4,57,,52860178
10,115310589,38771,HABP2,57,,115349360
7,128032330,17706,IMPDH1,57,,128050036
5,50678957,11606,ISL1,57,,50690563
12,57943846,34708,KIF5A,57,,57978554
14,56046924,104378,KTN1,57,,56151302
14,103851700,118466,MARK3,57,,103970166
22,36002810,10574,MB,57,,36013384
20,17206751,258471,PCSK2,57,,17465222
19,10531332,48975,PDE4A,57,,10580307
X,47483611,5758,CFP,57,,47489369
11,494511,12310,RNH1,57,,506821
15,69745158,2726,RPLP1,57,,69747884
12,57623355,5363,SHMT2,57,,57628718
1,179262848,64966,SOAT1,57,,179327814
15,41136642,13211,SPINT1,57,,41149853
15,57210832,369882,TCF12,57,,57580714
3,23244783,387513,UBE2E2,57,,23632296
3,13860081,61537,WNT7A,57,,13921618
X,47004616,41598,RBM10,57,,47046214
22,19467348,40787,CDC45,57,,19508135
17,47676245,79280,SPOP,57,,47755525
19,47990890,27625,NAPA,57,,48018515
8,22993100,28443,TNFRSF10D,57,,23021543
7,138145078,125254,TRIM24,57,,138270332
3,183852809,10290,EIF2B5,57,,183863099
19,2100986,50570,AP3D1,57,,2151556
11,62744068,8427,SLC22A6,57,,62752495
16,11641577,39229,LITAF,57,,11680806
17,27071022,6954,TRAF4,57,,27077976
16,56815703,63158,NUP93,57,,56878861
1,149895208,4936,SF3B4,57,,149900144
14,24630421,5353,IRF9,57,,24635774
1,108113781,117345,VAV3,57,,108231126
11,118914895,13062,HYOU1,57,,118927957
2,85921413,4561,GNLY,57,,85925974
2,128056244,44561,MAP3K2,57,,128100805
6,135281516,94520,HBS1L,57,,135376036
19,15160290,8813,CASP14,57,,15169103
2,96012767,39058,KCNIP3,57,,96051825
9,35099772,3420,STOML2,57,,35103192
1,114935398,118383,TRIM33,57,,115053781
17,26369687,153717,NLK,57,,26523404
14,90422245,88863,TDP1,57,,90511108
6,157099063,432850,ARID1B,57,,157531913
7,151832009,301081,KMT2C,57,,152133090
4,145567147,92734,HHIP,57,,145659881
20,3869485,41044,PANK2,57,,3910529
4,140427191,50732,SETD7,57,,140477923
4,54243819,82284,FIP1L1,57,,54326103
2,25042038,100848,ADCY3,56,,25142886
17,19552063,28845,ALDH3A2,56,,19580908
5,78073036,209321,ARSB,56,,78282357
8,62413114,189294,ASPH,56,,62602408
8,86240457,49926,CA1,56,,86290383
X,49061522,28311,CACNA1F,56,,49089833
10,18549583,281105,CACNB2,56,,18830688
11,104813593,25732,CASP4,56,,104839325
1,116242625,68801,CASQ2,56,,116311426
19,14491955,27582,CD97,56,,14519537
2,175612322,16878,CHRNA1,56,,175629200
11,77327195,21656,CLNS1A,56,,77348851
8,6912821,1440,DEFA5,56,,6914261
7,30634508,39140,GARS,56,,30673648
21,34876237,38227,GART,56,,34914464
1,89517986,13057,GBP1,56,,89531043
3,120461557,40359,GTF2E1,56,,120501916
16,27471933,89318,GTF3C1,56,,27561251
2,138721807,3207,HNMT,56,,138725014
9,21216371,939,IFNA16,56,,21217310
19,45312315,12363,BCAM,56,,45324678
17,41322986,40722,NBR1,56,,41363708
3,151986256,197313,MBNL1,56,,152183569
22,24115005,11498,MMP11,56,,24126503
1,113217094,26274,MOV10,56,,113243368
1,203052256,2910,MYOG,56,,203055166
12,104510857,21183,NFYB,56,,104532040
1,162602227,148020,DDR2,56,,162750247
17,5288152,34907,NUP88,56,,5323059
3,58413356,6223,PDHB,56,,58419579
6,144261436,124300,PLAGL1,56,,144385736
1,11126669,33298,EXOSC10,56,,11159967
1,28157324,20859,PPP1R8,56,,28178183
5,177419235,4008,PROP1,56,,177423243
11,112097087,7608,PTS,56,,112104695
9,116298756,61267,RGS3,56,,116360023
11,118886421,2636,RPS25,56,,118889057
19,50138548,4852,RRAS,56,,50143400
17,32687346,2906,CCL1,56,,32690252
15,101821714,13773,SNRPA1,56,,101835487
20,31995762,35936,SNTA1,56,,32031698
12,57403780,6564,TAC3,56,,57410344
1,28929608,39996,TAF12,56,,28969604
10,121332977,23564,TIAL1,56,,121356541
3,124449212,18907,UMPS,56,,124468119
11,64002055,4681,VEGFB,56,,64006736
3,124944512,149686,ZNF148,56,,125094198
21,37757688,31437,CHAF1B,56,,37789125
20,55926617,26902,RAE1,56,,55953519
X,13752831,34649,OFD1,56,,13787480
5,77298149,292430,AP3B1,56,,77590579
4,76649705,85737,USO1,56,,76735442
18,158482,55257,USP14,56,,213739
18,9913954,46064,VAPA,56,,9960018
19,55417507,6932,NCR1,56,,55424439
14,64932216,9005,AKAP5,56,,64941221
7,148700153,25629,PDIA4,56,,148725782
19,51409607,4387,KLK4,56,,51413994
5,138702884,16155,SLC23A1,56,,138719039
15,73612199,49406,HCN4,56,,73661605
X,40440215,25673,ATP6AP2,56,,40465888
2,181845850,82304,UBE2E3,56,,181928154
20,2633177,5862,NOP56,56,,2639039
4,95373007,216371,PDLIM5,56,,95589378
5,145826872,64197,TCERG1,56,,145891069
5,137087072,2967,HNRNPA0,56,,137090039
12,120565013,67500,GCN1L1,56,,120632513
9,139981378,22261,MAN1B1,56,,140003639
19,47177572,42812,PRKD2,56,,47220384
4,76404246,35394,RCHY1,56,,76439640
1,25071759,99056,CLIC4,56,,25170815
10,11962020,122820,UPF2,56,,12084840
1,174968570,12593,CACYBP,56,,174981163
10,97951454,79879,BLNK,56,,98031333
2,234637772,44173,UGT1A3,56,,234681945
2,58386377,82138,FANCL,56,,58468515
12,132434464,130547,EP400,56,,132565011
1,206680862,81754,RASSF5,56,,206762616
10,63808969,47738,ARID5B,56,,63856707
17,26721660,11570,SLC46A1,56,,26733230
3,196195656,34983,RNF168,56,,196230639
2,209130990,39281,PIKFYVE,56,,209170271
12,123868662,25238,SETD8,56,,123893900
1,1633822,22182,CDK11A,56,,1656004
11,57001051,3876,APLNR,55,,57004927
9,104182841,15221,ALDOB,55,,104198062
5,151122382,15828,ATOX1,55,,151138210
3,10365706,181562,ATP2B2,55,,10547268
12,7167979,10356,C1S,55,,7178335
19,36630827,10428,CAPNS1,55,,36641255
21,47518032,34731,COL6A2,55,,47552763
5,10971953,617076,CTNND2,55,,11589029
3,183873283,18031,DVL3,55,,183891314
11,22644078,3309,FANCF,55,,22647387
5,127593600,280135,FBN2,55,,127873735
9,97365420,36503,FBP1,55,,97401923
8,11653081,43737,FDFT1,55,,11696818
2,69546900,67486,GFPT1,55,,69614386
21,30923167,389203,GRIK1,55,,31312370
X,16141423,30218,GRPR,55,,16171641
20,33516235,27385,GSS,55,,33543620
1,110210643,7265,GSTM2,55,,110217908
8,30436030,79708,GTF2E2,55,,30515738
6,26043454,431,HIST1H2BB,55,,26043885
6,19837600,4831,ID4,55,,19842431
1,215178884,231552,KCNK2,55,,215410436
6,31548335,1867,LTB,55,,31550202
12,56229213,7554,MMP19,55,,56236767
19,17186590,137514,MYO9B,55,,17324104
11,114166534,16704,NNMT,55,,114183238
12,6666035,11463,NOP2,55,,6677498
10,126085871,21674,OAT,55,,126107545
1,11994723,40876,PLOD1,55,,12035599
14,21269514,1522,RNASE1,55,,21271036
19,55897299,6152,RPL28,55,,55903451
3,52027643,2315,RPL29,55,,52029958
12,56435685,2322,RPS26,55,,56438007
X,73641327,112437,SLC16A2,55,,73753764
14,38677203,5065,SSTR1,55,,38682268
1,205012251,35149,CNTN2,55,,205047400
20,2276612,45113,TGM3,55,,2321725
7,100464949,6127,TRIP6,55,,100471076
8,48920994,53460,UBE2V2,55,,48974454
X,44732420,239437,KDM6A,55,,44971857
6,31919863,7001,NELFE,55,,31926864
X,47092313,15414,USP11,55,,47107727
6,27107087,370,HIST1H4I,55,,27107457
11,47291670,59912,MADD,55,,47351582
1,47023078,46888,MKNK1,55,,47069966
8,134203281,40651,WISP1,55,,134243932
15,59397283,19961,CCNB2,55,,59417244
5,176910394,14212,PDLIM7,55,,176924606
3,139076432,32090,COPB2,55,,139108522
1,7831328,10164,VAMP3,55,,7841492
19,5691844,28332,LONP1,55,,5720176
11,93517404,29092,MED17,55,,93546496
13,48807273,28959,ITM2B,55,,48836232
20,39314487,3393,MAFB,55,,39317880
2,219082119,36952,ARPC2,55,,219119071
3,50126340,30057,RBM5,55,,50156397
1,40723721,36135,ZMPSTE24,55,,40759856
4,1723216,23689,TACC3,55,,1746905
3,11314009,285130,ATG7,55,,11599139
9,94793415,84341,SPTLC1,55,,94877756
2,26256728,103595,RAB10,55,,26360323
15,79165122,24959,MORF4L1,55,,79190081
12,95867821,41792,METAP2,55,,95909613
20,21283921,86542,XRN2,55,,21370463
20,23059992,6985,CD93,55,,23066977
16,58553849,109941,CNOT1,55,,58663790
16,18816174,121552,SMG1,55,,18937726
21,45642877,18010,ICOSLG,55,,45660887
9,133569146,11135,EXOSC2,55,,133580281
1,39549838,402972,MACF1,55,,39952810
1,207039153,3415,IL20,55,,207042568
16,67694850,1831,PARD6A,55,,67696681
7,100882892,5479,FIS1,55,,100888371
1,150237798,3811,APH1A,55,,150241609
5,33945971,38809,SLC45A2,55,,33984780
9,123940414,23951,RAB14,55,,123964365
7,100472700,13585,SRRT,55,,100486285
9,123151146,191302,CDK5RAP2,55,,123342448
1,10003485,42071,NMNAT1,55,,10045556
1,117686208,60250,VTCN1,55,,117746458
19,50168398,8775,BCL2L12,55,,50177173
2,69240275,133221,ANTXR1,55,,69373496
19,2428162,28804,LMNB2,55,,2456966
1,62920396,233643,DOCK7,55,,63154039
16,67516473,1243,AGRP,54,,67517716
10,81914879,50449,ANXA11,54,,81965328
14,68086578,31858,ARG2,54,,68118436
2,151324706,19503,RND3,54,,151344209
1,201008639,73055,CACNA1S,54,,201081694
4,166300093,119606,CPE,54,,166419699
19,48325096,21490,CRX,54,,48346586
4,88571453,14059,DMP1,54,,88585512
18,28569330,53451,DSC3,54,,28622781
3,115342150,98184,GAP43,54,,115440334
6,52614884,13477,GSTA2,54,,52628361
12,124118285,28866,GTF2H3,54,,124147151
7,65425672,21629,GUSB,54,,65447301
5,130494975,6066,HINT1,54,,130501041
1,111136201,37895,KCNA2,54,,111174096
7,119913721,476666,KCND2,54,,120390387
1,112318453,213324,KCND3,54,,112531777
5,169805164,11517,KCNMB1,54,,169816681
12,53038341,7618,KRT2,54,,53045959
19,54865232,11489,LAIR1,54,,54876721
2,135011829,200363,MGAT5,54,,135212192
12,54685890,8931,NFE2,54,,54694821
1,18957499,117861,PAX7,54,,19075360
10,99185881,7320,PGAM1,54,,99193201
19,42590261,46364,POU2F2,54,,42636625
9,127908851,43367,PPP6C,54,,127952218
X,46696346,45445,RP2,54,,46741791
19,17970686,3447,RPL18A,54,,17974133
13,27825691,5011,RPL21,54,,27830702
5,81569138,5097,RPS23,54,,81574235
7,75441113,1920,CCL24,54,,75443033
13,103696347,22849,SLC10A2,54,,103719196
12,50478982,15512,SMARCD1,54,,50494494
22,37600276,8140,SSTR3,54,,37608416
12,51487538,79388,TFCP2,54,,51566926
X,118708429,9963,UBE2A,54,,118718392
13,20532847,133137,ZMYM2,54,,20665984
1,115259533,41138,CSDE1,54,,115300671
1,155658881,49919,DAP3,54,,155708800
11,86656716,9724,FZD4,54,,86666440
17,37821598,1209,TCAP,54,,37822807
1,33240839,42794,YARS,54,,33283633
16,66968346,10648,CES2,54,,66978994
10,12237960,54629,CDC123,54,,12292589
20,32676103,24059,EIF2S2,54,,32700162
3,123813527,631645,KALRN,54,,124445172
17,49039534,158692,SPAG9,54,,49198226
17,5185557,104102,RABEP1,54,,5289659
3,141457050,8595,RNF7,54,,141465645
6,90539618,44537,CASP8AP2,54,,90584155
22,50961996,2872,SCO2,54,,50964868
11,63448921,78442,RTN3,54,,63527363
1,11734536,17142,MAD2L2,54,,11751678
11,20385288,20041,HTATIP2,54,,20405329
1,169433148,22060,SLC19A2,54,,169455208
22,19881780,47735,TXNRD2,54,,19929515
19,12995235,2782,KLF1,54,,12998017
1,38422651,33131,SF3A3,54,,38455782
12,66582977,65417,IRAK3,54,,66648394
3,128968452,28164,COPG1,54,,128996616
3,33537738,163195,CLASP2,54,,33700933
14,64319682,373485,SYNE2,54,,64693167
18,60382671,265005,PHLPP1,54,,60647676
22,32871223,23595,FBXO7,54,,32894818
6,153291657,13083,FBXO5,54,,153304740
2,42396477,163211,EML4,54,,42559688
13,48649863,19414,MED4,54,,48669277
14,53106632,56017,ERO1L,54,,53162649
10,104263718,115502,SUFU,54,,104379220
3,186288464,15125,DNAJB11,54,,186303589
14,92588297,42246,CPSF2,54,,92630543
19,39876269,5566,PAF1,54,,39881835
X,71549365,243588,HDAC8,54,,71792953
12,69080730,58864,NUP107,54,,69139594
4,44703811,24840,GNPDA2,54,,44728651
22,39353526,5662,APOBEC3A,54,,39359188
6,3224494,3474,TUBB2B,54,,3227968
2,177015030,110,MIR10B,54,,177015140
3,38010894,77,MIR26A1,54,,38010971
12,54356091,6449,HOTAIR,54,,54362540
1,100316044,73535,AGL,53,,100389579
14,23586514,2306,CEBPE,53,,23588820
20,3764497,2840,CENPB,53,,3767337
20,5891973,14032,CHGB,53,,5906005
7,100797685,6872,AP1S1,53,,100804557
1,41444970,33267,CTPS1,53,,41478237
X,24073064,23863,EIF2S3,53,,24096927
7,143088204,17781,EPHA1,53,,143105985
6,35420137,14744,FANCE,53,,35434881
14,29236277,3206,FOXG1,53,,29239483
1,24171571,23288,FUCA1,53,,24194859
11,94277016,6048,FUT4,53,,94283064
14,65877309,333530,FUT8,53,,66210839
16,88880141,43233,GALNS,53,,88923374
3,6902801,880417,GRM7,53,,7783218
16,11961984,47841,GSPT1,53,,12009825
17,1959603,3378,HIC1,53,,1962981
12,56843285,5150,MIP,53,,56848435
18,55313658,156669,ATP8B1,53,,55470327
16,8891669,51525,PMM2,53,,8943194
6,42952236,27847,PPP2R5D,53,,42980083
12,49688908,3573,PRPH,53,,49692481
19,51515999,7432,KLK10,53,,51523431
3,49133364,9198,QARS,53,,49142562
3,139245246,13425,RBP1,53,,139258671
1,153963238,1393,RPS27,53,,153964631
1,29474249,34388,SRSF4,53,,29508637
2,44502596,45366,SLC3A1,53,,44547962
X,152953751,8297,SLC6A8,53,,152962048
16,30210548,5102,SULT1A3,53,,30215650
1,45477804,3537,UROD,53,,45481341
6,64281916,11577,PTP4A1,53,,64293493
15,91509267,28614,PRC1,53,,91537881
18,77441429,73081,CTDP1,53,,77514510
19,19734465,4574,LPAR2,53,,19739039
3,65339905,684604,MAGI1,53,,66024509
22,40297085,72261,GRAP2,53,,40369346
9,101050363,421116,GABBR2,53,,101471479
5,157212750,73433,CLINT1,53,,157286183
17,38175349,35540,MED24,53,,38210889
13,75858799,197505,TBC1D4,53,,76056304
19,34919267,41531,UBA2,53,,34960798
19,14519609,10586,DDX39A,53,,14530195
1,10093040,148256,UBE4B,53,,10241296
6,139693391,2108,CITED2,53,,139695499
4,128802015,18362,PLK4,53,,128820377
5,57749809,6157,PLK2,53,,57755966
18,32556891,166541,MAPRE2,53,,32723432
19,19010322,19877,COPE,53,,19030199
6,36461659,53634,STK38,53,,36515293
3,196662272,7192,NCBP2,53,,196669464
22,50497819,26539,MLC1,53,,50524358
2,122095351,311701,CLASP1,53,,122407052
11,47638857,25349,MTCH2,53,,47664206
X,69509878,130896,KIF4A,53,,69640774
1,171810617,571240,DNM3,53,,172381857
X,135579237,15266,HTATSF1,53,,135594503
2,168810529,293576,STK39,53,,169104105
11,77377273,154607,RSF1,53,,77531880
22,20067754,31646,DGCR8,53,,20099400
6,135605109,213794,AHI1,53,,135818903
X,39910498,126084,BCOR,53,,40036582
7,142605266,25554,TRPV5,53,,142630820
2,169757749,8761,G6PC2,53,,169766510
15,69307033,42468,NOX5,53,,69349501
9,124329380,218429,DAB2IP,53,,124547809
17,73823307,17491,UNC13D,53,,73840798
1,98511625,102,MIR137,53,,98511727
19,50004041,84,MIR150,53,,50004125
17,7123149,5437,ACADVL,52,,7128586
17,19641297,10449,ALDH3A1,52,,19651746
19,827825,4193,AZU1,52,,832018
17,28575212,43972,BLMH,52,,28619184
19,10677137,2494,CDKN2D,52,,10679631
14,35179587,4174,CFL2,52,,35183761
1,45265896,5771,PLK3,52,,45271667
6,116440084,7212,COL10A1,52,,116447296
9,115983807,42965,SLC31A1,52,,116026772
13,72012097,429233,DACH1,52,,72441330
9,5890908,18914,MLANA,52,,5909822
9,130565459,10901,FPGS,52,,130576360
4,47033294,395153,GABRB1,52,,47428447
10,101156626,33904,GOT1,52,,101190530
15,50534145,24017,HDC,52,,50558162
16,1840413,3321,IGFALS,52,,1843734
22,31644347,29277,LIMK2,52,,31673624
9,129376721,86590,LMX1B,52,,129463311
14,74964885,114149,LTBP2,52,,75079034
2,85766100,6303,MAT2A,52,,85772403
7,130131898,14240,MEST,52,,130146138
11,62037626,3003,SCGB2A2,52,,62040629
12,120779132,27851,MSI1,52,,120806983
19,2476122,2135,GADD45B,52,,2478257
12,56552044,3322,MYL6,52,,56555366
11,47600561,5554,NDUFS3,52,,47606115
2,173420696,43166,PDK1,52,,173463862
5,134363423,6541,PITX1,52,,134369964
8,57073467,50392,PLAG1,52,,57123859
16,30087296,9402,PPP4C,52,,30096698
14,21423629,965,RNASE2,52,,21424594
18,47014850,4085,RPL17,52,,47018935
6,133135707,2996,RPS12,52,,133138703
19,35521591,9762,SCN1B,52,,35531353
4,2794749,48074,SH3BP2,52,,2842823
17,59477256,9571,TBX2,52,,59486827
5,133451297,32623,TCF7,52,,133483920
19,55644065,16657,TNNT1,52,,55660722
19,16178316,35497,TPM4,52,,16213813
4,39500374,28844,UGDH,52,,39529218
8,42249278,14177,VDAC3,52,,42263455
14,97263683,84268,VRK1,52,,97347951
3,128886657,16153,CNBP,52,,128902810
2,74688183,4354,MOGS,52,,74692537
9,102584136,45037,NR4A3,52,,102629173
1,151171020,50987,PIP5K1A,52,,151222007
12,132379278,28429,ULK1,52,,132407707
6,132778662,55675,STX7,52,,132834337
2,172778934,69666,HAT1,52,,172848600
11,116648904,9850,ZPR1,52,,116658754
7,27779713,89673,TAX1BP1,52,,27869386
X,50653734,5907,BMP15,52,,50659641
X,135747711,115792,ARHGEF6,52,,135863503
5,37291734,79494,NUP155,52,,37371228
1,44115796,55393,KDM4A,52,,44171189
4,76567952,30391,G3BP2,52,,76598343
17,17408876,86141,PEMT,52,,17495017
19,38755097,28157,SPINT2,52,,38783254
17,47865980,40478,KAT7,52,,47906458
17,20902905,43447,USP22,52,,20946352
11,120207617,153028,ARHGEF12,52,,120360645
4,139085247,78256,SLC7A11,52,,139163503
22,17565848,30736,IL17RA,52,,17596584
19,51446558,9786,KLK5,52,,51456344
7,66147077,129371,RABGEF1,52,,66276448
12,6833448,7593,COPS7A,52,,6841041
5,145492588,69762,LARS,52,,145562350
2,203130438,37946,NOP58,52,,203168384
17,6659155,19809,XAF1,52,,6678964
1,107599266,2650,PRMT6,52,,107601916
3,179065479,45529,MFN1,52,,179111008
13,25456411,40616,CENPJ,52,,25497027
10,127512103,30161,BCCIP,52,,127542264
7,138728265,66200,ZC3HAV1,52,,138794465
2,219940045,85542,NHEJ1,52,,220025587
11,66036055,8908,RAB1B,52,,66044963
11,133938819,82833,JAM3,52,,134021652
1,26377795,16330,TRIM63,52,,26394125
17,74523429,10558,CYGB,52,,74533987
5,110427869,38331,WDR36,52,,110466200
22,39493228,6844,APOBEC3H,52,,39500072
5,150226084,2147,IRGM,52,,150228231
11,121970464,88,MIR125B1,52,,121970552
3,123001142,134047,ADCY5,51,,123135189
2,70889215,105632,ADD2,51,,70994847
22,40742503,20249,ADSL,51,,40762752
15,58430394,47713,AQP9,51,,58478107
3,57557089,26126,ARF4,51,,57583215
19,41903693,27217,BCKDHA,51,,41930910
1,158297739,3582,CD1B,51,,158301321
3,39371196,3975,CCR8,51,,39375171
X,107398836,282824,COL4A6,51,,107681660
1,47394845,12311,CYP4A11,51,,47407156
14,31343740,16082,COCH,51,,31359822
14,75348593,10001,DLST,51,,75358594
7,153584181,1101819,DPP6,51,,154686000
3,186501360,6325,EIF4A2,51,,186507685
2,223725731,82388,ACSL3,51,,223808119
22,21128382,13626,SERPIND1,51,,21142008
6,55039070,108348,HCRTR2,51,,55147418
19,35531409,26068,HPN,51,,35557477
2,228336887,89051,AGFG1,51,,228425938
21,38996524,292217,KCNJ6,51,,39288741
10,90973325,38471,LIPA,51,,91011796
9,113431050,132228,MUSK,51,,113563278
1,161171936,12248,NDUFS2,51,,161184184
19,49564396,2728,NTF4,51,,49567124
20,62711434,20562,OPRL1,51,,62731996
X,110187468,283121,PAK3,51,,110470589
X,114827818,57361,PLS3,51,,114885179
1,146626684,17484,PRKAB2,51,,146644168
11,8703994,7425,RPL27A,51,,8711419
16,18794276,7380,RPS15A,51,,18801656
11,18259779,10442,SAA2,51,,18270221
8,54879113,55903,TCEA1,51,,54935016
6,159057506,8312,DYNLT1,51,,159065818
Y,9304563,2795,TSPY1,51,,9307358
17,36890149,14409,PCGF2,51,,36904558
10,61548505,117909,CCDC6,51,,61666414
12,53701239,14173,AAAS,51,,53715412
12,112079949,43851,BRAP,51,,112123800
4,186506597,226813,SORBS2,51,,186733410
2,172639914,110902,SLC25A12,51,,172750816
14,79745681,588952,NRXN3,51,,80334633
12,27175454,8152,MED21,51,,27183606
1,156904631,110531,ARHGEF11,51,,157015162
14,71049937,17470,MED6,51,,71067407
3,160117091,35658,SMC4,51,,160152749
X,48755194,5226,PQBP1,51,,48760420
21,34398215,3288,OLIG2,51,,34401503
1,180941849,50408,STX6,51,,180992257
17,61627795,43847,DCAF7,51,,61671642
10,103544199,34023,MGEA5,51,,103578222
1,27248212,25150,NUDC,51,,27273362
9,127620157,4083,RPL35,51,,127624240
17,37913967,106474,IKZF3,51,,38020441
19,48711342,32978,CARD8,51,,48744320
3,47455174,62275,SCAP,51,,47517449
5,175875355,61720,FAF2,51,,175937075
6,31694813,3229,DDAH2,51,,31698042
11,93862093,53044,PANX1,51,,93915137
10,67672275,1753168,CTNNA3,51,,69425443
1,87170252,43615,SH3GLB1,51,,87213867
12,50569562,107791,LIMA1,51,,50677353
1,1447522,22545,ATAD3A,51,,1470067
11,15987994,442436,SOX6,51,,16430430
6,485137,208004,EXOC2,51,,693141
8,21971931,16634,HR,51,,21988565
19,36236477,1579,PSENEN,51,,36238056
6,117881432,42273,GOPC,51,,117923705
7,132937822,231124,EXOC4,51,,133168946
7,45067232,48837,CCM2,51,,45116069
11,63974151,17212,FERMT3,51,,63991363
18,12308057,18558,TUBB6,51,,12326615
20,56072223,28485,CTCFL,51,,56100708
7,129410222,110,MIR182,51,,129410332
1,172107937,110,MIR214,51,,172108047
17,1617196,85,MIR22,51,,1617281
6,160182988,17099,ACAT2,50,,160200087
22,41865128,59865,ACO2,50,,41924993
4,100333417,23250,ADH7,50,,100356667
19,3052907,9464,AES,50,,3062371
16,72816785,275749,ZFHX3,50,,73092534
10,7830066,19696,ATP5C1,50,,7849762
2,71162997,29564,ATP6V1B1,50,,71192561
5,40909598,73444,C7,50,,40983042
1,57394882,36931,C8B,50,,57431813
3,53529075,317417,CACNA1D,50,,53846492
1,158259562,5002,CD1C,50,,158264564
1,160650211,31430,CD48,50,,160681641
3,50643884,5378,CISH,50,,50649262
5,60169658,71247,ERCC8,50,,60240905
18,32173281,236011,DTNA,50,,32409292
1,150480486,5779,ECM1,50,,150486265
1,201979689,6626,ELF3,50,,201986315
11,69587796,2375,FGF4,50,,69590171
19,49977465,12023,FLT3LG,50,,49989488
15,42566365,79499,GANC,50,,42645864
1,92940317,9039,GFI1,50,,92949356
16,58741034,27227,GOT2,50,,58768261
11,105480799,372020,GRIA4,50,,105852819
19,47421932,86401,ARHGAP35,50,,47508333
5,54398473,7607,GZMA,50,,54406080
1,32083300,9619,HCRTR1,50,,32092919
11,128707908,4521,KCNJ1,50,,128712429
12,52880957,6224,KRT6A,50,,52887181
2,95691399,28338,MAL,50,,95719737
19,12757321,20270,MAN2B1,50,,12777591
15,23930553,1897,NDN,50,,23932450
22,29876180,11097,NEFH,50,,29887277
16,68119268,143894,NFATC3,50,,68263162
6,31515352,11254,NFKBIL1,50,,31526606
16,14529556,194572,PARN,50,,14724128
7,142829173,7661,PIP,50,,142836834
6,51480144,472279,PKHD1,50,,51952423
1,201252579,49542,PKP1,50,,201302121
2,44395941,62671,PPM1B,50,,44458612
4,17488015,25842,QDPR,50,,17513857
13,98086474,33778,RAP2A,50,,98120252
3,197677051,5670,RPL35A,50,,197682721
16,51169885,14623,SALL1,50,,51184508
17,32683470,2159,CCL13,50,,32685629
12,23682437,1033087,SOX5,50,,24715524
15,40327890,3513,SRP14,50,,40331403
12,50135591,23126,TMBIM6,50,,50158717
13,38210772,233167,TRPC4,50,,38443939
X,111017541,308463,TRPC5,50,,111326004
13,76123615,56541,UCHL3,50,,76180156
8,41786996,122548,KAT6A,50,,41909544
1,163112088,60875,RGS5,50,,163172963
22,36906896,18381,EIF3D,50,,36925277
10,103866248,13982,LDB1,50,,103880230
2,27587218,6106,EIF2B4,50,,27593324
14,75469611,6683,EIF2B2,50,,75476294
16,84733554,79973,USP10,50,,84813527
9,116037913,17272,PRPF4,50,,116055185
13,36342788,87210,DCLK1,50,,36429998
2,28113481,448286,BRE,50,,28561767
16,56966001,11792,HERPUD1,50,,56977793
11,66247483,29647,DPP3,50,,66277130
5,74666927,140879,COL4A3BP,50,,74807806
17,48939586,5753,TOB1,50,,48945339
11,67806461,11905,TCIRG1,50,,67818366
12,49952085,8137,MCRS1,50,,49960222
3,9821647,13048,TADA3,50,,9834695
14,53323988,93827,FERMT2,50,,53417815
5,132028318,44952,KIF3A,50,,132073270
13,36875774,68543,SPG20,50,,36944317
22,30972611,15316,PES1,50,,30987927
2,37477645,66577,PRKD3,50,,37544222
9,140149751,18249,NELFB,50,,140168000
3,66429220,121625,LRIG1,50,,66550845
16,52470327,110479,TOX3,50,,52580806
8,145648983,4963,VPS28,50,,145653946
16,6069131,1694209,RBFOX1,50,,7763340
5,6599351,34122,NSUN2,50,,6633473
8,10622470,74939,PINX1,50,,10697409
8,98787808,77022,LAPTM4B,50,,98864830
5,304290,134115,AHRR,50,,438405
3,45123765,64149,CDCP1,50,,45187914
19,47249302,12530,FKRP,50,,47261832
6,150263073,7295,ULBP2,50,,150270368
5,138855112,7263,TMEM173,50,,138862375
11,3848207,14006,RHOG,49,,3862213
17,7076750,6133,ASGR1,49,,7082883
5,125877532,53550,ALDH7A1,49,,125931082
6,99990262,26428,CCNC,49,,100016690
4,170541671,102667,CLCN3,49,,170644338
3,42850963,57812,ACKR2,49,,42908775
12,41086243,280276,CNTN1,49,,41366519
1,40766162,16777,COL9A2,49,,40782939
3,98298289,14166,CPOX,49,,98312455
5,76248679,16620,CRHBP,49,,76265299
X,100603025,683,TIMM8A,49,,100603708
2,11584500,21803,E2F6,49,,11606303
4,187508936,136051,FAT1,49,,187644987
1,161185086,3952,FCER1G,49,,161189038
4,843062,83116,GAK,49,,926178
3,81538849,272101,GBE1,49,,81810950
22,23412668,54553,GNAZ,49,,23467221
7,27220775,4060,HOXA11,49,,27224835
X,69353317,32856,IGBP1,49,,69386173
X,117861558,66938,IL13RA1,49,,117928496
4,184426202,7379,ING2,49,,184433581
12,56078353,23333,ITGA7,49,,56101686
3,37493812,367469,ITGA9,49,,37861281
12,26488269,497862,ITPR2,49,,26986131
2,70142172,27904,MXD1,49,,70170076
19,35782988,21721,MAG,49,,35804709
10,111969988,77135,MXI1,49,,112047123
5,70264309,56632,NAIP,49,,70320941
1,41157241,80034,NFYC,49,,41237275
22,42069936,14977,NHP2L1,49,,42084913
2,101436612,176675,NPAS2,49,,101613287
2,148687965,90351,ORC4,49,,148778316
14,60715965,49840,PPM1A,49,,60765805
7,588833,178480,PRKAR1B,49,,767313
16,11369492,845,PRM2,49,,11370337
19,14583277,2897,PTGER1,49,,14586174
6,111620233,184685,REV3L,49,,111804918
4,39455744,4824,RPL9,49,,39460568
3,14444075,86782,SLC6A6,49,,14530857
5,176047084,10478,SNCB,49,,176057562
15,64388082,48351,SNX1,49,,64436433
11,59522531,50824,STX3,49,,59573355
19,7701986,10774,STXBP2,49,,7712760
8,120743013,102061,TAF2,49,,120845074
5,33440801,27395,TARS,49,,33468196
2,122513120,12308,TSN,49,,122525428
15,41851219,20317,TYRO3,49,,41871536
6,26216428,444,HIST1H2BG,49,,26216872
1,159887896,6445,TAGLN2,49,,159894341
10,15147770,62925,NMT2,49,,15210695
5,78669646,140013,HOMER1,49,,78809659
22,35695267,48720,TOM1,49,,35743987
11,17515441,50522,USH1C,49,,17565963
10,104238985,23527,ACTR1A,49,,104262512
13,21714652,8572,SAP18,49,,21723224
11,5710816,21277,TRIM22,49,,5732093
11,319672,1242,IFITM3,49,,320914
4,57302268,25266,PAICS,49,,57327534
12,58087737,27603,OS9,49,,58115340
19,55174270,7540,LILRB4,49,,55181810
4,83739661,72772,SEC31A,49,,83812433
7,94285636,13370,PEG10,49,,94299006
7,135242661,90838,NUP205,49,,135333499
2,54091203,106774,PSME4,49,,54197977
1,19400999,135747,UBR4,49,,19536746
8,80676244,3854,HEY1,49,,80680098
5,54603575,117834,SKIV2L2,49,,54721409
5,154266975,50801,GEMIN5,49,,154317776
14,24708850,3030,TINF2,49,,24711880
2,113816684,5636,IL36RN,49,,113822320
5,132211070,88284,AFF4,49,,132299354
16,22217591,82475,EEF2K,49,,22300066
1,193065594,9593,GLRX2,49,,193075187
22,38245378,39411,EIF3L,49,,38284789
6,41126243,4681,TREM2,49,,41130924
11,12399025,157878,PARVA,49,,12556903
8,27667137,28475,PBK,49,,27695612
20,1422806,25531,NSFL1C,49,,1448337
4,157682762,209784,PDGFC,49,,157892546
10,12391541,476922,CAMK1D,49,,12868463
14,21853352,46515,CHD8,49,,21899867
10,99218080,40286,MMS19,49,,99258366
16,2255177,4241,MLST8,49,,2259418
19,50706884,106917,MYH14,49,,50813801
17,46047893,11259,CDK5RAP3,49,,46059152
9,5510544,60738,PDCD1LG2,49,,5571282
1,110993787,6189,PROK1,49,,110999976
19,2164147,68430,DOT1L,49,,2232577
20,32399109,43064,CHMP4B,49,,32442173
19,55434876,23997,NLRP7,49,,55458873
8,9760897,85,MIR124-1,49,,9760982
12,49159973,22906,ADCY6,48,,49182879
X,11311532,7349,AMELX,48,,11318881
1,104292278,9033,AMY1A,48,,104301311
17,7482805,2624,CD68,48,,7485429
22,25615611,12225,CRYBB2,48,,25627836
13,95089557,42379,DCT,48,,95131936
1,54359859,16900,DIO1,48,,54376759
X,106956451,3260,TSC22D3,48,,106959711
15,48623620,11950,DUT,48,,48635570
6,123100619,4603,FABP7,48,,123105222
17,65821779,158715,BPTF,48,,65980494
17,18148130,13740,FLII,48,,18161870
11,118895060,6556,SLC37A4,48,,118901616
14,88399357,60258,GALC,48,,88459615
19,13001942,8871,GCDH,48,,13010813
10,5807185,48327,GDI2,48,,5855512
6,26217147,564,HIST1H2AE,48,,26217711
6,122720695,33569,HSF2,48,,122754264
10,92500575,117096,HTR7,48,,92617671
14,105607317,27844,JAG2,48,,105635161
11,30031287,7290,KCNA4,48,,30038577
2,26915580,38486,KCNK3,48,,26954066
12,9092956,9401,M6PR,48,,9102357
X,151081360,12282,MAGEA4,48,,151093642
1,53692563,11719,MAGOH,48,,53704282
11,1012823,23883,MUC6,48,,1036706
8,24772454,4152,NEFM,48,,24776606
11,20691096,906133,NELL1,48,,21597229
1,236139131,89350,NID1,48,,236228481
7,127250345,5435,PAX4,48,,127255780
12,20522178,314863,PDE3A,48,,20837041
2,27604065,28485,PPM1G,48,,27632550
11,66406087,7857,RBM4,48,,66413944
19,14072341,44793,RFX1,48,,14117134
15,33603162,555142,RYR3,48,,34158304
3,11034419,46516,SLC6A1,48,,11080935
2,5832798,8719,SOX11,48,,5841517
4,57333761,36086,SRP72,48,,57369847
9,136218659,4702,SURF1,48,,136223361
5,92919042,11273,NR2F1,48,,92930315
12,71518876,32903,TSPAN8,48,,71551779
3,129693235,3546,TRH,48,,129696781
3,49349217,28319,USP4,48,,49377536
19,18553472,79465,ELL,48,,18632937
6,27775256,453,HIST1H2BL,48,,27775709
2,159313391,224549,PKP4,48,,159537940
3,9799028,12640,CAMK1,48,,9811668
4,174292092,6591,SAP30,48,,174298683
16,66836780,28099,NAE1,48,,66864879
1,151336777,8433,SELENBP1,48,,151345210
5,38845959,40882,OSMR,48,,38886841
X,13707239,20705,RAB9A,48,,13727944
7,77646373,1436517,MAGI2,48,,79082890
19,47634079,79814,SAE1,48,,47713893
3,183701539,34209,ABCC5,48,,183735748
2,220074487,9225,ABCB6,48,,220083712
2,238768186,52573,RAMP1,48,,238820759
7,23286315,28414,GPNMB,48,,23314729
3,125822403,77626,ALDH1L1,48,,125900029
11,64620198,26987,EHD1,48,,64647185
8,37594196,9875,ERLIN2,48,,37604071
3,47844398,47288,DHX30,48,,47891686
1,204797781,194169,NFASC,48,,204991950
5,154092461,104706,LARP1,48,,154197167
6,158244202,121907,SNX9,48,,158366109
20,57556262,13926,NELFCD,48,,57570188
7,139025104,83099,LUC7L2,48,,139108203
2,86730552,60068,CHMP3,48,,86790620
22,18593452,21046,TUBA8,48,,18614498
1,229577043,67045,NUP133,48,,229644088
15,40886446,68435,CASC5,48,,40954881
2,42721708,262379,MTA3,48,,42984087
18,19321289,129629,MIB1,48,,19450918
9,35736862,12363,GBA2,48,,35749225
1,175913961,262419,RFWD2,48,,176176380
9,128199672,269841,MAPKAP1,48,,128469513
1,120336640,17563,REG4,48,,120354203
16,31128984,13730,KAT8,48,,31142714
2,667972,9467,TMEM18,48,,677439
3,153993456,48830,DHX36,48,,154042286
15,43235097,163189,UBR1,48,,43398286
17,40554466,20872,PTRF,48,,40575338
22,25960860,164398,ADRBK2,47,,26125258
4,178351928,11729,AGA,47,,178363657
X,55035487,22010,ALAS2,47,,55057497
12,49329991,21261,ARF3,47,,49351252
3,113465865,65040,ATP6V1A,47,,113530905
12,7187514,57529,C1R,47,,7245043
6,31082864,5388,CDSN,47,,31088252
19,47341414,12838,AP2S1,47,,47354252
16,1494933,30152,CLCN7,47,,1525085
2,98962617,52447,CNGA3,47,,99015064
2,189896640,147965,COL5A2,47,,190044605
17,3539761,26636,CTNS,47,,3566397
19,41594355,7745,CYP2A13,47,,41602100
19,49133816,6991,DBP,47,,49140807
7,107405911,37767,SLC26A3,47,,107443678
19,49251267,7380,FUT1,47,,49258647
4,2965342,77132,GRK4,47,,3042474
17,73772514,3502,H3F3B,47,,73776016
19,52216364,10881,HAS1,47,,52227245
3,121350244,29551,HCLS1,47,,121379795
21,38123188,239357,HLCS,47,,38362545
7,27180670,2617,HOXA5,47,,27183287
17,46652868,2875,HOXB4,47,,46655743
3,10206562,78865,IRAK2,47,,10285427
19,39261607,2550,LGALS7,47,,39264157
8,23154409,107313,LOXL2,47,,23261722
2,206987802,36441,NDUFS1,47,,207024243
22,31795538,34634,DRG1,47,,31830172
19,3366564,102651,NFIC,47,,3469215
16,2089815,8055,NTHL1,47,,2097870
1,64088886,37030,PGM1,47,,64125916
6,2887499,16047,SERPINB9,47,,2903546
10,22823765,179738,PIP4K2A,47,,23003503
17,56597610,20569,4-Sep,47,,56618179
14,63840609,169470,PPP2R5E,47,,64010079
10,70847783,16784,SRGN,47,,70864567
8,61429468,106735,RAB2A,47,,61536203
17,33426810,20078,RAD51D,47,,33446888
2,121010413,41873,RALB,47,,121052286
9,135973106,51501,RALGDS,47,,136024607
12,56114150,4376,RDH5,47,,56118526
17,34324617,4467,CCL15,47,,34329084
3,10342612,20260,SEC13,47,,10362872
7,37945534,10991,SFRP4,47,,37956525
13,30083550,86275,SLC7A1,47,,30169825
22,19163087,2931,SLC25A1,47,,19166018
2,70508493,12410,SNRPG,47,,70520903
19,57742427,4489,AURKC,47,,57746916
10,71163957,12717,TACR2,47,,71176674
11,747431,17593,TALDO1,47,,765024
1,24069855,18694,TCEB3,47,,24088549
11,12695968,270316,TEAD1,47,,12966284
22,37406899,9325,TST,47,,37416224
17,4840425,3037,SLC25A11,47,,4843462
13,99102452,126953,STK24,47,,99229405
2,10183955,11008,KLF11,47,,10194963
11,313990,1282,IFITM1,47,,315272
21,47655038,50270,MCM3AP,47,,47705308
17,7494547,23668,FXR2,47,,7518215
10,70883908,50264,VPS26A,47,,70934172
15,72102887,7710,NR2E3,47,,72110597
11,74303574,50531,POLD3,47,,74354105
13,53226825,35664,SUGT1,47,,53262489
12,112451151,9873,ERP29,47,,112461024
1,43629844,8397,EBNA1BP2,47,,43638241
11,2629557,91671,KCNQ1OT1,47,,2721228
12,120532898,21745,RAB35,47,,120554643
19,33321418,39265,SLC7A9,47,,33360683
19,39078279,30396,MAP4K1,47,,39108675
10,27793102,38064,RAB18,47,,27831166
12,1100373,504726,ERC1,47,,1605099
19,3630178,70299,PIP5K1C,47,,3700477
19,5690345,1333,RPL36,47,,5691678
1,25870075,25302,LDLRAP1,47,,25895377
5,156693089,129517,CYFIP2,47,,156822606
5,162932533,13826,MAT2B,47,,162946359
16,50352928,49917,BRD7,47,,50402845
19,48248792,11531,GLTSCR2,47,,48260323
6,24650204,16911,TDP2,47,,24667115
15,45422191,35585,DUOX1,47,,45457776
11,68228185,154616,PPP6R3,47,,68382801
10,13203553,49551,MCM10,47,,13253104
20,6055491,48700,FERMT1,47,,6104191
8,145637797,1178,SLC39A4,47,,145638975
2,55514977,132080,CCDC88A,47,,55647057
11,5009420,4239,MMP26,47,,5013659
11,76156068,107875,C11orf30,47,,76263943
14,94517267,30291,DDX24,47,,94547558
13,49227846,57515,CYSLTR2,47,,49285361
2,202624180,21715,ALS2,47,,202645895
14,45605141,64952,FANCM,47,,45670093
1,245912641,758003,SMYD3,47,,246670644
X,154299694,51655,BRCC3,47,,154351349
20,62526454,40930,DNAJC5,47,,62567384
19,50321535,18702,MED25,47,,50340237
1,228645807,452,HIST3H2BB,47,,228646259
3,52232098,16245,ALAS1,46,,52248343
4,79472741,58864,ANXA3,46,,79531605
9,72042448,244827,APBA1,46,,72287275
17,58227296,9610,CA4,46,,58236906
15,63615729,58580,CA12,46,,63674309
1,181452685,323236,CACNA1E,46,,181775921
8,42552561,39648,CHRNB3,46,,42592209
1,16370230,13591,CLCNKB,46,,16383821
8,145149937,2493,CYC1,46,,145152430
1,109792640,25738,CELSR2,46,,109818378
6,131160487,223975,EPB41L2,46,,131384462
7,142552775,16072,EPHB6,46,,142568847
9,108320410,82989,FKTN,46,,108403399
13,92050872,1468615,GPC5,46,,93519487
17,73754017,7263,GALK1,46,,73761280
13,20712394,22789,GJA3,46,,20735183
6,24426061,63789,GPLD1,46,,24489850
21,40714240,6807,HMGN1,46,,40721047
10,91152302,13942,IFIT1,46,,91166244
17,3617918,86619,ITGAE,46,,3704537
15,43809805,14013,MAP1A,46,,43823818
1,220701524,136275,MARK1,46,,220837799
5,52856462,122709,NDUFS4,46,,52979171
10,72643264,5279,PCBD1,46,,72648543
13,100741268,441423,PCCA,46,,101182691
7,95212808,13117,PDK4,46,,95225925
3,145787227,92055,PLOD2,46,,145879282
4,155456148,15437,PLRG1,46,,155471585
2,190648810,93545,PMS1,46,,190742355
17,37824705,2023,PNMT,46,,37826728
14,93170151,44896,LGMN,46,,93215047
15,79252288,130927,RASGRF1,46,,79383215
6,32146161,2409,RNF5,46,,32148570
11,67195934,6945,RPS6KB2,46,,67202879
18,61304492,7061,SERPINB4,46,,61311553
1,168545710,5605,XCL1,46,,168551315
3,50192843,33665,SEMA3F,46,,50226508
15,48498497,97778,SLC12A1,46,,48596275
16,89574795,49381,SPG7,46,,89624176
1,193029003,31903,TROVE2,46,,193060906
20,23016056,1258,SSTR4,46,,23017314
11,62574331,25232,STX5,46,,62599563
5,79331121,47986,THBS4,46,,79379107
1,175291934,420818,TNR,46,,175712752
17,44839871,56255,WNT3,46,,44896126
17,55163134,35571,AKAP1,46,,55198705
19,41281081,2317,MIA,46,,41283398
1,46713366,30779,RAD54L,46,,46744145
Y,15015909,16481,DDX3Y,46,,15032390
3,50355220,5061,HYAL2,46,,50360281
6,27100094,481,HIST1H2BJ,46,,27100575
16,3064712,3476,CLDN6,46,,3068188
1,110905472,28232,SLC16A4,46,,110933704
2,102314537,196615,MAP4K4,46,,102511152
17,45608443,92199,NPEPPS,46,,45700642
1,31404352,134212,PUM1,46,,31538564
4,10075962,42611,WDR1,46,,10118573
4,124317949,6966,SPRY1,46,,124324915
9,92219926,1543,GADD45G,46,,92221469
20,60790016,5307,HRH3,46,,60795323
19,50364459,6363,PNKP,46,,50370822
13,77618791,282386,MYCBP2,46,,77901177
9,132962871,36712,NCS1,46,,132999583
12,109038884,57890,CORO1C,46,,109096774
7,115850546,48291,TES,46,,115898837
11,134248397,33415,B3GAT1,46,,134281812
19,39109713,17886,EIF3K,46,,39127599
8,145618445,16288,CPSF1,46,,145634733
8,131064350,391556,ASAP1,46,,131455906
4,113558119,20629,LARP7,46,,113578748
22,20861828,80091,MED15,46,,20941919
7,151038846,36702,NUB1,46,,151075548
1,38158072,17319,CDCA8,46,,38175391
2,32582095,261870,BIRC6,46,,32843965
X,5808066,338857,NLGN4X,46,,6146923
Y,1264893,16723,CRLF2,46,,1281616
8,55370494,2962,SOX17,46,,55373456
11,103777913,257114,PDGFD,46,,104035027
1,163291722,33831,NUF2,46,,163325553
11,95709756,366588,MAML2,46,,96076344
6,27106071,8566,HIST1H2BK,46,,27114637
2,55861197,59848,PNPT1,46,,55921045
8,56685790,53214,TGS1,46,,56739004
4,80898661,95816,ANTXR2,46,,80994477
3,20210971,16754,SGOL1,46,,20227725
15,38545051,104399,SPRED1,46,,38649450
7,20174278,82735,MACC1,46,,20257013
7,25989538,68,MIR148A,46,,25989606
6,72113253,71,MIR30A,46,,72113324
2,219866366,64,MIR375,46,,219866430
3,52017299,5919,ACY1,45,,52023218
20,4201277,28382,ADRA1D,45,,4229659
15,29213839,196677,APBA2,45,,29410516
7,81575759,497363,CACNA2D1,45,,82073122
11,60739112,48736,CD6,45,,60787848
16,64977656,178384,CDH11,45,,65156040
11,67820325,68533,CHKA,45,,67888858
6,70925742,87044,COL9A1,45,,71012786
1,100652477,62932,DBT,45,,100715409
1,20978259,9778,DDOST,45,,20988037
2,172544181,62487,DYNC1I2,45,,172606668
5,169064250,446136,DOCK2,45,,169510386
6,2832565,9718,SERPINB1,45,,2842283
1,50574591,94866,ELAVL4,45,,50669457
14,69846839,18182,ERH,45,,69865021
9,137795081,14768,FCN1,45,,137809849
1,203309748,10809,FMOD,45,,203320557
1,147374945,6450,GJA8,45,,147381395
19,3136029,27738,GNA15,45,,3163767
1,23518387,2835,HTR1D,45,,23521222
20,47980413,118768,KCNB1,45,,48099181
12,48961466,2363,LALBA,45,,48963829
11,34073229,50928,CAPRIN1,45,,34124157
19,3777966,23844,MATK,45,,3801810
17,10424464,28476,MYH2,45,,10452940
18,47349155,372296,MYO5B,45,,47721451
5,16662015,274370,MYO10,45,,16936385
17,46125685,13222,NFE2L1,45,,46138907
11,66615996,109851,PC,45,,66725847
1,10535002,155813,PEX14,45,,10690815
1,10459048,21520,PGD,45,,10480568
12,18414473,386879,PIK3C2G,45,,18801352
1,161136180,4830,PPOX,45,,161141010
6,30568176,16908,PPP1R10,45,,30585084
18,7567313,839546,PTPRM,45,,8406859
14,51371934,39314,PYGL,45,,51411248
17,41150445,4526,RPL27,45,,41154971
20,17594322,68606,RRBP1,45,,17662928
X,13730360,22394,TRAPPC2,45,,13752754
5,155753766,441032,SGCD,45,,156194798
6,31926580,10952,SKIV2L,45,,31937532
18,43304091,28394,SLC14A1,45,,43332485
X,153059903,4064,SSR4,45,,153063967
6,80624528,32787,ELOVL4,45,,80657315
6,166571145,11012,T,45,,166582157
6,34845554,10294,TAF11,45,,34855848
22,19744225,26887,TBX1,45,,19771112
11,59620280,13761,TCN1,45,,59634041
3,12194567,6284,TIMP4,45,,12200851
1,231664398,37871,TSNAX,45,,231702269
17,40128438,40745,DNAJC7,45,,40169183
2,175424301,123326,WIPF1,45,,175547627
6,26240653,368,HIST1H4F,45,,26241021
14,24028771,8274,AP1G2,45,,24037045
12,49223538,22419,DDX23,45,,49245957
6,43484761,4503,POLR1C,45,,43489264
15,64657210,16499,KIAA0101,45,,64673709
9,139334547,43664,SEC16A,45,,139378211
17,60019965,122678,MED13,45,,60142643
11,71709957,3617,IL18BP,45,,71713574
3,100428133,39678,TFG,45,,100467811
4,145915726,103645,ANAPC10,45,,146019371
20,47538274,114956,ARFGEF2,45,,47653230
9,106856830,46870,SMC2,45,,106903700
3,45927995,16672,CCR9,45,,45944667
20,17550598,38054,DSTN,45,,17588652
8,80523048,55362,STMN2,45,,80578410
16,28834368,14190,ATXN2L,45,,28848558
19,50432399,4794,ATF5,45,,50437193
21,45079431,36529,RRP1B,45,,45115960
11,47799634,70462,NUP160,45,,47870096
8,67624652,149605,SGK3,45,,67774257
16,11928054,17388,RSL1D1,45,,11945442
10,95066185,175889,MYOF,45,,95242074
2,113670547,5911,IL37,45,,113676458
2,12856997,25861,TRIB2,45,,12882858
2,24425734,157663,ITSN2,45,,24583397
8,54628102,127769,ATP6V1H,45,,54755871
2,9563665,49574,CPSF3,45,,9613239
15,59279864,109754,RNF111,45,,59389618
16,15737123,83085,NDE1,45,,15820208
12,39687029,150163,KIF21A,45,,39837192
10,70480900,71234,CCAR1,45,,70552134
1,44679124,7227,DMAP1,45,,44686351
6,2765665,20314,WRNIP1,45,,2785979
20,47240792,203628,PREX1,45,,47444420
2,115919683,682643,DPP10,45,,116602326
19,16466054,116769,EPS15L1,45,,16582823
3,179113875,55496,GNB4,45,,179169371
14,99635624,102426,BCL11B,45,,99738050
10,55580859,980192,PCDH15,45,,56561051
3,176737142,177972,TBL1XR1,45,,176915114
12,58118075,13954,AGAP2,45,,58132029
1,71868624,879653,NEGR1,45,,72748277
12,7073259,95,MIR141,45,,7073354
13,92000073,6756,MIR17HG,45,,92006829
15,40226324,101473,EIF2AK4,45,,40327797
6,30539169,20140,ABCF1,44,,30559309
7,150549564,8815,AOC1,44,,150558379
12,121163540,14271,ACADS,44,,121177811
10,135075919,14488,ADAM8,44,,135090407
4,100197522,14663,ADH1A,44,,100212185
12,53817638,7680,AMHR2,44,,53825318
19,36359346,11353,APLP1,44,,36370699
17,3827162,40596,ATP2A3,44,,3867758
21,35275756,12402,ATP5O,44,,35288158
12,8209439,9628,C3AR1,44,,8219067
5,41142247,71448,C6,44,,41213695
17,4801063,5306,CHRNE,44,,4806369
22,51007289,9807,CPT1B,44,,51017096
12,56665482,28693,CS,44,,56694175
2,136663450,79804,DARS,44,,136743254
5,149340299,26664,SLC26A2,44,,149366963
15,80445232,33692,FAH,44,,80478924
2,183698004,33494,FRZB,44,,183731498
5,39105353,165406,FYB,44,,39270759
1,24122088,4946,GALE,44,,24127034
5,150632612,17341,GM2A,44,,150649953
18,11751470,134213,GNAL,44,,11885683
14,65405869,3754,GPX2,44,,65409623
4,108910869,45462,HADH,44,,108956331
22,37966252,9772,LGALS2,44,,37976024
17,79876144,9443,MAFG,44,,79885587
15,75648132,12836,MAN2C1,44,,75660968
5,109025066,180260,MAN2A1,44,,109205326
2,63816284,18046,MDH1,44,,63834330
17,10395626,26233,MYH1,44,,10421859
6,44225902,7623,NFKBIE,44,,44233525
7,107788070,92544,NRCAM,44,,107880614
1,64239689,369363,ROR1,44,,64609052
X,9693452,40553,GPR143,44,,9734005
17,48172100,16633,PDK2,44,,48188733
8,57353512,5781,PENK,44,,57359293
7,92116336,41509,PEX1,44,,92157845
1,151264272,35919,PI4KB,44,,151300191
7,44154278,8891,POLD2,44,,44163169
16,4932507,54629,PPL,44,,4987136
16,31142753,4330,PRSS8,44,,31147083
10,97365685,50882,ALDH18A1,44,,97416567
20,25228705,49943,PYGB,44,,25278648
15,77223961,18640,RCN2,44,,77242601
1,192544856,4303,RGS1,44,,192549159
15,89753097,11825,RLBP1,44,,89764922
2,113403433,17967,SLC20A1,44,,113421400
17,56422535,7064,SUPT4H1,44,,56429599
17,18174742,43664,TOP3A,44,,18218406
1,62901974,15501,USP1,44,,62917475
6,31745296,18416,VARS,44,,31763712
2,224461657,5560,SCG2,44,,224467217
4,1694457,20011,SLBP,44,,1714468
19,2236815,11863,SF3A2,44,,2248678
X,47511190,7389,UXT,44,,47518579
21,45138977,43211,PDXK,44,,45182188
19,10225689,4911,EIF3G,44,,10230600
1,6524170,2085,TNFRSF25,44,,6526255
16,84087365,63183,MBTPS1,44,,84150548
1,1138887,3202,TNFRSF18,44,,1142089
13,45006278,5112,TSC22D1,44,,45011390
1,45340200,112194,EIF2B3,44,,45452394
6,4021568,43649,PRPF4B,44,,4065217
8,42607779,16150,CHRNA6,44,,42623929
3,69103880,25644,UBA3,44,,69129524
1,41249683,56441,KCNQ4,44,,41306124
19,10332108,9840,S1PR2,44,,10341948
2,230628552,158173,TRIP12,44,,230786725
19,6739692,11845,TRIP10,44,,6751537
8,65503409,207939,CYP7B1,44,,65711348
1,9299902,31492,H6PD,44,,9331394
1,31342312,39168,SDC3,44,,31381480
3,100082302,37940,TOMM70A,44,,100120242
7,45197366,26484,RAMP3,44,,45223850
19,676388,7004,FSTL3,44,,683392
10,5454513,46506,NET1,44,,5501019
1,40506254,32067,CAP1,44,,40538321
14,105219469,6527,SIVA1,44,,105225996
12,121675494,59062,CAMKK2,44,,121734556
10,11206992,171680,CELF2,44,,11378672
16,30710461,40989,SRCAP,44,,30751450
X,54834770,7678,MAGED2,44,,54842448
14,24805226,4016,RIPK3,44,,24809242
X,48770458,5955,PIM2,44,,48776413
16,30194730,5667,CORO1A,44,,30200397
11,14299465,80608,RRAS2,44,,14380073
20,32581457,89534,RALY,44,,32670991
13,33160563,191595,PDS5B,44,,33352158
X,53963112,108457,PHF8,44,,54071569
17,74708913,13968,JMJD6,44,,74722881
4,39824482,155094,PDS5A,44,,39979576
19,55773590,18161,HSPBP1,44,,55791751
1,879582,15097,NOC2L,44,,894679
3,127771211,19315,SEC61A1,44,,127790526
2,217277472,70302,SMARCAL1,44,,217347774
16,27438578,24785,IL21R,44,,27463363
9,79379351,23134,PCA3,44,,79402485
2,178487976,265490,PDE11A,44,,178753466
12,12966279,16636,DDX47,44,,12982915
6,31110215,15351,CCHCR1,44,,31125566
10,95256368,32481,CEP55,44,,95288849
11,34127110,41348,NAT10,44,,34168458
10,80828791,247494,ZMIZ1,44,,81076285
4,140222675,89260,NAA15,44,,140311935
15,57998718,11037,POLR2M,44,,58009755
6,7881482,28828,TXNDC5,44,,7910310
9,273047,192212,DOCK8,44,,465259
12,133287392,11931,PGAM5,44,,133299323
1,38076950,23645,RSPO1,44,,38100595
1,955502,35997,AGRN,44,,991499
11,122022936,80,MIR100,44,,122023016
19,52196506,86,MIR125A,44,,52196592
11,111383662,84,MIR34B,44,,111383746
8,131792546,260289,ADCY8,43,,132052835
13,24995068,91880,PARP4,43,,25086948
4,40198526,47858,RHOH,43,,40246384
16,12058963,2962,TNFRSF17,43,,12061925
7,43798271,48670,BLVRA,43,,43846941
8,86351055,10212,CA3,43,,86361267
11,104864966,28929,CASP5,43,,104893895
21,37507262,11598,CBR3,43,,37518860
2,238232654,90196,COL6A3,43,,238322850
5,158122922,403848,EBF1,43,,158526770
5,106712589,294007,EFNA5,43,,107006596
13,41506054,50364,ELF1,43,,41556418
4,81187741,24430,FGF5,43,,81212171
19,45971252,7185,FOSB,43,,45978437
10,48411773,5099,GDF2,43,,48416872
22,41075181,3637,M1,43,,41078818
6,26158348,487,HIST1H2BD,43,,26158835
7,27236498,3227,HOXA13,43,,27239725
2,176981491,3179,HOXD10,43,,176984670
2,231041188,49256,SP110,43,,231090444
Y,59330251,13237,IL9R,43,,59343488
12,21917888,9867,KCNJ8,43,,21927755
6,112429133,146784,LAMA4,43,,112575917
10,82031575,17859,MAT1A,43,,82049434
19,6210391,69568,MLLT1,43,,6279959
6,31707724,22731,MSH5,43,,31730455
14,23851198,26288,MYH6,43,,23877486
3,46899356,5617,MYL3,43,,46904973
12,4758263,38457,NDUFA9,43,,4796720
11,108028118,65247,NPAT,43,,108093365
1,52254865,89744,NRD1,43,,52344609
X,47082416,6978,CDK16,43,,47089394
11,111222980,27177,POU2AF1,43,,111250157
16,11374692,500,PRM1,43,,11375192
10,129705324,178795,PTPRE,43,,129884119
19,1438362,2134,RPS15,43,,1440496
6,7108085,144128,RREB1,43,,7252213
20,16710608,11809,SNRPB2,43,,16722417
17,74034855,33752,SRP68,43,,74068607
7,104756820,182406,SRPK2,43,,104939226
10,29746276,278454,SVIL,43,,30024730
3,12045833,181399,SYN2,43,,12227232
1,43766565,22216,TIE1,43,,43788781
5,14143810,366503,TRIO,43,,14510313
6,24495196,42239,ALDH5A1,43,,24537435
20,10385427,27146,MKKS,43,,10412573
6,26033319,477,HIST1H2AB,43,,26033796
6,143771917,39834,PEX3,43,,143811751
10,51026320,345051,PARG,43,,51371371
3,155588324,67196,GMPS,43,,155655520
8,21766383,4836,DOK2,43,,21771219
11,117075786,27455,PCSK7,43,,117103241
11,113603904,40581,ZW10,43,,113644485
19,8455204,14113,RAB11B,43,,8469317
12,53662082,25345,ESPL1,43,,53687427
1,154192647,43334,UBAP2L,43,,154235981
17,60704761,66201,MRC2,43,,60770962
19,10683346,14645,AP1M2,43,,10697991
3,9834178,14611,ARPC4,43,,9848789
11,20409075,121804,PRMT3,43,,20530879
19,15464331,26281,AKAP8,43,,15490612
6,111876580,50897,TRAF3IP2,43,,111927477
1,24290836,16117,SRSF10,43,,24306953
20,61509089,48814,DIDO1,43,,61557903
10,58117198,3836,ZWINT,43,,58121034
11,74870843,46602,SLCO2B1,43,,74917445
12,54718873,26762,COPZ1,43,,54745635
2,135809834,118445,RAB3GAP1,43,,135928279
11,67007505,18045,KDM2A,43,,67025550
15,22955754,47849,CYFIP1,43,,23003603
3,13357729,104090,NUP210,43,,13461819
17,1963132,206361,SMG6,43,,2169493
22,36134782,101848,RBFOX2,43,,36236630
6,88299784,77388,ORC3,43,,88377172
6,34505578,18532,SPDEF,43,,34524110
16,28548661,1834,NUPR1,43,,28550495
14,75480466,37769,MLH3,43,,75518235
19,59062932,3559,CHMP2A,43,,59066491
19,55912649,6676,UBE2S,43,,55919325
1,202300784,10310,UBE2T,43,,202311094
11,66824288,15200,RHOD,43,,66839488
6,24171982,211538,DCDC2,43,,24383520
20,61904136,17006,ARFGAP1,43,,61921142
20,36322356,178175,CTNNBL1,43,,36500531
17,2207236,21322,SRR,43,,2228558
14,67708011,94767,MPP5,43,,67802778
9,130882971,7496,PTGES2,43,,130890467
15,77905365,19504,LINGO1,43,,77924869
19,1000417,9314,GRIN3B,43,,1009731
20,5281845,15533,PROKR2,43,,5297378
X,63404996,20628,AMER1,43,,63425624
22,39417117,12139,APOBEC3D,43,,39429256
3,2280512,819133,CNTN4,43,,3099645
1,33327868,8546,FNDC5,43,,33336414
7,74572383,15419,NCF1C,43,,74587802
17,26900132,3819,ALDOC,42,,26903951
6,111195986,20929,AMD1,42,,111216915
17,3379295,23405,ASPA,42,,3402700
1,111991742,12783,ATP5F1,42,,112004525
16,2563726,6498,ATP6V0C,42,,2570224
22,18074902,36686,ATP6V1E1,42,,18111588
8,91070835,24274,CALB1,42,,91095109
8,95139393,90138,CDH17,42,,95229531
19,1269266,3905,CIRBP,42,,1273171
1,86934525,31449,CLCA1,42,,86965974
10,96443250,52697,CYP2C18,42,,96495947
10,94833646,3995,CYP26A1,42,,94837641
11,111895537,39465,DLAT,42,,111935002
6,93949739,179561,EPHA7,42,,94129300
4,75230859,23618,EREG,42,,75254477
13,47345390,25977,ESD,42,,47371367
1,110145888,9817,GNAT2,42,,110155705
1,24128366,23583,HMGCL,42,,24151949
4,88720701,12900,IBSP,42,,88733601
12,9747869,12628,KLRB1,42,,9760497
8,89049459,290258,MMP16,42,,89339717
5,102201526,165282,PAM,42,,102366808
4,619362,45319,PDE6B,42,,664681
1,161070345,17521,PFDN2,42,,161087866
14,95027756,8494,SERPINA4,42,,95036250
3,167453431,89926,SERPINI1,42,,167543357
X,15337572,16104,PIGA,42,,15353676
10,103989945,11286,PITX3,42,,104001231
8,22298482,100175,PPP3CC,42,,22398657
9,71627448,1591,PRKACG,42,,71629039
12,70909650,121570,PTPRB,42,,71031220
2,220154344,19951,PTPRN,42,,220174295
11,63304272,9658,RARRES3,42,,63313930
16,24550907,33276,RBBP6,42,,24584183
X,153409697,14810,OPN1LW,42,,153424507
1,153591275,15293,S100A13,42,,153606568
19,4360363,40202,SH3GL1,42,,4400565
1,47715810,64009,STIL,42,,47779819
21,38071432,50786,SIM2,42,,38122218
4,104510624,130349,TACR3,42,,104640973
X,105277189,5529,SERPINA7,42,,105282718
22,19318223,100996,HIRA,42,,19419219
7,129470572,122211,UBE2H,42,,129592783
3,48636431,10667,UQCRC1,42,,48647098
20,52183609,16027,ZNF217,42,,52199636
19,46318699,47849,SYMPK,42,,46366548
X,153712055,2954,UBL4A,42,,153715009
X,153524026,34687,TKTL1,42,,153558713
6,44794466,551322,SUPT3H,42,,45345788
2,178257470,151094,AGPS,42,,178408564
1,27695600,5743,FCN3,42,,27701343
17,25799035,151683,KSR1,42,,25950718
21,34001068,99182,SYNJ1,42,,34100250
3,129033613,1507,H1FX,42,,129035120
2,152126981,19449,NMI,42,,152146430
19,40315986,8887,DYRK1B,42,,40324873
17,76670128,108296,CYTH1,42,,76778424
18,54270052,35868,TXNL1,42,,54305920
1,145096406,20591,SEC22B,42,,145116997
11,125315640,50566,FEZ1,42,,125366206
19,5587009,35929,SAFB2,42,,5622938
2,99953833,62895,EIF5B,42,,100016728
20,4760669,43622,RASSF2,42,,4804291
8,125563010,177738,MTSS1,42,,125740748
16,71929395,35145,IST1,42,,71964540
1,235272657,19599,TOMM20,42,,235292256
17,46908349,34258,CALCOCO2,42,,46942607
20,18488606,53453,SEC23B,42,,18542059
1,110527386,38978,AHCYL1,42,,110566364
11,10579412,10953,LYVE1,42,,10590365
12,75891418,14000,KRR1,42,,75905418
14,77228234,21129,VASH1,42,,77249363
10,104847773,105290,NT5C2,42,,104953063
1,16174358,92592,SPEN,42,,16266950
1,153631129,3199,SNAPIN,42,,153634328
16,46723557,8749,ORC6,42,,46732306
19,49375648,3671,PPP1R15A,42,,49379319
12,10365488,10236,GABARAPL1,42,,10375724
22,39130718,21306,SUN2,42,,39152024
3,47422471,32460,PTPN23,42,,47454931
2,219135114,2556,PNKD,42,,219137670
11,34642587,42247,EHF,42,,34684834
6,74303101,60636,SLC17A5,42,,74363737
10,75880014,30829,AP3M1,42,,75910843
3,47057897,147570,SETD2,42,,47205467
16,67263291,18134,FHOD1,42,,67281425
10,103585730,17947,KCNIP2,42,,103603677
17,16318855,21462,TRPV2,42,,16340317
2,152266396,67464,RIF1,42,,152333860
14,101292444,34916,MEG3,42,,101327360
19,14230320,17120,ASF1B,42,,14247440
3,53317444,64210,DCP1A,42,,53381654
3,170606203,20223,EIF5A2,42,,170626426
18,11851388,3060,CHMP1B,42,,11854448
3,185304030,44855,SENP2,42,,185348885
19,52467592,22487,ZNF350,42,,52490079
3,39138089,11302,GORASP1,42,,39149391
11,66025173,10159,KLC2,42,,66035332
20,30102212,55158,HM13,42,,30157370
5,89854616,605417,GPR98,42,,90460033
16,48200821,68267,ABCC11,42,,48269088
13,33691684,68532,STARD13,42,,33760216
19,39971051,13373,TIMM50,42,,39984424
12,53720359,9808,SP7,42,,53730167
9,77337410,165226,TRPM6,42,,77502636
15,55722505,77927,DYX1C1,42,,55800432
5,112312406,45486,DCP2,42,,112357892
7,142960521,5701,GSTK1,42,,142966222
1,149832329,396,HIST2H4B,42,,149832725
9,130628758,11264,AK1,41,,130640022
7,127228405,3354,ARF5,41,,127231759
X,69488184,13506,ARR3,41,,69501690
2,241653180,106545,KIF1A,41,,241759725
1,111415721,26837,CD53,41,,111442558
5,98190907,71331,CHD1,41,,98262238
7,29519327,34624,CHN2,41,,29553951
5,175819455,24115,CLTB,41,,175843570
16,85833172,7437,COX4I1,41,,85840609
12,69244955,82024,CPM,41,,69326979
2,208992860,1694,CRYGC,41,,208994554
17,79679265,8781,SLC25A10,41,,79688046
12,56324945,22862,DGKA,41,,56347807
2,74153952,32136,DGUOK,41,,74186088
7,96649701,4442,DLX5,41,,96654143
7,95401817,325919,DYNC1I1,41,,95727736
7,155250823,6703,EN2,41,,155257526
12,131274144,49675,STX2,41,,131323819
15,76508628,95182,ETFA,41,,76603810
4,185676748,56665,ACSL1,41,,185733413
X,54471886,50713,FGD1,41,,54522599
8,42911441,29491,FNTA,41,,42940932
2,28615778,21738,FOSL2,41,,28637516
X,151335633,284198,GABRA3,41,,151619831
X,120181461,2335,GLUD2,41,,120183796
19,35842444,923,FFAR1,41,,35843367
4,144917256,23242,GYPB,41,,144940498
5,140053488,17824,HARS,41,,140071312
1,26798901,4232,HMGN2,41,,26803133
17,46698518,5317,HOXB9,41,,46703835
9,98997588,66846,HSD17B3,41,,99064434
19,10397642,1618,ICAM4,41,,10399260
3,52812508,13576,ITIH1,41,,52826084
17,39657232,4633,KRT13,41,,39661865
16,75507021,21905,CHST6,41,,75528926
7,103766787,81708,ORC5,41,,103848495
10,74766979,89753,P4HA1,41,,74856732
3,135969166,79847,PCCB,41,,136049013
12,53689234,4000,PFDN5,41,,53693234
X,18910415,92065,PHKA2,41,,19002480
12,15475190,276075,PTPRO,41,,15751265
17,79989531,2549,RAC3,41,,79992080
12,389222,109399,KDM5A,41,,498621
6,49572889,31698,RHAG,41,,49604587
3,77147162,551952,ROBO2,41,,77699114
20,60962120,1456,RPS21,41,,60963576
2,120197418,84610,SCTR,41,,120282028
4,74702272,2205,CXCL6,41,,74704477
11,126225539,58997,ST3GAL4,41,,126284536
12,21417533,70299,SLCO1A2,41,,21487832
X,128580477,77005,SMARCA1,41,,128657482
15,45315301,51986,SORD,41,,45367287
14,50583838,114573,SOS2,41,,50698411
X,54946995,10871,TRO,41,,54957866
9,135250936,31302,TTF1,41,,135282238
16,21964384,30597,UQCRC2,41,,21994981
X,154444700,23422,VBP1,41,,154468122
2,17721806,115900,VSNL1,41,,17837706
4,1984440,26522,NELFA,41,,2010962
13,100634025,4994,ZIC2,41,,100639019
7,96318078,21125,SHFM1,41,,96339203
16,14766404,22026,PLA2G10,41,,14788430
5,172741725,14781,STC2,41,,172756506
12,121458094,18951,OASL,41,,121477045
8,145538245,12337,DGAT1,41,,145550582
2,103035249,33775,IL18RAP,41,,103069024
1,173010359,9744,TNFSF18,41,,173020103
2,9983570,90975,TAF1B,41,,10074545
16,67471916,43173,ATP6V0D1,41,,67515089
4,155665122,9149,LRAT,41,,155674271
11,57319127,16053,UBE2L6,41,,57335180
9,26903367,44101,PLAA,41,,26947468
1,159032274,14373,AIM2,41,,159046647
7,73868119,148801,GTF2IRD1,41,,74016920
6,160148531,28821,WTAP,41,,160177352
10,75504130,27803,SEC24C,41,,75531933
7,150904922,19538,ABCF2,41,,150924460
1,155225769,6407,SCAMP3,41,,155232176
1,62208148,421443,INADL,41,,62629591
11,32605312,19107,EIF3M,41,,32624419
14,39501122,71610,SEC23A,41,,39572732
9,35732316,4689,CREB3,41,,35737005
10,131934638,44008,GLRX3,41,,131978646
6,32260474,79215,C6orf10,41,,32339689
9,127020195,94524,NEK6,41,,127114719
11,74699949,18794,NEU3,41,,74718743
9,34661879,810,CCL27,41,,34662689
8,99129520,42549,POP1,41,,99172069
9,101984569,8332,SEC61B,41,,101992901
5,659976,33534,TPPP,41,,693510
12,120123594,191501,CIT,41,,120315095
20,34043222,56582,CEP250,41,,34099804
13,73329539,26727,DIS3,41,,73356266
9,132649465,156008,FNBP1,41,,132805473
8,145486001,29119,BOP1,41,,145515120
10,1034348,29360,GTPBP4,41,,1063708
1,85279085,79811,LPAR3,41,,85358896
19,15490858,39074,AKAP8L,41,,15529932
6,42928491,3127,GNMT,41,,42931618
7,44084238,17077,DBNL,41,,44101315
19,17378184,11978,BABAM1,41,,17390162
22,44395090,170022,PARVB,41,,44565112
14,100531750,78823,EVL,41,,100610573
20,62289162,38444,RTEL1,41,,62327606
2,173940564,192173,ZAK,41,,174132737
12,46751970,14675,SLC38A2,41,,46766645
19,49661015,54083,TRPM4,41,,49715098
13,20277008,80151,PSPC1,41,,20357159
11,46417961,197658,AMBRA1,41,,46615619
17,38060847,14056,GSDMB,41,,38074903
14,24779356,1903,LTB4R2,41,,24781259
19,49122547,11116,SPHK2,41,,49133663
19,41892275,10981,EXOSC5,41,,41903256
3,139062860,13027,MRPS22,41,,139075887
16,57462080,19360,CIAPIN1,41,,57481440
12,4430358,38832,C12orf5,41,,4469190
17,27717942,160979,TAOK1,41,,27878921
1,205681946,37426,NUCKS1,41,,205719372
12,102139274,85371,GNPTAB,41,,102224645
14,24649424,8700,IPO4,41,,24658124
8,124510126,43367,FBXO32,41,,124553493
11,14899555,14196,CYP2R1,41,,14913751
6,25727136,437,HIST1H2BA,41,,25727573
4,3465032,31177,DOK7,41,,3496209
7,103014654,71970,SLC26A5,41,,103086624
11,111384163,77,MIR34C,41,,111384240
11,64781584,8073,ARL2,40,,64789657
17,7004640,13490,ASGR2,40,,7018130
8,20054703,24504,ATP6V1B2,40,,20079207
X,153656977,7886,ATP6AP1,40,,153664863
11,66278118,22966,BBS1,40,,66301084
4,15704572,29224,BST1,40,,15733796
3,15643251,45890,BTD,40,,15689141
6,41888964,11820,BYSL,40,,41900784
3,184063972,15467,CLCN2,40,,184079439
9,34551429,38709,CNTFR,40,,34590138
17,27573874,7628,CRYBA1,40,,27581502
2,79740059,1135929,CTNNA2,40,,80875988
1,206317458,14646,CTSE,40,,206332104
20,57570241,12068,CTSZ,40,,57582309
17,48067368,5220,DLX3,40,,48072588
19,13033283,11275,FARSA,40,,13044558
18,33234532,57266,GALNT1,40,,33291798
12,133360453,44973,GOLGA3,40,,133405426
2,241375114,32381,GPC1,40,,241407495
1,110198697,5634,GSTM4,40,,110204331
22,24322218,3888,GSTT2,40,,24326106
14,105675622,106292,BRF1,40,,105781914
7,8152814,149097,ICA1,40,,8301911
14,94577078,5958,IFI27,40,,94583036
7,142638200,21303,KEL,40,,142659503
16,29802033,14673,KIF22,40,,29816706
13,76194569,239437,LMO7,40,,76434006
21,47608359,40379,LSS,40,,47648738
6,119498365,172566,MAN1A1,40,,119670931
3,196728611,28076,MFI2,40,,196756687
4,71296208,52506,MUC7,40,,71348714
17,57059999,124283,TRIM37,40,,57184282
11,2965659,47948,NAP1L4,40,,3013607
18,9102627,31716,NDUFV2,40,,9134343
10,71962585,30605,PPA1,40,,71993190
4,82008523,66788,PRKG2,40,,82075311
12,56367696,22771,RAB5B,40,,56390467
11,47459307,11423,RAPSN,40,,47470730
11,65101224,19227,DPF2,40,,65120451
10,16632616,226837,RSU1,40,,16859453
1,109756514,24290,SARS,40,,109780804
3,38738836,96665,SCN10A,40,,38835501
17,34340095,4910,CCL23,40,,34345005
22,31478845,21765,SMTN,40,,31500610
5,122110690,59544,SNX2,40,,122170234
16,69221049,121906,SNTB2,40,,69342955
2,73114511,4778,SPR,40,,73119289
X,52780279,10338,SSX2,40,,52790617
16,28603263,5128,SULT1A2,40,,28608391
19,49078992,23692,SULT2B1,40,,49102684
8,38644721,65825,TACC1,40,,38710546
16,4307186,15815,TFAP4,40,,4323001
15,70340129,50127,TLE3,40,,70390256
1,201372894,17980,TNNI1,40,,201390874
13,103249285,83023,TPP2,40,,103332308
3,50654561,32167,MAPKAPK3,40,,50686728
9,139088095,6924,LHX3,40,,139095019
22,19166986,112253,CLTCL1,40,,19279239
7,90893782,4350,FZD1,40,,90898132
11,70116805,113802,PPFIA1,40,,70230607
11,46383144,18960,DGKZ,40,,46402104
9,13105702,173861,MPDZ,40,,13279563
15,85427891,61136,SLC28A1,40,,85489027
17,73645793,17476,RECQL5,40,,73663269
17,9153787,325488,STX8,40,,9479275
11,66099541,4459,RIN1,40,,66104000
11,10772533,28769,CTR9,40,,10801302
12,6603297,37835,NCAPD2,40,,6641132
18,214519,53540,THOC1,40,,268059
7,98972297,20107,ARPC1B,40,,98992404
12,56596287,19198,RNF41,40,,56615485
1,186265404,18290,PRG4,40,,186283694
17,40913211,1849,RAMP2,40,,40915060
9,100745488,32736,ANP32B,40,,100778224
1,110943876,6670,LAMTOR5,40,,110950546
8,68109883,146029,ARFGEF1,40,,68255912
19,42460832,2696,RABAC1,40,,42463528
9,91003296,90326,SPIN1,40,,91093622
22,43265771,145413,PACSIN2,40,,43411184
11,70313960,621882,SHANK2,40,,70935842
10,88195012,86529,WAPAL,40,,88281541
4,37892704,248092,TBC1D1,40,,38140796
8,106331146,485621,ZFPM2,40,,106816767
12,124196864,49437,ATP6V0A2,40,,124246301
2,192813771,245888,TMEFF2,40,,193059659
8,95439939,47404,RAD54B,40,,95487343
6,151186814,236209,MTHFD1L,40,,151423023
2,73300509,39637,RAB11FIP5,40,,73340146
7,72983276,9737,TBL2,40,,72993013
2,71558884,103307,ZNF638,40,,71662191
7,138391038,91903,ATP6V0A4,40,,138482941
3,3191316,30085,CRBN,40,,3221401
14,51192545,105294,NIN,40,,51297839
22,32783561,24713,RTCB,40,,32808274
14,52456227,15193,C14orf166,40,,52471420
17,48796925,33147,LUC7L3,40,,48830072
9,139834884,4322,FBXW5,40,,139839206
7,5659671,161690,RNF216,40,,5821361
4,102734982,260987,BANK1,40,,102995969
10,99400442,35747,PI4K2A,40,,99436189
5,177576464,4497,NHP2,40,,177580961
12,14518565,137304,ATF7IP,40,,14655869
4,77870866,88902,11-Sep,40,,77959768
2,86668583,51256,KDM3A,40,,86719839
4,26862312,164691,STIM2,40,,27027003
17,78234659,137922,RNF213,40,,78372581
1,97187160,93445,PTBP2,40,,97280605
3,133502876,37460,SRPRB,40,,133540336
17,74385612,63676,UBE2O,40,,74449288
1,2985741,369444,PRDM16,40,,3355185
14,105155942,30005,INF2,40,,105185947
2,232646380,27583,COPS7B,40,,232673963
16,67691414,3304,ACD,40,,67694718
X,64732461,22225,LAS1L,40,,64754686
16,3631183,30424,SLX4,40,,3661607
10,6131308,28114,RBM17,40,,6159422
9,101978706,5540,ALG2,40,,101984246
19,13229101,22860,NACC1,40,,13251961
9,6413150,93901,UHRF2,40,,6507051
15,52230221,33777,LEO1,40,,52263998
6,74405807,132234,CD109,40,,74538041
1,32645344,18542,TXLNA,40,,32663886
6,39302875,390306,KIF6,40,,39693181
8,11627171,17683,NEIL2,40,,11644854
1,149859018,448,HIST2H2AB,40,,149859466
6,52009146,86,MIR206,40,,52009232
1,198828172,110,MIR181A1,40,,198828282
1,156390132,89,MIR9-1,40,,156390221
17,73937588,37927,ACOX1,39,,73975515
5,7396342,433852,ADCY2,39,,7830194
16,50321822,30223,ADCY7,39,,50352045
16,4012649,153537,ADCY9,39,,4166186
2,233271551,3873,ALPPL2,39,,233275424
11,118443101,30646,ARCN1,39,,118473747
17,7554207,6882,ATP1B2,39,,7561089
21,27096790,11175,ATP5J,39,,27107965
2,74753774,3250,AUP1,39,,74757024
14,69254371,6260,ZFP36L1,39,,69260631
1,57320442,63452,C8A,39,,57383894
9,140772240,246836,CACNA1B,39,,141019076
2,87042459,46588,CD8B,39,,87089047
20,60074476,441197,CDH4,39,,60515673
4,68337988,73268,CENPC,39,,68411256
9,91926109,5509,CKS2,39,,91931618
12,108681820,51274,CMKLR1,39,,108733094
20,61448413,24098,COL9A3,39,,61472511
7,24737973,59110,DFNA5,39,,24797083
19,12786530,5495,DHPS,39,,12792025
11,118967212,5573,DPAGT1,39,,118972785
18,28709213,33606,DSC1,39,,28742819
17,41843488,12880,DUSP3,39,,41856368
8,29190578,17689,DUSP4,39,,29208267
8,86089618,37135,E2F5,39,,86126753
12,124105569,12754,EIF2B1,39,,124118323
15,43489425,23898,EPB42,39,,43513323
X,147582138,500055,AFF2,39,,148082193
14,65453506,75864,FNTB,39,,65529370
5,161112657,16941,GABRA6,39,,161129598
6,89887222,40274,GABRR1,39,,89927496
3,121382045,86569,GOLGB1,39,,121468614
4,74902311,2179,CXCL3,39,,74904490
2,127413510,40741,GYPC,39,,127454251
10,102891060,6486,TLX1,39,,102897546
7,27193337,2959,HOXA7,39,,27196296
10,7745235,46248,ITIH2,39,,7791483
1,38275238,50054,MTF1,39,,38325292
1,61547979,380481,NFIA,39,,61928460
19,2269484,4003,OAZ1,39,,2273487
11,72983186,26484,P2RY6,39,,73009670
1,207226619,27749,PFKFB2,39,,207254368
3,149682690,6051,PFN2,39,,149688741
1,20396700,21694,PLA2G5,39,,20418394
20,9288446,173016,PLCB4,39,,9461462
6,57182414,330962,PRIM2,39,,57513376
19,5205518,135296,PTPRS,39,,5340814
17,40276993,30069,RAB5C,39,,40307062
13,23755059,144245,SGCG,39,,23899304
2,45169036,4180,SIX3,39,,45173216
19,2785457,28145,THOP1,39,,2813602
11,1860718,2192,TNNI2,39,,1862910
17,4172511,97458,UBE2G1,39,,4269969
9,114659045,38609,UGCG,39,,114697654
6,30152231,29040,TRIM26,39,,30181271
11,19203576,28542,CSRP3,39,,19232118
12,69753489,31161,YEATS4,39,,69784650
12,123745516,9265,CDK2AP1,39,,123754781
6,27782821,446,HIST1H2BM,39,,27783267
6,26225382,462,HIST1H3E,39,,26225844
6,52991759,21865,GCM1,39,,53013624
11,43333504,32576,API5,39,,43366080
1,87794150,20457,LMO4,39,,87814607
1,21132784,370597,EIF4G3,39,,21503381
6,112375277,15610,WISP3,39,,112390887
11,95566043,91328,MTMR2,39,,95657371
X,15843928,29209,AP1S2,39,,15873137
17,48638428,66404,CACNA1G,39,,48704832
X,46937753,14960,RGN,39,,46952713
16,57653909,45042,GPR56,39,,57698951
19,50861728,7359,NAPSA,39,,50869087
7,156931654,130412,UBE3C,39,,157062066
16,19535178,29550,CCP110,39,,19564728
16,72127614,19197,DHX38,39,,72146811
2,171847332,240492,TLK1,39,,172087824
11,66360689,12801,CCS,39,,66373490
12,110872694,15522,ARPC3,39,,110888216
16,67880634,25835,NUTF2,39,,67906469
1,46016454,19269,AKR1A1,39,,46035723
5,17216931,60023,BASP1,39,,17276954
8,136469707,190145,KHDRBS3,39,,136659852
3,238278,212819,CHL1,39,,451097
2,183789578,114008,NCKAP1,39,,183903586
1,196743929,19274,CFHR3,39,,196763203
19,7599590,27063,PNPLA6,39,,7626653
X,118750908,76425,6-Sep,39,,118827333
22,26887893,20544,TFIP11,39,,26908437
2,86251568,81710,POLR1A,39,,86333278
7,106809405,33569,HBP1,39,,106842974
14,24678786,4250,CHMP4A,39,,24683036
22,37886399,28811,CARD10,39,,37915210
8,17086737,17681,CNOT7,39,,17104418
1,150937648,9831,CERS2,39,,150947479
14,94749649,9959,SERPINA10,39,,94759608
17,37617763,73055,CDK12,39,,37690818
X,70364680,26371,NLGN3,39,,70391051
7,36429411,63990,ANLN,39,,36493401
7,12250847,26043,TMEM106B,39,,12276890
19,14016955,24738,CC2D1A,39,,14041693
2,74379724,26370,MOB1A,39,,74406094
11,64323072,17275,SLC22A11,39,,64340347
X,118722299,17547,NKRF,39,,118739846
20,46286149,129211,SULF2,39,,46415360
14,75230068,73945,YLPM1,39,,75304013
7,7222245,66035,C1GALT1,39,,7288280
14,73525220,62856,RBM25,39,,73588076
3,71820805,13552,PROK2,39,,71834357
9,86890764,64930,SLC28A3,39,,86955694
1,226332379,42044,ACBD3,39,,226374423
14,23842069,3543,IL25,39,,23845612
3,14166439,18741,TMEM43,39,,14185180
17,73201544,30310,NUP85,39,,73231854
5,141689991,14629,SPRY4,39,,141704620
4,84382093,24197,FAM175A,39,,84406290
X,133507341,55481,PHF6,39,,133562822
19,50372289,8355,AKT1S1,39,,50380644
17,48211098,16780,PPP1R9B,39,,48227878
4,54326436,131317,LNX1,39,,54457753
10,101292689,3591,NKX2-3,39,,101296280
7,99691615,82,MIR106B,39,,99691697
20,61151512,71,MIR1-1,39,,61151583
7,99691390,80,MIR93,39,,99691470
16,70286296,37116,AARS,38,,70323412
9,139901685,21055,ABCA2,38,,139922740
9,38392660,6002,ALDH1B1,38,,38398662
17,7942357,10094,ALOX15B,38,,7952451
12,7801995,16504,APOBEC1,38,,7818499
22,19957401,46908,ARVCF,38,,20004309
12,24962957,139436,BCAT1,38,,25102393
19,589892,27267,HCN2,38,,617159
4,75669969,49927,BTC,38,,75719896
17,80272745,2735,CD7,38,,80275480
17,73996986,5094,CDK3,38,,74002080
10,5238797,22113,AKR1C4,38,,5260910
8,27317277,19536,CHRNA2,38,,27336813
15,43885054,6550,CKMT1B,38,,43891604
19,11649531,11607,CNN1,38,,11661138
11,33162976,20061,CSTF3,38,,33183037
9,121928907,202832,BRINP1,38,,122131739
8,91013579,50648,DECR1,38,,91064227
10,135175986,10922,ECHS1,38,,135186908
14,103800338,11023,EIF5,38,,103811361
11,64888098,1574,FAU,38,,64889672
3,13590624,89298,FBLN2,38,,13679922
11,69624735,9457,FGF3,38,,69634192
15,50578076,69529,GABPB1,38,,50647605
17,79762007,9882,GCGR,38,,79771889
17,61957571,1731,GH2,38,,61959302
2,165349322,129038,GRB14,38,,165478360
12,14765565,83954,GUCY2C,38,,14849519
10,100175954,30766,HPS1,38,,100206720
7,154862033,17069,HTR5A,38,,154879102
5,140027383,14682,IK,38,,140042065
2,155555092,159772,KCNJ3,38,,155714864
12,10583205,5387,KLRC2,38,,10588592
9,138413283,5103,LCN1,38,,138418386
5,112357795,466732,MCC,38,,112824527
15,37183221,210279,MEIS2,38,,37393500
12,57482676,6583,NAB2,38,,57489259
9,117092068,3468,ORM2,38,,117095536
16,89710838,13355,CHMP1A,38,,89724193
10,13319795,21951,PHYH,38,,13341746
21,44394619,59422,PKNOX1,38,,44454041
8,28196164,4707,PNOC,38,,28200871
4,122722471,15705,EXOSC9,38,,122738176
22,19705957,4888,5-Sep,38,,19710845
6,43044551,84907,PTK7,38,,43129458
3,61547242,733331,PTPRG,38,,62280573
17,79890261,4943,PYCR1,38,,79895204
17,72199794,6225,RPL38,38,,72206019
2,234216308,39393,SAG,38,,234255701
2,65215578,35422,SLC1A4,38,,65251000
X,21958690,54265,SMS,38,,22012955
6,34724870,16764,SNRPC,38,,34741634
7,21467651,86789,SP4,38,,21554440
11,66452719,36151,SPTBN2,38,,66488870
1,225965514,12654,SRP9,38,,225978168
17,80709939,191123,TBCD,38,,80901062
X,9431334,256446,TBL1X,38,,9687780
22,42556018,123915,TCF20,38,,42679933
17,26662547,11488,TNFAIP1,38,,26674035
2,219283837,30411,VIL1,38,,219314248
7,73588705,22724,EIF4H,38,,73611429
12,49359122,6519,WNT10B,38,,49365641
2,202899309,3851,FZD7,38,,202903160
21,40547371,8069,PSMG1,38,,40555440
6,167343003,27074,RNASET2,38,,167370077
6,108532420,50044,SNX3,38,,108582464
5,156904311,98520,ADAM19,38,,157002831
5,170846666,37964,FGF18,38,,170884630
2,118572254,17699,DDX18,38,,118589953
12,123319984,27523,HIP1R,38,,123347507
15,77287425,42391,PSTPIP1,38,,77329816
5,115163893,13655,ATG12,38,,115177548
5,154238078,18274,CNOT8,38,,154256352
19,14640378,36414,TECR,38,,14676792
1,146714290,53157,CHD1L,38,,146767447
11,95523624,42233,CEP57,38,,95565857
5,179159850,44437,MAML1,38,,179204287
6,24544331,102052,KIAA0319,38,,24646383
7,72349905,72074,POM121,38,,72421979
16,1543351,17109,TELO2,38,,1560460
3,136055998,415247,STAG1,38,,136471245
14,77924372,11443,AHSA1,38,,77935815
3,190105660,24272,CLDN16,38,,190129932
2,85843214,33193,USP39,38,,85876407
22,45559725,24165,NUP50,38,,45583890
2,109510926,94902,EDAR,38,,109605828
7,87505543,33313,DBF4,38,,87538856
6,101163006,166242,ASCC3,38,,101329248
19,51525486,4386,KLK11,38,,51529872
22,38914953,49461,DMC1,38,,38964414
14,55405655,88164,WDHD1,38,,55493819
14,35221936,122917,BAZ1A,38,,35344853
22,40440820,290992,TNRC6B,38,,40731812
17,16946073,149889,MPRIP,38,,17095962
9,96213977,114420,FAM120A,38,,96328397
6,34857037,202153,ANKS1A,38,,35059190
7,872141,42416,SUN1,38,,914557
22,24407819,166777,CABIN1,38,,24574596
11,119981993,26870,TRIM29,38,,120008863
10,92671856,9176,ANKRD1,38,,92681032
9,139743267,2228,PHPT1,38,,139745495
21,45666221,15878,DNMT3L,38,,45682099
1,154975105,15896,ZBTB7B,38,,154991001
11,43702142,176027,HSD17B12,38,,43878169
3,182655945,42444,DCUN1D1,38,,182698389
12,109185694,65665,SSH1,38,,109251359
7,132469622,297296,CHCHD3,38,,132766918
8,27950583,98086,ELP3,38,,28048669
20,48552913,17509,RNF114,38,,48570422
1,17733250,31809,RCC2,38,,17765059
1,156030939,9366,RAB25,38,,156040305
4,22694536,126659,GBA3,38,,22821195
6,31765168,9593,LSM2,38,,31774761
21,43791995,24205,TMPRSS3,38,,43816200
1,110881944,7359,RBM15,38,,110889303
5,68485374,20810,CENPH,38,,68506184
19,34287750,18916,KCTD15,38,,34306666
9,86595636,23351,RMI1,38,,86618987
1,150190716,17788,ANP32E,38,,150208504
8,145153535,5605,SHARPIN,38,,145159140
20,33104188,24574,DYNLRB1,38,,33128762
1,1407134,24450,ATAD3B,38,,1431584
20,3208062,11825,SLC4A11,38,,3219887
2,113829894,3533,IL1F10,38,,113833427
12,55024622,4041,LACRT,38,,55028663
X,131211020,51030,FRMD7,38,,131262050
19,4675243,48612,DPP9,38,,4723855
19,49547101,1467,CGB5,38,,49548568
7,44873212,14513,H2AFV,38,,44887725
18,3262610,15672,MYL12B,38,,3278282
1,160454819,38233,SLAMF6,38,,160493052
13,32313678,63331,RXFP2,38,,32377009
4,187112673,21944,CYP4V2,38,,187134617
6,64429875,1987243,EYS,38,,66417118
6,18120717,2134,NHLRC1,38,,18122851
12,122656576,2170,IL31,38,,122658746
2,233320821,4634,ALPI,37,,233325455
1,104159953,8449,AMY2A,37,,104168402
3,49711434,9500,APEH,37,,49720934
12,101786897,14701,ARL1,37,,101801598
20,32848170,8978,ASIP,37,,32857148
17,40610861,63736,ATP6V0A1,37,,40674597
16,56518258,35750,BBS2,37,,56554008
1,207262583,10754,C4BPB,37,,207273337
2,85621870,19327,CAPG,37,,85641197
16,88941262,102242,CBFA2T3,37,,89043504
2,135676391,40524,CCNT2,37,,135716915
1,235824330,205897,LYST,37,,236030227
2,201717731,11553,CLK1,37,,201729284
5,82934016,82880,HAPLN1,37,,83016896
22,26995361,18630,CRYBB1,37,,27013991
11,65779461,1515,CST6,37,,65780976
20,54967426,12156,CSTF1,37,,54979582
7,91741462,22378,CYP51A1,37,,91763840
19,3958450,12671,DAPK3,37,,3971121
19,859658,3911,CFD,37,,863569
14,102027687,2102,DIO3,37,,102029789
17,48050129,2194,DLX4,37,,48052323
1,38462441,8746,FHL3,37,,38471187
3,50229042,6087,GNAT1,37,,50235129
17,7215977,2681,GPS2,37,,7218658
8,145064225,3358,GRINA,37,,145067583
3,120347014,54404,HGD,37,,120401418
1,221052742,5658,HLX,37,,221058400
2,220144039,7583,DNAJB2,37,,220151622
7,112063198,54060,IFRD1,37,,112117258
17,39669996,5274,KRT15,37,,39675270
7,108210188,5106,DNAJB9,37,,108215294
6,83920109,220829,ME1,37,,84140938
12,101988708,90950,MYBPC1,37,,102079658
1,40361095,6592,MYCL,37,,40367687
15,73344824,252723,NEO1,37,,73597547
9,14081841,232204,NFIB,37,,14314045
19,49403306,23234,NUCB1,37,,49426540
6,137143701,91371,PEX7,37,,137235072
2,68592321,32264,PLEK,37,,68624585
10,118305435,21935,PNLIP,37,,118327370
3,195241217,29007,PPP1R2,37,,195270224
9,33750463,48766,PRSS3,37,,33799229
6,128289923,551896,PTPRK,37,,128841819
1,76251878,8897,RABGGTB,37,,76260775
3,152880000,8413,RAP2B,37,,152888413
11,32112476,14796,RCN1,37,,32127272
2,79312148,3002,REG1B,37,,79315150
1,182567757,5791,RGS16,37,,182573548
8,55528626,14768,RP1,37,,55543394
4,109541713,9926,RPL34,37,,109551639
15,84115979,171514,SH3GL3,37,,84287493
X,48114751,12128,SSX1,37,,48126879
2,37064840,128775,STRN,37,,37193615
16,66541905,42289,TK2,37,,66584194
4,70345882,15744,UGT2B4,37,,70361626
1,165796731,84124,UCK2,37,,165880855
7,76054271,17117,ZP3,37,,76071388
2,208627309,6834,FZD5,37,,208634143
1,32372021,13238,PTP4A2,37,,32385259
X,53220502,34102,KDM5C,37,,53254604
6,26124372,546,HIST1H2AC,37,,26124918
6,26104175,390,HIST1H4C,37,,26104565
15,44829265,25736,EIF3J,37,,44855001
3,57231943,2337,HESX1,37,,57234280
11,64126624,13063,RPS6KA4,37,,64139687
16,67204399,5241,NOL3,37,,67209640
1,68511644,5670,DIRAS3,37,,68517314
X,70459473,15574,ZMYM3,37,,70475047
12,130822432,33493,PIWIL1,37,,130855925
5,892968,16079,TRIP13,37,,909047
2,197644812,19680,GTF3C3,37,,197664492
2,26680070,101496,OTOF,37,,26781566
1,31732414,37230,SNRNP40,37,,31769644
10,105353783,261381,SH3PXD2A,37,,105615164
7,111366163,480299,DOCK4,37,,111846462
16,30968614,27369,SETD1A,37,,30995983
19,36208920,20861,KMT2B,37,,36229781
14,55614833,43563,DLGAP5,37,,55658396
9,36572858,104822,MELK,37,,36677680
3,38207025,89954,OXSR1,37,,38296979
15,34522196,107765,SLC12A6,37,,34629961
14,20811772,14291,PARP2,37,,20826063
15,38780301,76706,RASGRP1,37,,38857007
19,1040101,25469,ABCA7,37,,1065570
2,242434121,13989,STK25,37,,242448110
10,83635069,1111866,NRG3,37,,84746935
17,17584786,129979,RAI1,37,,17714765
10,135092133,30527,TUBGCP2,37,,135122660
5,137492572,21786,BRD8,37,,137514358
17,37793332,27122,STARD3,37,,37820454
20,61436176,9176,OGFR,37,,61445352
5,54273694,7720,ESM1,37,,54281414
1,17393255,52693,PADI2,37,,17445948
X,56258788,59175,KLF8,37,,56317963
3,127407904,134189,MGLL,37,,127542093
2,213864410,151923,IKZF2,37,,214016333
10,64133915,28302,ZNF365,37,,64162217
7,154735399,59283,PAXIP1,37,,154794682
6,72922513,190332,RIMS1,37,,73112845
12,72148642,38614,RAB21,37,,72187256
17,7743234,14884,KDM6B,37,,7758118
10,99116457,44670,RRP12,37,,99161127
17,74077073,22795,EXOC7,37,,74099868
14,104200087,113840,PPP1R13B,37,,104313927
6,126070731,11684,HEY2,37,,126082415
10,76586170,206210,KAT6B,37,,76792380
1,220321609,124234,RAB3GAP2,37,,220445843
22,44351260,41152,SAMM50,37,,44392412
15,72766666,112230,ARIH1,37,,72878896
22,36863092,14595,TXN2,37,,36877687
17,25621105,19540,WSB1,37,,25640645
19,1407567,28119,DAZAP1,37,,1435686
9,80911990,33019,PSAT1,37,,80945009
11,65633911,6494,EFEMP2,37,,65640405
6,30029016,3670,ZNRD1,37,,30032686
2,71057342,5611,CD207,37,,71062953
X,151999510,38397,NSDHL,37,,152037907
9,37779710,5379,EXOSC3,37,,37785089
16,31539172,953,AHSP,37,,31540125
15,65822826,47867,PTPLAD1,37,,65870693
3,142025448,141456,XRN1,37,,142166904
11,85405264,63848,SYTL2,37,,85469112
16,87985037,125887,BANP,37,,88110924
15,68499329,22751,CLN6,37,,68522080
1,236712304,55537,HEATR1,37,,236767841
17,30469472,83318,RHOT1,37,,30552790
17,48458593,16321,LRRC59,37,,48474914
10,60028861,20158,CISD1,37,,60049019
10,71909960,20325,SAR1A,37,,71930285
12,99137751,150923,ANKS1B,37,,99288674
19,7684410,10029,XAB2,37,,7694439
2,8868986,108769,KIDINS220,37,,8977755
5,32124823,49602,GOLPH3,37,,32174425
9,139258407,9726,CARD9,37,,139268133
12,26272958,5045,BHLHE41,37,,26278003
10,93558150,67082,TNKS2,37,,93625232
2,231729609,14360,ITM2C,37,,231743969
2,113299491,35238,POLR1B,37,,113334729
4,57514153,8535,HOPX,37,,57522688
11,122526397,158790,UBASH3B,37,,122685187
14,75548081,45702,NEK9,37,,75593783
18,20715726,124708,CABLES1,37,,20840434
5,174905500,51244,SFXN1,37,,174956744
3,112182812,35596,BTLA,37,,112218408
10,64926980,102003,JMJD1C,37,,65028983
X,30845558,61953,TAB3,37,,30907511
1,5922867,129666,NPHP4,37,,6052533
17,44107281,195459,KANSL1,37,,44302740
1,65524116,75,MIR101-1,37,,65524191
17,56408592,87,MIR142,37,,56408679
2,241395417,89,MIR149,37,,241395506
16,28722740,24310,EIF3CL,37,,28747050
10,81315607,4610,SFTPA2,37,,81320217
7,45613738,90533,ADCY1,36,,45704271
15,101419896,36934,ALDH1A3,36,,101456830
8,26240522,30122,BNIP3L,36,,26270644
2,175664041,206066,CHN1,36,,175870107
11,46406341,1817,CHRM4,36,,46408158
17,28707495,89180,CPD,36,,28796675
4,5822490,72320,CRMP1,36,,5894810
20,23804403,2909,CST2,36,,23807312
10,17179334,64736,TRDMT1,36,,17244070
9,131580778,4177,ENDOG,36,,131584955
4,111397228,87265,ENPEP,36,,111484493
4,66185280,350933,EPHA5,36,,66536213
1,171154346,27476,FMO2,36,,171181822
11,71927818,5176,FOLR2,36,,71932994
2,166604312,46491,GALNT3,36,,166650803
15,45653321,17659,GATM,36,,45670980
9,79074067,48265,GCNT1,36,,79122332
17,46673098,9236,HOXB6,36,,46682334
2,177028804,9022,HOXD3,36,,177037826
15,78441718,21166,IDH3A,36,,78462884
4,71521257,11091,IGJ,36,,71532348
9,34652181,9717,IL11RA,36,,34661898
8,82569150,29439,IMPA1,36,,82598589
3,52847005,17712,ITIH4,36,,52864717
22,38822332,17701,KCNJ4,36,,38840033
10,116190868,253546,ABLIM1,36,,116444414
17,18128935,19253,LLGL1,36,,18148188
13,37418967,75442,SMAD9,36,,37494409
2,20191812,20643,MATN3,36,,20212455
2,192110001,180114,MYO1B,36,,192290115
11,67374322,5690,NDUFV1,36,,67380012
11,132284558,1117949,OPCML,36,,133402507
2,61244811,34314,PEX13,36,,61279125
6,33378772,5458,PHF1,36,,33384230
6,99282579,4087,POU3F2,36,,99286666
1,180123967,43202,QSOX1,36,,180167169
8,77892493,20031,PEX2,36,,77912524
1,153954092,3750,RAB13,36,,153957842
13,114321596,117041,GRK1,36,,114438637
2,74652987,16073,RTKN,36,,74669060
14,70242551,21455,SLC10A1,36,,70264006
3,121613170,49864,SLC15A2,36,,121663034
17,26989215,40487,SUPT6H,36,,27029702
20,62496580,26318,TPD52L2,36,,62522898
6,35465650,15029,TULP1,36,,35480679
18,32912171,12260,ZNF24,36,,32924431
10,21823573,208986,MLLT10,36,,22032559
11,34937676,79999,PDHX,36,,35017675
6,27806439,449,HIST1H2BN,36,,27806888
6,26027123,357,HIST1H4B,36,,26027480
1,46505811,92897,PIK3R3,36,,46598708
22,29904155,45581,THOC5,36,,29949736
1,56960418,84839,PPAP2B,36,,57045257
7,39989958,146775,CDK13,36,,40136733
6,144471653,41423,STX11,36,,144513076
12,94071146,173385,CRADD,36,,94244531
4,108534821,106598,PAPSS1,36,,108641419
18,3496029,349329,DLGAP1,36,,3845358
1,70671364,46337,SRSF11,36,,70717701
22,21213291,32210,SNAP29,36,,21245501
11,62760295,23022,SLC22A8,36,,62783317
6,41303527,15098,NCR2,36,,41318625
5,156565450,4336,MED7,36,,156569786
5,137203544,19996,MYOT,36,,137223540
5,141346401,23455,RNF14,36,,141369856
1,243287729,130979,CEP170,36,,243418708
11,74165885,12715,KCNE3,36,,74178600
15,52401465,3507,BCL2L10,36,,52404972
19,867961,25257,MED16,36,,893218
2,223436161,84913,FARSB,36,,223521074
2,204192961,103935,ABI2,36,,204296896
20,62704534,6311,RGS19,36,,62710845
3,48956252,66719,ARIH2,36,,49022971
13,53602875,23321,OLFM4,36,,53626196
10,123922940,91120,TACC2,36,,124014060
10,101909846,35968,ERLIN1,36,,101945814
15,52413122,59040,GNB5,36,,52472162
2,74425689,16735,MTHFD2,36,,74442424
13,27131839,131243,WASF3,36,,27263082
5,176758562,20323,LMAN2,36,,176778885
12,53905842,114357,ATF7,36,,54020199
7,937536,57507,ADAP1,36,,995043
10,79734906,54392,POLR3A,36,,79789298
10,12207326,30817,NUDT5,36,,12238143
3,52489523,26403,NISCH,36,,52515926
12,64798152,44311,XPOT,36,,64842463
17,47007458,14746,SNF8,36,,47022204
5,150020206,11697,SYNPO,36,,150031903
17,38296506,31925,CASC3,36,,38328431
10,119764426,41688,RAB11FIP2,36,,119806114
7,97736196,102748,LMTK2,36,,97838944
17,79163392,33397,CEP131,36,,79196789
19,4969123,184485,KDM4B,36,,5153608
1,78161673,63891,USP33,36,,78225564
9,6757640,319624,KDM4C,36,,7077264
1,46269284,232512,MAST2,36,,46501796
16,1756220,64098,MAPK8IP3,36,,1820318
6,42531759,56330,UBR2,36,,42588089
16,53633150,104700,RPGRIP1L,36,,53737850
18,2655885,149130,SMCHD1,36,,2805015
1,55532031,149008,USP24,36,,55681039
9,114122972,124053,KIAA0368,36,,114247025
6,13574760,40630,SIRT5,36,,13615390
2,46769866,41961,RHOQ,36,,46811827
12,108955238,7922,ISCU,36,,108963160
22,30792929,28362,SEC14L2,36,,30821291
12,54574141,8637,SMUG1,36,,54582778
20,4702499,6609,PRND,36,,4709108
6,56954827,80271,ZNF451,36,,57035098
1,6161846,78348,CHD5,36,,6240194
1,51701944,37175,RNF11,36,,51739119
11,126173646,42002,DCPS,36,,126215648
21,17102343,150047,USP25,36,,17252390
2,174937174,176224,OLA1,36,,175113398
7,23544400,27260,TRA2A,36,,23571660
1,109419602,53442,GPSM2,36,,109473044
14,31363004,132603,STRN3,36,,31495607
20,25051520,11495,VSX1,36,,25063015
11,62443969,2620,UBXN1,36,,62446589
13,28194879,46680,POLR1D,36,,28241559
9,33264876,17191,CHMP5,36,,33282067
2,24290453,8861,SF3B6,36,,24299314
X,131157635,52336,STK26,36,,131209971
19,35645844,14944,FXYD5,36,,35660788
4,68481478,85411,UBA6,36,,68566889
1,46654352,31625,POMGNT1,36,,46685977
19,55476651,35859,NLRP2,36,,55512510
15,40509628,60060,PAK6,36,,40569688
15,93586635,30581,RGMA,36,,93617216
X,122734411,132493,THOC2,36,,122866904
1,153777382,118069,GATAD2B,36,,153895451
4,17812435,34052,NCAPG,36,,17846487
1,32799429,2411,MARCKSL1,36,,32801840
11,61170119,27345,CPSF7,36,,61197464
2,48034058,98874,FBXO11,36,,48132932
8,37716464,40551,RAB11FIP1,36,,37757015
13,60239722,498397,DIAPH3,36,,60738119
8,144939491,13141,EPPK1,36,,144952632
15,62939509,197320,TLN2,36,,63136829
17,27041298,3988,RAB34,36,,27045286
1,228395830,170745,OBSCN,36,,228566575
18,72201691,50570,CNDP1,36,,72252261
9,130213764,52016,LRSAM1,36,,130265780
4,69176104,39731,YTHDC1,36,,69215835
2,239756672,75572,TWIST2,36,,239832244
2,219125737,2845,GPBAR1,36,,219128582
2,65537984,55947,SPRED2,36,,65593931
6,25726290,500,HIST1H2AA,36,,25726790
10,105213143,5505,CALHM1,36,,105218648
11,65265232,8751,MALAT1,36,,65273983
17,6920933,87,MIR195,36,,6921020
17,27188386,72,MIR451A,36,,27188458
3,38164200,14533,ACAA1,35,,38178733
22,51176651,7076,ACR,35,,51183727
10,111767693,127630,ADD3,35,,111895323
7,65540775,17554,ASL,35,,65558329
1,8412463,465236,RERE,35,,8877699
8,104033247,52038,ATP6V1C1,35,,104085285
5,72794249,7199,BTF3,35,,72801448
5,162864576,7446,CCNG1,35,,162872022
14,54863672,23262,CDKN3,35,,54886934
5,149546343,17778,CDX1,35,,149564121
3,186256227,6013,CRYGS,35,,186262240
4,70820973,5756,CSN2,35,,70826729
16,30907927,6954,CTF1,35,,30914881
10,98064084,34237,DNTT,35,,98098321
8,22545173,4729,EGR3,35,,22549902
X,20142635,17331,EIF1AX,35,,20159966
10,72163860,24514,EIF4EBP2,35,,72188374
20,34680631,140090,EPB41L1,35,,34820721
20,45523262,294230,EYA2,35,,45817492
1,171227061,28056,FMO1,35,,171255117
4,46920916,75508,GABRA4,35,,46996424
15,27111865,82492,GABRA5,35,,27194357
4,157997276,95966,GLRB,35,,158093242
20,3024267,2124,GNRH2,35,,3026391
3,51741080,11545,GRM2,35,,51752625
15,59930260,19477,GTF2A2,35,,59949737
11,66129991,9300,SLC29A2,35,,66139291
11,68671318,36751,IGHMBP2,35,,68708069
3,52828783,14242,ITIH3,35,,52843025
15,40697685,15827,IVD,35,,40713512
5,61601988,81023,KIF2A,35,,61683011
1,153232178,2422,LOR,35,,153234600
4,103552642,129509,MANBA,35,,103682151
6,160327973,1134,MAS1,35,,160329107
19,40697650,23832,MAP3K10,35,,40721482
11,129733669,31821,NFRKB,35,,129765490
11,59341870,41747,OSBP,35,,59383617
11,117014999,32132,PAFAH1B2,35,,117047131
2,79384131,2749,REG3A,35,,79386880
6,32152509,5454,PBX2,35,,32157963
12,102590236,1387,PMCH,35,,102591623
19,617222,16346,POLRMT,35,,633568
4,6322304,243023,PPP2R2C,35,,6565327
X,48432740,6813,RBM3,35,,48439553
1,151313115,6654,RFX5,35,,151319769
3,12876443,6638,RPL32,35,,12883081
14,60062693,274864,RTN1,35,,60337557
3,4344987,13962,SETMAR,35,,4358949
8,134467090,117093,ST3GAL1,35,,134584183
12,22346324,141324,ST8SIA1,35,,22487648
11,65405577,12814,SIPA1,35,,65418391
16,67977376,25221,SLC12A4,35,,68002597
6,109761930,3192,SMPD2,35,,109765122
X,139585151,2074,SOX3,35,,139587225
12,56391042,8267,SUOX,35,,56399309
17,35766976,70250,TADA2A,35,,35837226
1,235530674,81609,TBCE,35,,235612283
10,127477146,34691,UROS,35,,127511837
11,75526211,329071,UVRAG,35,,75855282
2,58273776,113279,VRK2,35,,58387055
7,73624086,20078,LAT2,35,,73644164
X,73040485,32103,XIST,35,,73072588
6,31554976,1710,LST1,35,,31556686
6,26251878,425,HIST1H2BH,35,,26252303
19,48551099,63010,PLA2G4C,35,,48614109
20,43343484,12969,WISP2,35,,43356453
15,58245621,112500,ALDH1A2,35,,58358121
6,158438079,82128,SYNJ2,35,,158520207
10,72575703,65229,SGPL1,35,,72640932
22,30279157,147700,MTMR3,35,,30426857
3,179370932,136257,USP13,35,,179507189
7,100849257,11754,PLOD3,35,,100861011
17,39878890,12008,HAP1,35,,39890898
5,9035137,511096,SEMA5A,35,,9546233
2,85132762,1037,TMSB10,35,,85133799
22,33669061,647355,LARGE,35,,34316416
18,67956136,41298,SOCS6,35,,67997434
1,52607765,204593,ZFYVE9,35,,52812358
1,71528973,17999,ZRANB2,35,,71546972
3,27414211,111700,SLC4A7,35,,27525911
6,8073592,29236,EEF1E1,35,,8102828
5,77656326,120236,SCAMP1,35,,77776562
14,104022880,6271,BAG5,35,,104029151
4,160188997,92304,RAPGEF2,35,,160281301
16,30772932,14696,RNF40,35,,30787628
12,110367596,66598,GIT2,35,,110434194
6,84262604,156243,SNAP91,35,,84418847
1,149874871,3672,SV2A,35,,149878543
1,200520624,69238,KIF14,35,,200589862
17,52978051,61277,TOM1L1,35,,53039328
1,183595327,9749,ARPC5,35,,183605076
6,49695091,17059,CRISP3,35,,49712150
16,30362086,4169,CD2BP2,35,,30366255
13,73356229,234362,PIBF1,35,,73590591
9,139567594,14317,AGPAT2,35,,139581911
10,92631708,36604,RPP30,35,,92668312
9,134378288,20905,POMT1,35,,134399193
5,176784843,14756,RGS14,35,,176799599
19,45909466,4558,CD3EAP,35,,45914024
18,12328942,48333,AFG3L2,35,,12377275
2,173686314,231306,RAPGEF4,35,,173917620
17,19807764,73405,AKAP10,35,,19881169
1,221874761,40757,DUSP10,35,,221915518
22,18632757,27405,USP18,35,,18660162
17,61851548,45129,DDX42,35,,61896677
3,173116237,884902,NLGN1,35,,174001139
3,52529355,29156,STAB1,35,,52558511
15,41709301,66460,RTF1,35,,41775761
2,242577026,36245,ATG4B,35,,242613271
9,79792360,240039,VPS13A,35,,80032399
14,31091524,113509,SCFD1,35,,31205033
2,20448452,102159,PUM2,35,,20550611
1,206516199,121584,SRGAP2,35,,206637783
16,67906925,11492,EDC4,35,,67918417
1,28099693,51270,STX12,35,,28150963
2,171784947,38696,GORASP2,35,,171823643
7,69063904,1194150,AUTS2,35,,70258054
1,179851176,38036,TOR1AIP1,35,,179889212
1,39328161,10889,MYCBP,35,,39339050
19,2425621,2293,TIMM13,35,,2427914
7,130146079,207519,COPG2,35,,130353598
3,182840002,40665,LAMP3,35,,182880667
1,229734940,26854,TAF5L,35,,229761794
7,6061877,36983,EIF2AK1,35,,6098860
19,47835403,9869,C5AR2,35,,47845272
7,82449795,342402,PCLO,35,,82792197
6,34482648,20352,PACSIN1,35,,34503000
18,47808712,5980,CXXC1,35,,47814692
9,139557378,9752,EGFL7,35,,139567130
1,162760491,22117,HSD17B7,35,,162782608
6,142468298,73787,VTA1,35,,142542085
5,32354451,90416,ZFR,35,,32444867
5,137688284,84432,KDM3B,35,,137772716
8,87586162,169741,CNGB3,35,,87755903
2,86333304,35976,PTCD3,35,,86369280
1,155629232,29333,YY1AP1,35,,155658565
2,128520059,48702,WDR33,35,,128568761
4,4269428,22320,LYAR,35,,4291748
11,65837823,174395,PACS1,35,,66012218
7,97920961,109466,BAIAP2L1,35,,98030427
2,72356366,18625,CYP26B1,35,,72374991
11,65292547,13635,SCYL1,35,,65306182
20,44650328,38461,SLC12A5,35,,44688789
4,134070444,4586,PCDH10,35,,134075030
2,128698790,86079,SAP130,35,,128784869
8,67542487,36965,VCPIP1,35,,67579452
1,224572844,49157,WDR26,35,,224622001
10,70320116,134123,TET1,35,,70454239
6,150285109,9740,ULBP1,35,,150294849
12,111086490,41127,HVCN1,35,,111127617
5,180017104,1383,SCGB3A1,35,,180018487
1,228645064,496,HIST3H2A,35,,228645560
11,72396113,67321,ARAP1,35,,72463434
17,55333930,428120,MSI2,35,,55762050
14,68168602,32566,RDH12,35,,68201168
17,48450580,8240,EME1,35,,48458820
11,94501507,108411,AMOTL1,35,,94609918
10,72972291,90344,UNC5B,35,,73062635
10,52065344,318393,SGMS1,35,,52383737
7,20655244,141393,ABCB5,35,,20796637
17,27400527,106880,MYO18A,35,,27507407
10,91352503,81,MIR107,35,,91352584
16,8806825,71607,ABAT,34,,8878432
11,47260852,9546,ACP2,34,,47270398
1,33473540,28972,AK2,34,,33502512
10,104433483,40707,ARL3,34,,104474190
4,94750077,1065,ATOH1,34,,94751142
2,219524378,3788,BCS1L,34,,219528166
9,72999512,30061,KLF9,34,,73029573
2,152689285,266396,CACNB4,34,,152955681
9,117663424,29451,TNFSF8,34,,117692875
13,77566058,10594,CLN5,34,,77576652
1,201452657,23730,CSRP1,34,,201476387
16,72042642,16674,DHODH,34,,72059316
19,926036,46767,ARID3A,34,,972803
18,74962007,20089,GALR1,34,,74982096
9,89559276,2828,GAS1,34,,89562104
9,6532463,113229,GLDC,34,,6645692
17,80332152,1310,UTS2R,34,,80333462
6,33986419,127495,GRM4,34,,34113914
2,27548715,31186,GTF3C2,34,,27579901
16,202853,1651,HBZ,34,,204504
17,46668618,2485,HOXB5,34,,46671103
4,70894129,8126,HTN3,34,,70902255
7,20370724,84658,ITGB8,34,,20455382
11,8245850,44332,LMO1,34,,8290182
X,138663929,126452,MCF2,34,,138790381
18,48405431,70731,ME2,34,,48476162
6,161412758,125659,MAP3K4,34,,161538417
14,50087488,2711,MGAT2,34,,50090199
7,123177051,20907,NDUFA5,34,,123197958
19,54641435,18011,CNOT3,34,,54659446
12,113416273,10337,OAS2,34,,113426610
11,14665268,228336,PDE3B,34,,14893604
5,139624634,58055,PFDN1,34,,139682689
17,42018169,1666,PPY,34,,42019835
1,214522038,202986,PTPN14,34,,214725024
4,99182526,182486,RAP1GDS1,34,,99365012
1,240938813,581717,RGS7,34,,241520530
12,51985019,221629,SCN8A,34,,52206648
4,52886860,17625,SGCB,34,,52904485
15,32933813,55486,SCG5,34,,32989299
5,176811431,6083,SLC34A1,34,,176817514
5,168088737,639396,SLIT3,34,,168728133
6,7281375,32172,SSR1,34,,7313547
12,3068477,81365,TEAD4,34,,3149842
14,20833825,47754,TEP1,34,,20881579
8,63972047,26565,TTPA,34,,63998612
1,211748380,3719,SLC30A1,34,,211752099
6,27791902,356,HIST1H4J,34,,27792258
19,41103140,32585,LTBP4,34,,41135725
12,53497273,21050,SOAT2,34,,53518323
1,231376918,36801,GNPAT,34,,231413719
15,74701624,24676,SEMA7A,34,,74726300
10,90424145,14427,LIPF,34,,90438572
12,112280031,51197,MAPKAPK5,34,,112331228
1,100818022,167811,CDC14A,34,,100985833
4,100799494,16209,LAMTOR3,34,,100815703
12,117298224,21008,HRK,34,,117319232
2,27422454,12721,SLC5A6,34,,27435175
9,133454959,58780,FUBP3,34,,133513739
6,26250369,466,HIST1H3F,34,,26250835
10,93683735,106345,BTAF1,34,,93790080
10,105036919,13189,INA,34,,105050108
9,135545421,24921,GTF3C4,34,,135570342
11,58294343,51369,LPXN,34,,58345712
2,24300302,6899,TP53I3,34,,24307201
7,99055783,8041,ATP5J2,34,,99063824
1,179923907,160108,CEP350,34,,180084015
15,80696691,193586,ARNT2,34,,80890277
9,2804154,39976,KIAA0020,34,,2844130
3,150929904,37094,P2RY14,34,,150966998
1,40204516,25070,PPIE,34,,40229586
6,33257411,1300,PFDN6,34,,33258711
10,21068902,394214,NEBL,34,,21463116
X,48380163,6941,EBP,34,,48387104
4,47596014,244109,CORIN,34,,47840123
10,181423,119154,ZMYND11,34,,300577
6,165740775,334813,PDE10A,34,,166075588
9,131102838,20911,SLC27A4,34,,131123749
1,78470511,13137,DNAJB4,34,,78483648
19,51499263,5695,KLK8,34,,51504958
8,124260689,26038,ZHX1,34,,124286727
4,128703363,51865,HSPA4L,34,,128755228
1,169890469,153410,KIFAP3,34,,170043879
2,160802325,116801,PLA2R1,34,,160919126
12,133195365,3607,P2RX2,34,,133198972
9,102741462,119872,ERP44,34,,102861334
8,22844929,32781,RHOBTB2,34,,22877710
16,4674824,66151,MGRN1,34,,4740975
2,200134222,188597,SATB2,34,,200322819
15,99645285,30515,SYNM,34,,99675800
21,37692486,56458,MORC3,34,,37748944
19,1065921,21909,HMHA1,34,,1087830
20,45926869,58764,ZMYND8,34,,45985633
11,65029322,36834,POLA2,34,,65066156
15,49170289,2091,EID1,34,,49172380
7,24836155,183676,OSBPL3,34,,25019831
2,215796265,100545,ABCA12,34,,215896810
9,77703397,58717,OSTF1,34,,77762114
13,53029494,21272,CKAP2,34,,53050766
1,36602169,12946,TRAPPC3,34,,36615115
X,83313353,129590,RPS6KA6,34,,83442943
1,213031596,41109,FLVCR1,34,,213072705
16,69775756,13115,NOB1,34,,69788871
14,21467413,2621,SLC39A2,34,,21470034
1,1152287,15160,SDF4,34,,1167447
22,46692637,34070,GTSE1,34,,46726707
15,31619057,51045,KLF13,34,,31670102
21,43823970,43820,UBASH3A,34,,43867790
4,77035811,33857,NUP54,34,,77069668
2,183580767,63983,DNAJC10,34,,183644750
9,19053134,49806,HAUS6,34,,19102940
11,71808337,6096,LAMTOR1,34,,71814433
10,90043858,299224,RNLS,34,,90343082
6,142623055,144348,GPR126,34,,142767403
3,39093476,44685,WDR48,34,,39138161
10,100216833,778799,HPSE2,34,,100995632
16,17196180,368558,XYLT1,34,,17564738
5,96211642,43778,ERAP2,34,,96255420
5,138282409,251656,SIL1,34,,138534065
9,37485931,17763,POLR1E,34,,37503694
15,83211950,28623,CPEB1,34,,83240573
9,91933387,41191,SECISBP2,34,,91974578
4,2743386,14366,TNIP2,34,,2757752
22,50920152,4714,ADM2,34,,50924866
10,32556643,79503,EPC1,34,,32636146
1,151584661,86898,SNX27,34,,151671559
15,63569748,31577,APH1B,34,,63601325
1,1266725,3975,TAS1R3,34,,1270700
10,7860466,196550,TAF3,34,,8057016
3,97483364,36722,ARL6,34,,97520086
6,27114860,481,HIST1H2AH,34,,27115341
2,47129008,13999,MCFD2,34,,47143007
15,40380091,20984,BMF,34,,40401075
2,7017795,20568,RSAD2,34,,7038363
17,61896792,8239,FTSJ3,34,,61905031
12,97301243,46226,NEDD1,34,,97347469
19,10426888,17426,RAVER1,34,,10444314
3,112641531,52406,CD200R1,34,,112693937
6,163148163,588361,PACRG,34,,163736524
3,191046873,69586,CCDC50,34,,191116459
12,101549993,54023,SLC5A8,34,,101604016
10,35625801,235797,CCNY,34,,35861598
12,109991520,19838,MMAB,34,,110011358
5,56775842,2794,ACTBL2,34,,56778636
16,69966983,100,MIR140,34,,69967083
13,92003004,71,MIR18A,34,,92003075
4,20529897,110,MIR218-1,34,,20530007
1,207975196,88,MIR29C,34,,207975284
7,129414532,77,MIR96,34,,129414609
17,74463629,2570,AANAT,33,,74466199
17,31340105,1143720,ASIC2,33,,32483825
10,75936246,532815,ADK,33,,76469061
1,165631448,36452,ALDH9A1,33,,165667900
17,7975953,15068,ALOX12B,33,,7991021
19,45445494,3259,APOC4,33,,45448753
19,12848272,10866,ASNA1,33,,12859138
3,141595433,49957,ATP1B3,33,,141645390
15,72978519,52298,BBS4,33,,73030817
1,147013270,84750,BCL9,33,,147098020
12,92534053,5620,BTG1,33,,92539673
1,9005892,29256,CA6,33,,9035148
1,158323485,3858,CD1E,33,,158327343
1,26644410,2604,CD52,33,,26647014
6,75794041,121582,COL12A1,33,,75915623
19,19322781,40280,NCAN,33,,19363061
9,841689,127401,DMRT1,33,,969090
19,12986024,6311,DNASE2,33,,12992335
1,93811477,16671,DR1,33,,93828148
14,76837689,130491,ESRRB,33,,76968180
16,86544132,3938,FOXF1,33,,86548070
1,84964005,8257,GNG5,33,,84972262
3,37284681,123689,GOLGA4,33,,37408370
3,194115549,4446,GP5,33,,194119995
1,37261127,238717,GRIK3,33,,37499844
7,156797546,4583,MNX1,33,,156802129
17,46606806,1466,HOXB1,33,,46608272
16,67197287,6561,HSF4,33,,67203848
10,91092235,8490,IFIT3,33,,91100725
17,21279698,43481,KCNJ12,33,,21323179
11,61640994,18023,FADS3,33,,61659017
16,29817857,4647,MAZ,33,,29822504
6,46761093,46426,MEP1A,33,,46807519
18,29769986,30380,MEP1B,33,,29800366
12,16500576,16768,MGST1,33,,16517344
16,58059469,21335,MMP15,33,,58080804
X,154006958,26844,MPP1,33,,154033802
16,56691854,1361,MT1F,33,,56693215
2,240896788,68031,NDUFA10,33,,240964819
11,67798083,6031,NDUFS8,33,,67804114
9,94171326,14818,NFIL3,33,,94186144
11,124609828,7274,NRGN,33,,124617102
9,95145552,21429,OGN,33,,95166981
3,170139027,13452,CLDN11,33,,170152479
6,2948392,24007,SERPINB6,33,,2972399
1,208195587,222078,PLXNA2,33,,208417665
12,57125363,20783,PRIM1,33,,57146146
15,52311410,47052,MAPK6,33,,52358462
13,96329392,117851,DNAJC3,33,,96447243
8,128806778,306721,PVT1,33,,129113499
2,217363519,2669,RPL37A,33,,217366188
Y,2709622,25375,RPS4Y1,33,,2734997
17,48243345,9948,SGCA,33,,48253293
8,134048972,66338,SLA,33,,134115310
1,44462154,35010,SLC6A9,33,,44497164
1,152974222,2110,SPRR3,33,,152976332
14,35452103,46670,SRP54,33,,35498773
18,23806846,164803,TAF4B,33,,23971649
11,120973374,88141,TECTA,33,,121061515
19,10400654,6800,ICAM5,33,,10407454
9,82186687,155109,TLE4,33,,82341796
X,37545008,46375,XK,33,,37591383
12,53874275,19169,MAP3K12,33,,53893444
8,28351721,80064,FZD3,33,,28431785
7,116593380,276695,ST7,33,,116870075
6,27861202,467,HIST1H2BO,33,,27861669
6,26045638,459,HIST1H3C,33,,26046097
6,26188937,367,HIST1H4D,33,,26189304
6,26285353,374,HIST1H4H,33,,26285727
6,26204872,377,HIST1H4E,33,,26205249
1,94027342,285364,BCAR3,33,,94312706
20,57226308,28274,STX16,33,,57254582
18,10525872,26894,NAPG,33,,10552766
13,48516790,58672,SUCLA2,33,,48575462
6,33387846,33620,SYNGAP1,33,,33421466
1,167691186,69970,MPZL1,33,,167761156
1,156776034,10606,SH2D2A,33,,156786640
2,9545809,17889,ITGB1BP1,33,,9563698
9,135906061,27829,GTF3C5,33,,135933890
4,174447651,3727,HAND2,33,,174451378
2,233415296,33059,EIF4E2,33,,233448355
6,43597278,11410,MAD2L1BP,33,,43608688
3,121488607,65319,IQCB1,33,,121553926
1,144951760,43273,PDE4DIP,33,,144995033
10,105726942,62049,SLK,33,,105788991
2,27593362,7038,SNX17,33,,27600400
12,51632507,5210,DAZAP2,33,,51637717
12,106457124,76687,NUAK1,33,,106533811
1,115110180,14085,BCAS2,33,,115124265
22,36956915,141775,CACNG2,33,,37098690
13,113139318,103181,TUBGCP3,33,,113242499
12,7079943,5222,EMG1,33,,7085165
X,129757356,279935,ENOX2,33,,130037291
2,37869024,30654,CDC42EP3,33,,37899678
17,26904582,21474,SPAG5,33,,26926056
5,75843233,160724,IQGAP2,33,,76003957
8,24151552,64979,ADAM28,33,,24216531
1,118472371,30678,WDR3,33,,118503049
6,167412804,43102,FGFR1OP,33,,167455906
2,27301434,7831,EMILIN1,33,,27309265
3,49044494,8892,WDR6,33,,49053386
15,41523436,50647,CHP1,33,,41574083
15,49030134,73209,CEP152,33,,49103343
9,72873877,95912,SMC5,33,,72969789
2,62934031,339590,EHBP1,33,,63273621
4,6576900,47231,MAN2B2,33,,6624131
6,148663728,209456,SASH1,33,,148873184
12,56521985,16475,ESYT1,33,,56538460
3,142720371,59196,U2SURP,33,,142779567
1,200374074,5112,ZNF281,33,,200379186
22,18121349,92272,BCL2L13,33,,18213621
18,33690962,18395,SLC39A6,33,,33709357
4,73939682,149149,ANKRD17,33,,74088831
9,139221931,32126,GPSM1,33,,139254057
12,117348760,120193,FBXW8,33,,117468953
19,36024313,11908,GAPDHS,33,,36036221
12,56864727,17471,GLS2,33,,56882198
7,16685758,60390,BZW2,33,,16746148
19,51581229,6238,KLK14,33,,51587467
10,71331790,1420,NEUROG3,33,,71333210
1,21069170,44011,HP1BP3,33,,21113181
4,17578926,30664,LAP3,33,,17609590
X,73802810,31651,RLIM,33,,73834461
17,79993756,1817,DCXR,33,,79995573
7,33053724,48685,NT5C3A,33,,33102409
19,8367010,6230,CD320,33,,8373240
10,28822420,89621,WAC,33,,28912041
13,29233140,19953,POMP,33,,29253093
14,67804580,22140,ATP6V1D,33,,67826720
6,90036343,26276,UBE2J1,33,,90062619
10,114135955,52183,ACSL5,33,,114188138
5,52083773,14679,PELO,33,,52098452
17,19437166,45180,SLC47A1,33,,19482346
11,27515964,12362,LIN7C,33,,27528326
3,53880576,19251,IL17RB,33,,53899827
19,51328544,6235,KLK15,33,,51334779
12,103981068,179434,STAB2,33,,104160502
1,201798287,55135,IPO9,33,,201853422
7,141251077,103132,AGK,33,,141354209
11,123499894,25421,SCN3B,33,,123525315
1,167778624,104840,ADCY10,33,,167883464
8,81880045,144258,PAG1,33,,82024303
1,68167148,132007,GNG12,33,,68299155
2,113735595,7654,IL36G,33,,113743249
22,31835344,50203,EIF4ENIF1,33,,31885547
Y,26979989,73198,DAZ2,33,,27053187
1,160708846,15762,SLAMF7,33,,160724608
10,124134093,57778,PLEKHA1,33,,124191871
3,49726931,32031,RNF123,33,,49758962
5,70883114,71416,MCCC2,33,,70954530
1,43212005,20750,LEPRE1,33,,43232755
12,72233486,87143,TBC1D15,33,,72320629
1,68564141,134088,WLS,33,,68698229
2,228549925,32820,SLC19A3,33,,228582745
18,12947982,39554,SEH1L,33,,12987536
22,42979726,31242,POLDIP3,33,,43010968
16,69166498,36439,CIRH1A,33,,69202937
5,121187649,874,FTMT,33,,121188523
17,17746821,128963,TOM1L2,33,,17875784
12,46123619,178200,ARID2,33,,46301819
3,185225569,44800,LIPH,33,,185270369
11,22214721,90192,ANO5,33,,22304913
19,36545782,50230,WDR62,33,,36596012
18,19405658,88,MIR133A1,33,,19405746
1,198828001,110,MIR181B1,33,,198828111
19,10928101,71,MIR199A1,33,,10928172
19,13947400,73,MIR23A,33,,13947473
9,97848302,68,MIR24-1,33,,97848370
1,206224282,7200,AVPR1B,32,,206231482
7,116502562,56751,CAPZA2,32,,116559313
2,233390869,10506,CHRND,32,,233401375
1,155232658,10662,CLK2,32,,155243320
15,74907334,15208,CLK3,32,,74922542
1,36560836,29849,COL8A2,32,,36590685
9,101705994,127080,COL15A1,32,,101833074
15,78632665,7907,CRABP1,32,,78640572
20,23666276,3386,CST4,32,,23669662
1,47264669,20352,CYP4B1,32,,47285021
14,23033806,24337,DAD1,32,,23058143
5,146770370,119249,DPYSL3,32,,146889619
10,119301955,7102,EMX2,32,,119309057
3,184279586,20610,EPHB3,32,,184300196
14,45584801,18931,FKBP3,32,,45603732
9,139924625,2667,FUT7,32,,139927292
16,74481325,159717,GLG1,32,,74641042
7,124385654,20425,GPR37,32,,124406079
7,126078651,804918,GRM8,32,,126883569
6,26107639,725,HIST1H1T,32,,26108364
16,69139466,12104,HAS3,32,,69151570
10,96305523,56333,HELLS,32,,96361856
16,72097124,14021,HPR,32,,72111145
11,125462689,29965,STT3A,32,,125492654
12,53200326,7574,KRT4,32,,53207900
2,100163715,558330,AFF3,32,,100722045
15,31293263,160213,TRPM1,32,,31453476
16,56700646,1331,MT1G,32,,56701977
17,40687950,8516,NAGLU,32,,40696466
9,32553523,19659,NDUFB6,32,,32573182
4,164264998,8088,NPY5R,32,,164273086
9,131218284,45287,ODF2,32,,131263571
6,49753363,1690,PGK2,32,,49755053
19,35629896,4063,FXYD1,32,,35633959
3,126707436,48799,PLXNA1,32,,126756235
3,135684514,182238,PPP2R3A,32,,135866752
11,82533982,77663,PRCP,32,,82611645
7,157331745,1048749,PTPRN2,32,,158380494
12,71031852,150858,PTPRR,32,,71182710
7,44915891,9093,PURB,32,,44924984
22,37196744,18773,PVALB,32,,37215517
10,121259338,42884,RGS10,32,,121302222
19,8386383,897,RPS28,32,,8387280
17,10583648,17237,SCO1,32,,10600885
11,626315,925,SCT,32,,627240
20,43850009,3090,SEMG2,32,,43853099
10,99526507,5249,SFRP5,32,,99531756
8,121547984,276325,SNTB1,32,,121824309
1,109289284,62864,STXBP3,32,,109352148
9,136228324,16496,SURF4,32,,136244820
X,38420730,127442,TSPAN7,32,,38548172
11,1940798,19138,TNNT3,32,,1959936
2,218664511,144285,TNS1,32,,218808796
3,155860750,396177,KCNAB1,32,,156256927
6,33168602,3612,SLC39A7,32,,33172214
6,41651715,52282,TFEB,32,,41703997
6,27840925,364,HIST1H4L,32,,27841289
6,30620895,19935,DHX16,32,,30640830
1,227177565,328261,CDC42BPA,32,,227505826
10,15555947,206387,ITGA8,32,,15762334
17,54911459,34577,DGKE,32,,54946036
16,89753075,9697,CDK10,32,,89762772
20,49551391,23710,DPM1,32,,49575101
7,90032647,12621,CLDN12,32,,90045268
17,5031686,46640,USP6,32,,5078326
10,96997324,53581,PDLIM1,32,,97050905
7,128502856,3047,ATP6V1F,32,,128505903
14,92432334,74069,TRIP11,32,,92506403
20,30865453,57358,KIF3B,32,,30922811
14,32798478,503790,AKAP6,32,,33302268
9,117349993,11159,ATP6V1G1,32,,117361152
X,102930425,11321,MORF4L2,32,,102941746
11,46638825,58743,ATG13,32,,46697568
5,108670409,75266,PJA2,32,,108745675
6,110012423,134211,FIG4,32,,110146634
8,126036502,67559,KIAA0196,32,,126104061
3,12938541,176076,IQSEC1,32,,13114617
20,44470359,15689,ACOT8,32,,44486048
17,42875815,32364,GJC1,32,,42908179
5,137514416,8988,KIF20A,32,,137523404
13,48985181,15862,LPAR6,32,,49001043
8,22423178,9830,SORBS3,32,,22433008
7,106848297,356662,COG5,32,,107204959
19,16628699,24564,CHERP,32,,16653263
10,3179918,35115,PITRM1,32,,3215033
4,25657434,22934,SLC34A2,32,,25680368
18,3247527,8708,MYL12A,32,,3256235
11,118272103,8459,ATP5L,32,,118280562
5,175298500,12523,CPLX2,32,,175311023
20,43570770,18344,TOMM34,32,,43589114
X,28605680,1368337,IL1RAPL1,32,,29974017
3,120113060,56858,FSTL1,32,,120169918
13,37574677,9074,EXOSC8,32,,37583751
3,138067507,56870,MRAS,32,,138124377
10,105156411,49608,PDCD11,32,,105206019
14,59655380,182743,DAAM1,32,,59838123
3,45017740,35222,EXOSC7,32,,45052962
6,43149921,42404,CUL9,32,,43192325
1,151375199,56742,POGZ,32,,151431941
9,470293,275813,KANK1,32,,746106
11,134022336,72090,NCAPD3,32,,134094426
16,84599203,52499,COTL1,32,,84651702
1,63906440,82504,ITGB3BP,32,,63988944
3,72423743,72031,RYBP,32,,72495774
12,123413538,37518,ABCB9,32,,123451056
8,22224761,55488,SLC39A14,32,,22280249
17,73841779,9722,WBP2,32,,73851501
19,18417039,16962,LSM4,32,,18434001
19,51559462,8905,KLK13,32,,51568367
15,91541645,24206,VPS33B,32,,91565851
20,17922239,27395,SNX5,32,,17949634
X,91090459,787769,PCDH11X,32,,91878228
9,130493802,3826,TOR2A,32,,130497628
17,73663195,40947,SAP30BP,32,,73704142
6,16129316,19162,MYLIP,32,,16148478
19,40093168,4946,LGALS13,32,,40098114
2,27651418,13706,NRBP1,32,,27665124
17,3566186,5787,TAX1BP3,32,,3571973
10,99195665,10109,EXOSC1,32,,99205774
3,43732374,31843,ABHD5,32,,43764217
14,68143518,18992,RDH11,32,,68162510
12,10145661,6238,CLEC1B,32,,10151899
X,141290127,2949,MAGEC2,32,,141293076
1,29063451,32836,YTHDF2,32,,29096287
3,48725435,29276,IP6K2,32,,48754711
17,4067111,100031,ANKFY1,32,,4167142
9,91620685,172997,SHC3,32,,91793682
2,219687105,9407,PRKAG3,32,,219696512
4,110736665,9228,GAR1,32,,110745893
1,165693527,44632,TMCO1,32,,165738159
7,29035246,150907,CPVL,32,,29186153
11,124754113,13718,ROBO4,32,,124767831
10,104678074,160270,CNNM2,32,,104838344
15,65734800,75251,DPP8,32,,65810051
18,12991360,133691,CEP192,32,,13125051
7,127950435,33527,RBM28,32,,127983962
17,7589388,17432,WRAP53,32,,7606820
15,41028081,19453,RMDN3,32,,41047534
20,33890368,109577,UQCC1,32,,33999945
15,75931425,1239,IMP3,32,,75932664
7,21940516,45026,CDCA7L,32,,21985542
5,150070351,10318,RBM22,32,,150080669
7,100026412,5337,MEPCE,32,,100031749
19,10216898,5781,PPAN,32,,10222679
3,182733005,84370,MCCC1,32,,182817375
1,149912228,70458,OTUD7B,32,,149982686
21,33043312,61119,SCAF4,32,,33104431
6,105175967,131827,HACE1,32,,105307794
14,51100297,34774,SAV1,32,,51135071
14,33408458,864924,NPAS3,32,,34273382
7,156473569,212333,LMBR1,32,,156685902
3,112251353,29457,ATG3,32,,112280810
22,47080306,53846,CERK,32,,47134152
X,54219255,165183,WNK3,32,,54384438
17,79935425,39857,ASPSCR1,32,,79975282
1,20825940,8734,MUL1,32,,20834674
4,185615218,40068,CENPU,32,,185655286
7,87905743,30485,STEAP4,32,,87936228
10,121588915,43480,MCMBP,32,,121632395
4,17616250,11001,MED28,32,,17627251
16,81528953,216414,CMIP,32,,81745367
17,1549444,3948,RILP,32,,1553392
19,48949029,8135,GRWD1,32,,48957164
12,109886459,28890,KCTD10,32,,109915349
2,242641433,27464,ING5,32,,242668897
20,5931297,44555,MCM8,32,,5975852
2,32248960,15944,DPY30,32,,32264904
3,97660660,30635,MINA,32,,97691295
17,38632079,25775,TNS4,32,,38657854
16,718082,6092,RHOT2,32,,724174
1,28562601,2015,ATPIF1,32,,28564616
10,88414313,11903,OPN4,32,,88426216
8,95938199,23416,TP53INP1,32,,95961615
17,43189007,20893,PLCD3,32,,43209900
13,84451339,5189,SLITRK1,32,,84456528
19,36245466,2464,HSPB6,32,,36247930
11,57471180,8615,MED19,32,,57479795
9,116029289,8580,CDC26,32,,116037869
3,141043054,125578,ZBTB38,32,,141168632
1,226418849,78355,LIN9,32,,226497204
12,123185839,2065,HCAR2,32,,123187904
19,1383882,11706,NDUFS7,32,,1395588
17,46657199,110,MIR10A,32,,46657309
9,127454720,110,MIR181A2,32,,127454830
9,97847726,97,MIR27B,32,,97847823
7,130562217,81,MIR29B1,32,,130562298
11,71950120,5100,PHOX2A,31,,71955220
13,25254548,31375,ATP12A,31,,25285923
X,152801579,46808,ATP2B3,31,,152848387
19,49298318,16002,BCAT2,31,,49314320
6,80816326,239661,BCKDHB,31,,81055987
4,81952118,26661,BMP3,31,,81978779
6,55618450,121938,BMP5,31,,55740388
21,46269499,24319,PTTG1IP,31,,46293818
19,33865429,8163,CEBPG,31,,33873592
3,99357439,158138,COL8A1,31,,99515577
16,21269838,44619,CRYM,31,,21314457
9,99791958,9967,CTSV,31,,99801925
12,31226778,30947,DDX11,31,,31257725
10,70173820,57910,DNA2,31,,70231730
1,33789223,26276,PHC2,31,,33815499
1,155036212,5817,EFNA4,31,,155042029
16,10622278,52295,EMP2,31,,10674573
8,21915374,24664,DMTN,31,,21940038
19,51848408,9688,ETFB,31,,51858096
4,159593252,36613,ETFDH,31,,159629865
11,110300660,34948,FDX1,31,,110335608
2,24272570,13980,FKBP1B,31,,24286550
4,190861973,22386,FRG1,31,,190884359
15,27216428,510051,GABRG3,31,,27726479
19,35940616,2053,FFAR2,31,,35942669
6,42123114,24707,GUCA1A,31,,42147821
16,1859103,18092,HAGH,31,,1877195
17,53342320,60106,HLF,31,,53402426
X,150151747,7501,HMGB3,31,,150159248
12,54332575,7753,HOXC13,31,,54340328
2,10470288,97455,HPCAL1,31,,10567743
10,91061705,7328,IFIT2,31,,91069033
4,1813205,44769,LETM1,31,,1857974
16,56716381,1727,MT1X,31,,56718108
21,42733949,46920,MX2,31,,42780869
15,59428167,236904,MYO1E,31,,59665071
1,202317829,89541,PPP1R12B,31,,202407370
22,42454337,12509,NAGA,31,,42466846
9,124906337,15761,NDUFA8,31,,124922098
7,44646120,70075,OGDH,31,,44716195
11,57105840,31709,P2RX3,31,,57137549
1,186412697,17543,PDC,31,,186430240
11,72287183,66321,PDE2A,31,,72353504
6,83874592,29063,PGM3,31,,83903655
11,64692142,9808,PPP2R5B,31,,64701950
X,12809473,32873,PRPS2,31,,12842346
19,43370612,13259,PSG1,31,,43383871
21,45527207,23856,PWP2,31,,45551063
18,52495707,67040,RAB27B,31,,52562747
17,79670399,4157,MRPL12,31,,79674556
14,50043389,9745,RPS29,31,,50053134
1,1215815,11594,SCNN1D,31,,1227409
19,8117645,9902,CCL25,31,,8127547
17,78183078,11121,SGSH,31,,78194199
3,164696685,99598,SI,31,,164796283
19,50922194,12115,SPIB,31,,50934309
5,76986994,85191,TBCA,31,,77072185
11,2949502,1148,PHLDA2,31,,2950650
5,159436106,56446,TTC1,31,,159492552
2,64068097,50599,UGP2,31,,64118696
8,121137346,248468,COL14A1,31,,121385814
11,75897369,20205,WNT11,31,,75917574
1,113009162,54748,WNT2B,31,,113063910
10,111624523,58788,XPNPEP1,31,,111683311
3,50304989,9613,SEMA3B,31,,50314602
7,1570367,12312,MAFK,31,,1582679
16,81348570,65233,GAN,31,,81413803
3,27757439,6767,EOMES,31,,27764206
20,3451664,145027,ATRN,31,,3596691
1,117602948,42543,TTF2,31,,117645491
5,76506705,217375,PDE8B,31,,76724080
17,46210801,296793,SKAP1,31,,46507594
4,96083655,386706,UNC5C,31,,96470361
1,160510883,38423,CD84,31,,160549306
20,34213952,38926,CPNE1,31,,34252878
8,145699114,2604,FOXH1,31,,145701718
7,26706680,197682,SKAP2,31,,26904362
5,131528303,34632,P4HA2,31,,131562935
12,13043955,22646,GPRC5A,31,,13066601
10,89419475,87987,PAPSS2,31,,89507462
16,3022791,7749,PKMYT1,31,,3030540
17,26873724,5922,UNC119,31,,26879646
8,95892452,15030,CCNE2,31,,95907482
11,20620945,55665,SLC6A5,31,,20676610
7,150745378,4465,ASIC3,31,,150749843
8,38034105,36714,BAG4,31,,38070819
2,109065576,60278,GCC2,31,,109125854
2,46926098,63829,SOCS5,31,,46989927
2,201676268,12301,BZW1,31,,201688569
3,5229358,32292,EDEM1,31,,5261650
5,79703831,71857,ZFYVE16,31,,79775688
1,203764664,58592,ZC3H11A,31,,203823256
5,134094423,72403,DDX46,31,,134166826
2,37428774,29966,CEBPZ,31,,37458740
5,10353750,86750,6-Mar,31,,10440500
21,40984866,49950,B3GALT5,31,,41034816
19,3572942,6139,HMG20B,31,,3579081
1,43124047,18382,PPIH,31,,43142429
6,32135982,7934,AGPAT1,31,,32143916
21,30396937,29870,USP16,31,,30426807
X,129040096,23642,UTP14A,31,,129063738
6,31430956,2630,HCP5,31,,31433586
1,117910084,158236,MAN1A2,31,,118068320
6,149916010,53930,KATNA1,31,,149969940
10,88428425,67399,LDB3,31,,88495824
11,394182,10726,PKP3,31,,404908
13,74260148,447918,KLF12,31,,74708066
1,15764937,8216,CTRC,31,,15773153
3,52262625,10558,TWF2,31,,52273183
8,123793900,192855,ZHX2,31,,123986755
3,42132745,134637,TRAK1,31,,42267382
2,27886337,31510,SLC4A1AP,31,,27917847
22,43562627,20510,TTLL12,31,,43583137
2,242045513,43406,PASK,31,,242088919
11,111473114,124527,SIK2,31,,111597641
1,6845383,86724,CAMTA1,31,,6932107
9,95473644,53439,BICD2,31,,95527083
11,116714117,255014,SIK3,31,,116969131
9,131709971,59404,NUP188,31,,131769375
5,43602790,102878,NNT,31,,43705668
21,37832919,115948,CLDN14,31,,37948867
22,39052657,17198,CBY1,31,,39069855
2,37571752,28713,QPCT,31,,37600465
14,31569320,107409,HECTD1,31,,31676729
1,212113740,95262,INTS7,31,,212209002
20,42143075,27460,L3MBTL1,31,,42170535
18,42260137,197242,SETBP1,31,,42457379
1,153606457,12325,CHTOP,31,,153618782
20,33590206,90412,TRPC4AP,31,,33680618
4,15606006,51029,FBXL5,31,,15657035
1,111833473,29715,CHIA,31,,111863188
1,153931574,4270,SLC39A1,31,,153935844
6,47199262,78421,TNFRSF21,31,,47277683
1,145610989,78016,RNF115,31,,145689005
12,101673904,106493,UTP20,31,,101780397
X,119759528,4477,C1GALT1C1,31,,119764005
11,47199072,8938,PACSIN3,31,,47208010
15,52121824,82507,TMOD3,31,,52204331
19,47222767,26953,STRN4,31,,47249720
19,14843508,44231,EMR2,31,,14887739
22,31530792,5801,PLA2G3,31,,31536593
3,56761445,351891,ARHGEF3,31,,57113336
17,73257748,4709,MRPS7,31,,73262457
1,19578074,8548,MRTO4,31,,19586622
3,137717657,34837,CLDN18,31,,137752494
12,110288747,29546,GLTP,31,,110318293
9,34179002,73519,UBAP1,31,,34252521
5,176938577,5750,DDX41,31,,176944327
2,231578262,107528,CAB39,31,,231685790
1,47799468,45043,CMPK1,31,,47844511
15,83685180,50926,BTBD1,31,,83736106
20,4129425,38969,SMOX,31,,4168394
8,145133521,2030,EXOSC4,31,,145135551
7,44605015,9122,DDX56,31,,44614137
15,41271078,137366,INO80,31,,41408444
19,19496641,123100,GATAD2A,31,,19619741
1,173793796,33886,DARS2,31,,173827682
2,234745346,17866,HJURP,31,,234763212
6,25279655,341103,LRRC16A,31,,25620758
12,106751859,152117,POLR3B,31,,106903976
5,43379295,33198,CCL28,31,,43412493
22,39077953,2813,TOMM22,31,,39080766
Y,26979966,73221,DAZ4,31,,27053187
20,9518036,301651,PAK7,31,,9819687
2,64319785,51820,PELI1,31,,64371605
1,26126666,18047,SEPN1,31,,26144713
16,87636492,1762,JPH3,31,,87638254
X,99546641,118630,PCDH19,31,,99665271
17,27582853,38313,NUFIP2,31,,27621166
11,113668596,77696,USP28,31,,113746292
19,40899670,19601,PRX,31,,40919271
19,45754515,54026,MARK4,31,,45808541
19,15532317,28445,WIZ,31,,15560762
3,9908393,13545,CIDEC,31,,9921938
X,53111541,6187,TSPYL2,31,,53117728
1,37955560,24860,MEAF6,31,,37980420
6,34555056,109571,C6orf106,31,,34664627
6,96025372,31956,MANEA,31,,96057328
8,104152920,89613,BAALC,31,,104242533
1,9352940,76650,SPSB1,31,,9429590
2,219745254,13397,WNT10A,31,,219758651
17,40714091,4208,COASY,31,,40718299
15,78575577,16491,WDR61,31,,78592068
17,57784825,134791,VMP1,31,,57919616
11,28042162,87584,KIF18A,31,,28129746
22,30687978,34977,TBC1D10A,31,,30722955
X,77081861,69204,MAGT1,31,,77151065
5,156346292,43974,TIMD4,31,,156390266
1,43849578,5905,MED8,31,,43855483
7,73097897,14654,WBSCR22,31,,73112551
3,125247701,66680,OSBPL11,31,,125314381
6,159455500,7885,TAGAP,31,,159463385
7,135611502,50702,MTPN,31,,135662204
12,56546203,5568,MYL6B,31,,56551771
20,627267,6747,SRXN1,31,,634014
15,43036541,176466,TTBK2,31,,43213007
8,100025493,196522,VPS13B,31,,100222015
5,150827156,44786,SLC36A1,31,,150871942
2,3592481,13480,RNASEH1,31,,3605961
3,4402828,106138,SUMF1,31,,4508966
5,45255051,441169,HCN1,31,,45696220
1,222791443,49911,MIA3,31,,222841354
8,144510229,2373,MAFA,31,,144512602
17,1953201,101,MIR132,31,,1953302
11,64658608,110,MIR192,31,,64658718
X,151127049,81,MIR224,31,,151127130
9,86584662,110,MIR7-1,31,,86584772
15,43984983,6437,CKMT1A,31,,43991420
X,52541053,5144,XAGE1E,31,,52546197
X,74273006,103169,ABCB7,30,,74376175
16,25228284,11969,AQP8,30,,25240253
5,64885506,34681,TRIM23,30,,64920187
X,153172829,18885,ARHGAP4,30,,153191714
14,32546494,82440,ARHGAP5,30,,32628934
11,117690789,4670,FXYD2,30,,117695459
4,666224,1903,ATP5I,30,,668127
6,31512227,2398,ATP6V1G2,30,,31514625
12,32260184,270957,BICD1,30,,32531141
17,43299291,25392,FMNL1,30,,43324683
4,78078356,12857,CCNG2,30,,78091213
15,34261088,96199,CHRM5,30,,34357287
19,36605887,10962,TBCB,30,,36616849
19,40221892,6777,CLC,30,,40228669
7,14184673,696402,DGKB,30,,14881075
21,41384342,834697,DSCAM,30,,42219039
7,64450732,16392,ERV3-1,30,,64467124
3,191857181,588207,FGF12,30,,192445388
6,1624034,552191,GMDS,30,,2176225
17,40831419,2426,CCR10,30,,40833845
4,156587861,70353,GUCY1A3,30,,156658214
3,148709194,36262,GYG1,30,,148745456
6,26199011,510,HIST1H2AD,30,,26199521
6,12012723,152509,HIVEP1,30,,12165232
12,54410635,39179,HOXC4,30,,54449814
2,176987412,2233,HOXD9,30,,176989645
21,48055506,29530,PRMT2,30,,48085036
20,2639660,5209,IDH3B,30,,2644869
6,15249085,273188,JARID2,30,,15522273
11,18433852,38941,LDHC,30,,18472793
16,56659584,1440,MT1E,30,,56661024
17,30819539,384652,MYO1D,30,,31204191
8,125551342,10885,NDUFB9,30,,125562227
19,13135394,74216,NFIX,30,,13209610
12,113376237,34818,OAS3,30,,113411055
7,100199881,5917,PCOLCE,30,,100205798
1,205473683,28238,CDK18,30,,205501921
3,195964615,50008,PCYT1A,30,,196014623
2,46808412,35839,PIGF,30,,46844251
9,112137973,122620,PTPN3,30,,112260593
1,52373627,82809,RAB3B,30,,52456436
11,18252901,5483,SAA4,30,,18258384
9,37915894,153316,SHB,30,,38069210
1,9101426,28461,SLC2A5,30,,9129887
14,70510933,36001,SLC8A3,30,,70546934
8,42273979,84999,SLC20A2,30,,42358978
17,61909440,10911,SMARCD2,30,,61920351
12,6571403,8662,VAMP1,30,,6580065
1,109606997,11627,TAF13,30,,109618624
6,108489226,20787,NR2E1,30,,108510013
8,110099652,32160,TRHR,30,,110131812
8,15397595,226563,TUSC3,30,,15624158
12,26348268,39440,SSPN,30,,26387708
19,496489,8854,MADCAM1,30,,505343
22,32908539,545838,SYN3,30,,33454377
8,104310660,34434,FZD6,30,,104345094
6,27860476,487,HIST1H2AM,30,,27860963
6,27798951,354,HIST1H4K,30,,27799305
4,88394481,56174,SPARCL1,30,,88450655
19,5916151,62169,RANBP3,30,,5978320
17,9813925,115698,GAS7,30,,9929623
5,54720669,110237,PPAP2A,30,,54830906
1,167510250,12806,CREG1,30,,167523056
6,133001996,33198,VNN1,30,,133035194
3,49591921,117061,BSN,30,,49708982
15,45544427,23705,SLC28A2,30,,45568132
2,238536223,154067,LRRFIP1,30,,238690290
2,96931883,8017,CIAO1,30,,96939900
9,134735496,219778,MED27,30,,134955274
6,46620651,25276,SLC25A27,30,,46645927
17,7486964,4563,MPDU1,30,,7491527
17,28804425,49407,GOSR1,30,,28853832
X,101906293,7717,GPRASP1,30,,101914010
6,4115926,19776,ECI2,30,,4135702
17,73034954,8120,ATP5H,30,,73043074
14,68117866,23736,VTI1B,30,,68141602
17,41166621,7838,VAT1,30,,41174459
11,65686727,2321,DRAP1,30,,65689048
7,76822687,6463,FGL2,30,,76829150
22,38092994,79569,TRIOBP,30,,38172563
7,23221445,19185,NUPL2,30,,23240630
20,40701391,1117166,PTPRT,30,,41818557
X,152710177,1768,TREX2,30,,152711945
6,108188959,90523,SEC63,30,,108279482
16,70333061,34674,DDX19B,30,,70367735
5,443333,24076,EXOC3,30,,467409
12,76419226,6330,PHLDA1,30,,76425556
1,107682539,344982,NTNG1,30,,108027521
5,142150291,458281,ARHGAP26,30,,142608572
5,132086508,26559,8-Sep,30,,132113067
6,90352493,177020,MDN1,30,,90529513
16,18802988,10012,ARL6IP1,30,,18813000
13,113623534,130519,MCF2L,30,,113754053
20,49505454,42073,ADNP,30,,49547527
9,108006893,152735,SLC44A1,30,,108159628
22,51039113,10866,MAPK8IP2,30,,51049979
15,43477465,11910,CCNDBP1,30,,43489375
19,45281125,22778,CBLC,30,,45303903
5,80708625,338447,SSBP2,30,,81047072
22,50713407,32594,PLXNB2,30,,50746001
10,28966423,5445,BAMBI,30,,28971868
1,45965855,10884,MMACHC,30,,45976739
3,196080368,78977,UBXN7,30,,196159345
5,41925355,16317,FBXO4,30,,41941672
13,36050885,195989,NBEA,30,,36246874
8,38020838,13410,LSM1,30,,38034248
4,95219706,44321,HPGDS,30,,95264027
7,44111660,10479,POLM,30,,44122139
8,124332090,76615,ATAD2,30,,124408705
1,11333254,15237,UBIAD1,30,,11348491
1,150122091,10169,PLEKHO1,30,,150132260
5,61714710,209706,IPO11,30,,61924416
20,34359922,178366,PHF20,30,,34538288
5,138678122,27287,PAIP2,30,,138705409
3,48711271,12095,NCKIPSD,30,,48723366
7,129658125,33166,ZC3HC1,30,,129691291
12,42719946,122476,PPHLN1,30,,42842422
12,110929327,10618,VPS29,30,,110939945
12,14939411,16990,WBP11,30,,14956401
2,140988995,1900275,LRP1B,30,,142889270
16,81272295,52452,BCO1,30,,81324747
19,50354376,9625,PTOV1,30,,50364001
22,43088120,28796,A4GALT,30,,43116916
1,150521844,11568,ADAMTSL4,30,,150533412
X,117480035,103888,WDR44,30,,117583923
3,57124009,75418,IL17RD,30,,57199427
15,70946892,47728,UACA,30,,70994620
10,30598729,39538,MTPAP,30,,30638267
19,17830260,15064,MAP1S,30,,17845324
3,5163929,58672,ARL8B,30,,5222601
4,40337345,19889,CHRNA9,30,,40357234
X,48779302,35591,OTUD5,30,,48814893
13,113831852,31382,PCID2,30,,113863234
4,88742549,25419,MEPE,30,,88767968
3,156865344,13205,CCNL1,30,,156878549
1,153586731,2077,S100A14,30,,153588808
12,54104902,16405,CALCOCO1,30,,54121307
21,27011593,75292,JAM2,30,,27086885
14,35030617,68749,SNX6,30,,35099366
11,207510,7665,RIC8A,30,,215175
6,138409641,19019,PERP,30,,138428660
15,74471807,29564,STRA6,30,,74501371
3,101546833,33036,NFKBIZ,30,,101579869
8,120885894,177263,DEPTOR,30,,121063157
X,48367346,11856,PORCN,30,,48379202
16,58497993,49530,NDRG4,30,,58547523
3,48663155,8124,SLC26A6,30,,48671279
1,153700542,46742,INTS3,30,,153747284
10,70661033,45570,DDX50,30,,70706603
12,48055714,44130,RPAP3,30,,48099844
2,17845078,90018,SMC6,30,,17935096
1,38000049,19896,SNIP1,30,,38019945
3,13521843,26081,HDAC11,30,,13547924
5,1461537,62555,LPCAT1,30,,1524092
1,37940118,9860,ZC3H12A,30,,37949978
3,52288437,24222,WDR82,30,,52312659
19,4445002,10293,UBXN6,30,,4455295
1,205271190,19729,NUAK2,30,,205290919
11,9800213,515541,SBF2,30,,10315754
Y,4868266,105373,PCDH11Y,30,,4973639
10,105062552,48339,PCGF6,30,,105110891
4,123091757,192157,KIAA1109,30,,123283914
10,100007442,20565,LOXL4,30,,100028007
17,40925453,6165,VPS25,30,,40931618
12,56151053,60487,SARNP,30,,56211540
20,49348080,22198,PARD6B,30,,49370278
12,121866899,151465,KDM2B,30,,122018364
6,127440047,80579,RSPO3,30,,127520626
19,54296854,30803,NLRP12,30,,54327657
6,52285804,74779,EFHC1,30,,52360583
10,108333420,591046,SORCS1,30,,108924466
11,119209643,1950,C1QTNF5,30,,119211593
1,85109389,46851,SSX2IP,30,,85156240
15,72406598,26713,SENP8,30,,72433311
1,202559724,52857,SYT2,30,,202612581
20,61038552,12474,GATA5,30,,61051026
17,74864797,81674,MGAT5B,30,,74946471
13,42614171,202862,DGKH,30,,42817033
12,45609769,216365,ANO6,30,,45826134
11,62480096,14761,HNRNPUL2,30,,62494857
6,12716887,571188,PHACTR1,30,,13288075
X,133304227,81,MIR106A,30,,133304308
22,20020661,82,MIR185,30,,20020743
17,46709851,70,MIR196A1,30,,46709921
13,92003144,82,MIR19A,30,,92003226
9,97847489,97,MIR23B,30,,97847586
7,130135951,94,MIR335,30,,130136045
4,103790134,23829,CISD2,30,,103813963
19,19256375,24723,MEF2B,30,,19281098
11,104756444,12953,CASP12,30,,104769397
3,49454210,5901,AMT,29,,49460111
7,134331530,33037,BPGM,29,,134364567
3,48894355,42071,SLC25A20,29,,48936426
5,134074169,13681,CAMLG,29,,134087850
19,42300521,15070,CEACAM3,29,,42315591
22,51017386,4042,CHKB,29,,51021428
1,11866152,37049,CLCN6,29,,11903201
19,45458249,38355,CLPTM1,29,,45496604
1,95362504,30275,CNN3,29,,95392779
2,98262520,2137,COX5B,29,,98264657
19,36139124,10562,COX6B1,29,,36149686
1,75171171,27921,CRYZ,29,,75199092
17,17991180,20119,DRG2,29,,18011299
19,39306061,16436,ECH1,29,,39322497
12,9067315,26745,PHC1,29,,9094060
19,1286152,15277,EFNA2,29,,1301429
17,7608519,6174,EFNB3,29,,7614693
1,150594598,7500,ENSA,29,,150602098
1,22889994,26118,EPHA8,29,,22916112
X,14861528,29663,FANCB,29,,14891191
19,5830636,9106,FUT6,29,,5839742
16,20320895,18047,GP2,29,,20338942
15,53049159,33050,ONECUT1,29,,53082209
17,46620018,2375,HOXB2,29,,46622393
12,54422193,2414,HOXC6,29,,54424607
12,54402889,3656,HOXC8,29,,54406545
12,57828467,17378,INHBC,29,,57845845
1,233749749,58509,KCNK1,29,,233808258
12,52840434,5476,KRT6B,29,,52845910
12,6881669,5952,LAG3,29,,6887621
11,65306029,19670,LTBP3,29,,65325699
7,15650836,75472,MEOX2,29,,15726308
5,180217540,19597,MGAT1,29,,180237137
1,165600109,25263,MGST3,29,,165625372
22,28144264,53222,MN1,29,,28197486
15,75182351,9447,MPI,29,,75191798
10,102283485,6195,NDUFB8,29,,102289680
11,77779392,11873,NDUFC2,29,,77791265
12,70636809,111964,CNOT2,29,,70748773
14,24549315,4517,NRL,29,,24553832
5,41730166,140625,OXCT1,29,,41870791
X,82763268,1507,POU3F4,29,,82764775
1,202116140,14576,PTPN7,29,,202130716
X,153200721,9511,RENBP,29,,153210232
X,100645877,2963,RPL36A,29,,100648840
16,66955581,3858,RRAD,29,,66959439
16,20775311,33168,ACSM3,29,,20808479
13,70681344,32541,ATXN8OS,29,,70713885
17,34310691,3073,CCL14,29,,34313764
7,150936058,9691,SMARCD3,29,,150945749
20,3667616,20159,SIGLEC1,29,,3687775
4,70861647,6526,STATH,29,,70868173
2,108905094,21277,SULT1C2,29,,108926371
6,134210259,3134,TCF21,29,,134213393
4,156824844,16714,TDO2,29,,156841558
3,169684579,31582,SEC62,29,,169716161
3,45067758,9805,CLEC3B,29,,45077563
3,147127180,7326,ZIC1,29,,147134506
X,136648345,5914,ZIC3,29,,136654259
2,1635658,112661,PXDN,29,,1748319
3,51422667,4161,MANF,29,,51426828
7,144052488,25237,ARHGEF5,29,,144077725
9,136895445,37696,BRD3,29,,136933141
Y,14813159,159609,USP9Y,29,,14972768
6,26197011,2510,HIST1H3D,29,,26199521
5,73923230,14019,ENC1,29,,73937249
2,234296799,83944,DGKD,29,,234380743
6,89319615,353733,RNGTT,29,,89673348
17,63133455,90366,RGS9,29,,63223821
14,99947738,30114,CCNK,29,,99977852
2,86066271,28522,ST3GAL5,29,,86094793
15,63900816,225331,HERC1,29,,64126147
3,45636322,86433,LIMD1,29,,45722755
16,84211452,9224,TAF1C,29,,84220676
10,102047902,42341,PKD2L1,29,,102090243
14,23242431,42676,SLC7A7,29,,23285107
3,51967441,8516,RRP9,29,,51975957
12,46312913,71488,SCAF11,29,,46384401
12,59989820,193815,SLC16A7,29,,60183635
6,32121775,9683,PPT2,29,,32131458
1,87328127,51980,15-Sep,29,,87380107
6,97010400,56100,FHL5,29,,97066500
1,44412477,21217,IPO13,29,,44433694
8,104512975,753681,RIMS2,29,,105266656
16,88781745,69883,PIEZO1,29,,88851628
1,29563027,90298,PTPRU,29,,29653325
19,4229539,7985,EBI3,29,,4237524
10,74127083,258866,MICU1,29,,74385949
20,35169886,8340,MYL9,29,,35178226
X,135067585,61843,SLC9A6,29,,135129428
11,644219,51535,DEAF1,29,,695754
5,159828647,17521,SLU7,29,,159846168
16,2022063,6688,TBL3,29,,2028751
2,85545140,10279,TGOLN2,29,,85555419
7,44240577,13316,YKT6,29,,44253893
14,96968712,33223,PAPOLA,29,,97001935
1,92711954,52612,GLMN,29,,92764566
2,27851514,22199,GPN1,29,,27873713
1,6324331,129495,ACOT7,29,,6453826
2,69685126,185851,AAK1,29,,69870977
19,55741146,28892,PPP6R1,29,,55770038
11,117192493,91489,CEP164,29,,117283982
2,27193238,56849,MAPRE3,29,,27250087
12,27397077,81813,STK38L,29,,27478890
3,170776202,401995,TNIK,29,,171178197
5,71515235,100849,MRPS27,29,,71616084
4,62066973,877080,LPHN3,29,,62944053
3,132136552,121324,DNAJC13,29,,132257876
4,154074269,186205,TRIM2,29,,154260474
2,220426437,9831,OBSL1,29,,220436268
12,53442732,15430,TENC1,29,,53458162
12,65563350,78791,LEMD3,29,,65642141
19,40854331,30066,PLD3,29,,40884397
2,33701320,88478,RASGRP3,29,,33789798
2,198380766,37657,MOB4,29,,198418423
6,76311224,116777,SENP6,29,,76428001
17,26673653,10959,POLDIP2,29,,26684612
1,11708417,6471,FBXO2,29,,11714888
15,45879320,22594,BLOC1S6,29,,45901914
11,31531275,274798,ELP4,29,,31806073
8,74332603,326559,STAU2,29,,74659162
9,102861466,202991,INVS,29,,103064457
17,40811265,7759,TUBG2,29,,40819024
2,113763037,2584,IL36A,29,,113765621
15,43663256,36040,TUBGCP4,29,,43699296
13,58205788,97277,PCDH17,29,,58303065
3,126061477,14759,KLF15,29,,126076236
22,20119363,16167,ZDHHC8,29,,20135530
5,170736287,2851,TLX3,29,,170739138
19,48216600,29791,EHD2,29,,48246391
X,153880245,1608,CTAG2,29,,153881853
17,4736634,64722,MINK1,29,,4801356
13,50069745,33382,PHF11,29,,50103127
3,32567462,44904,DYNC1LI1,29,,32612366
11,202923,4499,BET1L,29,,207422
13,38923907,13237,UFM1,29,,38937144
7,916190,19881,GET4,29,,936071
7,117824085,20008,LSM8,29,,117844093
6,57051790,35322,RAB23,29,,57087112
1,1246964,13103,CPSF3L,29,,1260067
1,157963062,106990,KIRREL,29,,158070052
9,125883907,146948,STRBP,29,,126030855
3,183547172,55524,PARL,29,,183602696
10,71812356,59684,H2AFY2,29,,71872040
19,1985446,30256,BTBD2,29,,2015702
12,14927269,3667,H2AFJ,29,,14930936
11,117947726,42830,TMPRSS4,29,,117990556
2,128848753,104496,UGGT1,29,,128953249
20,56223447,42233,PMEPA1,29,,56265680
Y,25365580,71923,DAZ3,29,,25437503
1,156338979,16034,RHBG,29,,156355013
9,126141932,550485,DENND1A,29,,126692417
2,32449517,40432,NLRC4,29,,32489949
6,53132195,81782,ELOVL5,29,,53213977
X,68380580,4785,PJA1,29,,68385365
2,238395861,68100,MLPH,29,,238463961
11,102980159,370432,DYNC2H1,29,,103350591
20,35380193,22037,DSN1,29,,35402230
10,105637317,40728,OBFC1,29,,105678045
19,46031024,57098,OPA3,29,,46088122
3,134204574,79296,CEP63,29,,134283870
4,20730238,969080,KCNIP4,29,,21699318
20,56178901,16731,ZBP1,29,,56195632
1,196946666,32137,CFHR5,29,,196978803
14,51706885,17487,TMX1,29,,51724372
4,86396283,527540,ARHGAP24,29,,86923823
22,41601312,25963,L3MBTL2,29,,41627275
8,102698769,437793,NCALD,29,,103136562
17,3763616,32721,CAMKK1,29,,3796337
10,102756822,10771,LZTS2,29,,102767593
11,75479777,32804,DGAT2,29,,75512581
14,23447820,4031,AJUBA,29,,23451851
20,30407177,15323,MYLK2,29,,30422500
1,110574198,23065,STRIP1,29,,110597263
12,109525992,5301,ALKBH2,29,,109531293
14,75894508,44896,JDP2,29,,75939404
17,56160779,6839,DYNLL2,29,,56167618
12,42852139,25277,PRICKLE1,29,,42877416
3,31573992,105122,STT3B,29,,31679114
1,114471995,42703,HIPK1,29,,114514698
19,39759156,1576,IFNL2,29,,39760732
8,144295067,3977,GPIHBP1,29,,144299044
6,150045451,22257,NUP43,29,,150067708
11,57408670,89,MIR130A,29,,57408759
7,99691182,84,MIR25,29,,99691266
22,50354142,3578,PIM3,29,,50357720
6,52013720,119,MIR133B,29,,52013839
10,104196268,73,MIR146B,29,,104196341
2,219128851,6081,AAMP,28,,219134932
17,906757,105583,ABR,28,,1012340
1,244571793,43643,ADSS,28,,244615436
17,7348405,12527,CHRNB1,28,,7360932
5,115177302,72476,AP3S1,28,,115249778
16,57988579,16441,CNGB1,28,,58005020
19,1026273,12794,CNN2,28,,1039067
6,32083044,12973,ATF6B,28,,32096017
22,24313553,3127,DDT,28,,24316680
16,89679715,25124,DPEP1,28,,89704839
1,155051347,8667,EFNA3,28,,155060014
9,23690102,131741,ELAVL2,28,,23821843
2,119599746,6013,EN1,28,,119605759
6,133562494,290764,EYA4,28,,133853258
17,72858618,10538,FDXR,28,,72869156
12,56110075,3416,BLOC1S1,28,,56113491
9,131266970,37610,GLE1,28,,131304580
1,110254863,6027,GSTM5,28,,110260890
4,156680124,48670,GUCY1B3,28,,156728794
17,46626231,25579,HOXB3,28,,46651810
18,11981426,49459,IMPA2,28,,12030885
1,38326368,86361,INPP5B,28,,38412729
2,27309610,14009,KHK,28,,27323619
1,165171103,154375,LMX1A,28,,165325478
15,44096732,20219,MFAP1,28,,44116951
6,33762448,9345,MLN,28,,33771793
5,52391508,14094,MOCS2,28,,52405602
8,57025500,1041,MOS,28,,57026541
1,155178489,5141,MTX1,28,,155183630
18,55267893,21284,NARS,28,,55289177
16,2009516,2460,NDUFB10,28,,2011976
9,33290414,80747,NFX1,28,,33371161
11,2923511,22965,SLC22A18,28,,2946476
9,125580375,10560,PDCL,28,,125590935
2,183032613,354959,PDE1A,28,,183387572
19,57321444,30650,PEG3,28,,57352094
17,1421282,44828,PITPNA,28,,1466110
13,79173229,4466,POU4F1,28,,79177695
2,242089072,33993,PPP1R7,28,,242123065
17,74306867,43363,PRPSAP1,28,,74350230
12,44187525,12653,TWF1,28,,44200178
5,80256507,269474,RASGRF2,28,,80525981
14,58765221,75230,ARID4A,28,,58840451
1,155867598,13595,RIT1,28,,155881193
9,35657747,268,RMRP,28,,35658015
9,77112251,189866,RORB,28,,77302117
17,34303528,5004,CCL16,28,,34308532
5,112196884,7205,SRP19,28,,112204089
10,70939959,28895,SUPV3L1,28,,70968854
9,136207750,7261,MED22,28,,136215011
17,40719077,6144,MLX,28,,40725221
6,116596021,5259,TSPYL1,28,,116601280
8,144694787,4945,TSTA3,28,,144699732
11,8060179,67475,TUB,28,,8127654
3,49842637,8754,UBA7,28,,49851391
X,24167840,66532,ZFX,28,,24234372
5,100142638,96351,ST8SIA4,28,,100238989
7,91502190,7844,MTERF1,28,,91510034
15,92937139,74819,ST8SIA2,28,,93011958
17,56270084,12451,EPX,28,,56282535
9,135854097,12987,GFI1B,28,,135867084
6,26184023,435,HIST1H2BE,28,,26184458
3,184097860,9763,CHRD,28,,184107623
18,61420280,52330,SERPINB7,28,,61472610
3,67410883,294155,SUCLG2,28,,67705038
2,84650646,35940,SUCLG1,28,,84686586
12,81186299,145395,LIN7A,28,,81331694
2,9346893,198919,ASAP2,28,,9545812
1,222731243,32032,TAF1A,28,,222763275
11,1411128,72791,BRSK2,28,,1483919
1,44398991,3921,ARTN,28,,44402912
Y,22737596,17444,EIF1AY,28,,22755040
13,25820340,41364,MTMR6,28,,25861704
9,37422706,14280,GRHPR,28,,37436986
5,153854531,3293,HAND1,28,,153857824
6,4836331,119447,CDYL,28,,4955778
15,83517728,103748,HOMER2,28,,83621476
14,72399754,633484,RGS6,28,,73033238
10,11502508,71771,USP6NL,28,,11574279
7,82993221,277526,SEMA3E,28,,83270747
10,43277953,52432,BMS1,28,,43330385
X,65384071,103159,HEPH,28,,65487230
1,183441505,81823,SMG7,28,,183523328
17,65066553,174766,HELZ,28,,65241319
10,81107219,7870,PPIF,28,,81115089
20,34236846,16032,RBM12,28,,34252878
13,41363546,23050,SLC25A15,28,,41386596
1,26503980,12395,CNKSR1,28,,26516375
6,123670619,287619,TRDN,28,,123958238
11,13984183,305496,SPON1,28,,14289679
8,54958926,55651,LYPLA1,28,,55014577
9,35161988,243344,UNC13B,28,,35405332
5,43526369,30826,PAIP1,28,,43557195
1,154897207,12277,PMVK,28,,154909484
9,140317846,11012,NOXA1,28,,140328858
7,99036562,18438,CPSF4,28,,99055000
12,112563348,28060,TRAFD1,28,,112591408
12,124069075,13613,TMED2,28,,124082688
15,50474392,54197,SLC27A2,28,,50528589
12,75874512,21204,GLIPR1,28,,75895716
17,60556385,136456,TLK2,28,,60692841
17,62473901,19283,POLG2,28,,62493184
X,65241579,18388,VSIG4,28,,65259967
1,183217371,170263,NMNAT2,28,,183387634
2,29117508,53578,WDR43,28,,29171086
9,139305024,13189,PMPCA,28,,139318213
3,15708743,130948,ANKRD28,28,,15839691
10,53455245,4110,CSTF2T,28,,53459355
1,52888947,129815,ZCCHC11,28,,53018762
2,97001478,41355,NCAPH,28,,97042833
16,14927642,62372,NOMO1,28,,14990014
1,22303386,12461,CELA3B,28,,22315847
3,110790605,65802,PVRL3,28,,110856407
5,34656595,176122,RAI14,28,,34832717
7,5229834,43652,WIPI2,28,,5273486
6,153332031,120358,RGS17,28,,153452389
19,51645557,11226,SIGLEC7,28,,51656783
4,107842958,114495,DKK2,28,,107957453
19,51628136,11384,SIGLEC9,28,,51639520
12,49250915,8738,RND1,28,,49259653
5,61684350,15378,DIMT1,28,,61699728
7,65579804,39749,CRCP,28,,65619553
13,42031541,13472,RGCC,28,,42045013
14,77741298,45927,POMT2,28,,77787225
19,12810007,24803,TNPO2,28,,12834810
1,160185504,46846,DCAF8,28,,160232350
10,14880158,8840,HSPA14,28,,14888998
4,89378267,49052,HERC5,28,,89427319
1,54665839,18217,MRPL37,28,,54684056
15,90014639,25205,RHCG,28,,90039844
20,44044706,10179,PIGT,28,,44054885
14,94400498,42578,ASB2,28,,94443076
11,124543739,20948,SPA17,28,,124564687
21,47269874,92494,PCBP3,28,,47362368
9,116169518,3511,POLE3,28,,116173029
5,177019148,5095,TMED9,28,,177024243
9,103064356,50497,TEX10,28,,103114853
11,11862969,117903,USP47,28,,11980872
11,71164216,48365,NADSYN1,28,,71212581
9,33041849,34865,SMU1,28,,33076714
10,73079009,44138,SLC29A3,28,,73123147
11,799178,6072,PIDD1,28,,805250
2,130908964,30366,SMPD4,28,,130939330
16,238967,40514,LUC7L,28,,279481
11,118938462,14226,VPS11,28,,118952688
1,167905796,139287,DCAF6,28,,168045083
15,91473409,23914,UNC45A,28,,91497323
2,69201704,6408,GKN1,28,,69208112
1,156005084,18532,UBQLN4,28,,156023616
4,95128995,83448,SMARCAD1,28,,95212443
12,27485786,92960,ARNTL2,28,,27578746
20,44169264,6801,EPPIN,28,,44176065
1,25943958,168740,MAN1C1,28,,26112698
8,143822361,1468,SLURP1,28,,143823829
1,228337414,10113,GJC2,28,,228347527
17,77768175,2740,CBX8,28,,77770915
16,14165169,195467,MKL2,28,,14360636
1,151483861,27306,CGN,28,,151511167
1,228870823,11593,RHOU,28,,228882416
19,9938555,2242,UBL5,28,,9940797
11,44282277,49439,ALX4,28,,44331716
17,39968961,10508,FKBP10,28,,39979469
1,246703862,25703,TFB2M,28,,246729565
16,3096681,14043,MMP25,28,,3110724
1,220960038,27703,1-Mar,28,,220987741
15,91073117,115460,CRTC3,28,,91188577
2,105654482,61936,MRPS9,28,,105716418
2,86441119,124087,REEP1,28,,86565206
17,46985730,20692,UBE2Z,28,,47006422
9,95947211,134444,WNK2,28,,96081655
2,220084101,10309,ATG9A,28,,220094410
17,40253421,11330,DHX58,28,,40264751
17,34105508,17203,MMP28,28,,34122711
17,78965640,8293,CHMP6,28,,78973933
8,8993763,15389,PPP1R3B,28,,9009152
12,76738265,3957,BBS10,28,,76742222
16,46614467,40844,SHCBP1,28,,46655311
4,129730777,65602,JADE1,28,,129796379
8,102504667,177285,GRHL2,28,,102681952
9,73398777,85197,TRPM3,28,,73483974
5,141488323,45685,NDFIP1,28,,141534008
12,1726221,30156,WNT5B,28,,1756377
12,46576840,86368,SLC38A1,28,,46663208
11,67758570,13025,UNC93B1,28,,67771595
1,116184573,56272,VANGL1,28,,116240845
7,38217807,52465,STARD3NL,28,,38270272
22,50683612,6222,HDAC10,28,,50689834
2,122484520,9983,NIFK,28,,122494503
10,69865873,105900,MYPN,28,,69971773
10,5931534,48024,FBXO18,28,,5979558
11,57067102,25311,TNKS1BP1,28,,57092413
6,43395291,22872,ABCC10,28,,43418163
1,177898241,40809,SEC16B,28,,177939050
12,18836109,54884,PLCZ1,28,,18890993
19,13064969,3099,GADD45GIP1,28,,13068068
12,50794591,79197,LARP4,28,,50873788
19,4537226,2810,LRG1,28,,4540036
16,2028917,2633,NOXO1,28,,2031550
11,16809206,226757,PLEKHA7,28,,17035963
5,68710938,26952,MARVELD2,28,,68737890
9,2717525,12512,KCNV2,28,,2730037
9,3824127,475908,GLIS3,28,,4300035
4,119809995,149680,SYNPO2,28,,119959675
11,124789145,17163,HEPACAM,28,,124806308
13,115079964,12839,CHAMP1,28,,115092803
7,80087950,53375,GNAT3,28,,80141325
10,92827,2351,TUBB8,28,,95178
2,182401400,120434,CERKL,28,,182521834
7,129414744,110,MIR183,28,,129414854
13,92003567,78,MIR92A1,28,,92003645
14,101495970,81,MIR494,28,,101496051
10,1223252,556418,ADARB2,27,,1779670
1,110162434,12243,AMPD2,27,,110174677
15,59951344,30389,BNIP2,27,,59981733
11,76777991,59207,CAPN5,27,,76837198
11,3022151,56530,CARS,27,,3078681
5,80529138,33079,CKMT2,27,,80562217
X,154505495,58495,CLIC2,27,,154563990
20,23728189,3385,CST1,27,,23731574
X,95939661,915936,DIAPH2,27,,96855597
16,30389453,4718,1-Sep,27,,30394171
2,172964165,3313,DLX2,27,,172967478
2,96808907,2272,DUSP2,27,,96811179
12,96588159,75454,ELK3,27,,96663613
5,159626047,39682,FABP6,27,,159665729
6,116262692,119229,FRK,27,,116381921
19,1397024,4545,GAMT,27,,1401569
8,21549529,96817,GFRA2,27,,21646346
7,93535819,4758,GNGT1,27,,93540577
2,157292899,150016,GPD2,27,,157442915
19,2037469,13774,MKNK2,27,,2051243
11,120435144,424369,GRIK4,27,,120859513
5,43287571,26043,HMGCS1,27,,43313614
7,27168125,2274,HOXA4,27,,27170399
22,23915312,7183,IGLL1,27,,23922495
5,113698015,134182,KCNN2,27,,113832197
6,33359312,18387,KIFC1,27,,33377699
12,52679696,5603,KRT81,27,,52685299
11,46878267,61906,LRP4,27,,46940173
X,148769902,29026,MAGEA11,27,,148798928
15,91446460,19355,MAN2A2,27,,91465815
1,17300998,7083,MFAP2,27,,17308081
2,27532359,13610,MPV17,27,,27545969
1,76262555,116368,MSH4,27,,76378923
17,45286427,14618,MYL4,27,,45301045
16,447191,3563,NME4,27,,450754
1,224415035,102856,NVL,27,,224517891
X,67262185,391114,OPHN1,27,,67653299
19,10222196,3868,P2RY11,27,,10226064
19,42801184,5745,PAFAH1B3,27,,42806929
9,128510477,219178,PBX3,27,,128729655
6,170890834,2946,PDCD2,27,,170893780
5,149237518,86838,PDE6A,27,,149324356
2,232597134,48903,PDE6D,27,,232646037
X,24483343,85240,PDK3,27,,24568583
6,42931610,15371,PEX6,27,,42946981
1,2336240,7770,PEX10,27,,2344010
17,8152595,21214,PFAS,27,,8173809
1,170633312,75229,PRRX1,27,,170708541
7,113516881,42201,PPP1R3A,27,,113559082
7,56078743,40525,PSPH,27,,56119268
12,6875482,4636,PTMS,27,,6880118
Y,24026222,14451,RBMY1A1,27,,24040673
3,139171725,23627,RBP2,27,,139195352
18,40323182,372475,RIT2,27,,40695657
22,50883430,30070,SBF1,27,,50913500
2,165944029,116548,SCN3A,27,,166060577
7,137761177,41873,AKR1D1,27,,137803050
1,11114648,5443,SRM,27,,11120091
9,100263461,100564,TMOD1,27,,100364025
8,97238903,8959,UQCRB,27,,97247862
3,150644353,46433,CLRN1,27,,150690786
1,92974252,283709,EVI5,27,,93257961
5,112212080,45951,REEP5,27,,112258031
6,33172413,2195,HSD17B8,27,,33174608
22,19117791,14399,DGCR14,27,,19132190
10,35927176,3186,FZD8,27,,35930362
22,29950797,26288,NIPSNAP1,27,,29977085
5,131593350,15797,PDLIM4,27,,131609147
3,62384020,477044,CADPS,27,,62861064
6,39156746,40505,KCNK5,27,,39197251
19,30414550,92969,URI1,27,,30507519
9,111704848,71026,CTNNAL1,27,,111775874
6,109687716,16046,CD164,27,,109703762
19,52114755,18972,SIGLEC5,27,,52133727
1,145516559,7173,PEX11B,27,,145523732
17,74070881,2741,GALR2,27,,74073622
8,87526655,47071,CPNE3,27,,87573726
11,102447565,48498,MMP20,27,,102496063
16,29985187,14539,TAOK2,27,,29999726
11,64373645,117015,NRXN2,27,,64490660
11,45931219,8455,PEX16,27,,45939674
6,41873090,15795,MED20,27,,41888885
17,45000482,13725,GOSR2,27,,45014207
9,80037994,225238,GNA14,27,,80263232
16,524849,47632,RAB11FIP3,27,,572481
12,120972131,43266,RNF10,27,,121015397
2,27353624,3919,PREB,27,,27357543
15,68570140,18063,FEM1B,27,,68588203
12,7085346,40496,LPCAT3,27,,7125842
9,4792833,68244,RCL1,27,,4861077
3,37903668,122292,CTDSPL,27,,38025960
12,9142220,21120,KLRG1,27,,9163340
3,178276487,285730,KCNMB2,27,,178562217
10,112052797,11910,SMNDC1,27,,112064707
10,103541081,2089,NPM3,27,,103543170
9,138824814,28412,UBAC1,27,,138853226
4,129190391,19593,PGRMC2,27,,129209984
3,33155449,33816,CRTAP,27,,33189265
16,417383,3186,MRPL28,27,,420569
1,28995239,46876,GMEB1,27,,29042115
14,24422943,15545,DHRS4,27,,24438488
9,123850573,89313,CNTRL,27,,123939886
7,150725508,19361,ABCB8,27,,150744869
13,42846288,51115,AKAP11,27,,42897403
17,72462521,18416,CD300A,27,,72480937
14,52471519,64427,NID2,27,,52535946
1,28526789,32753,DNAJC8,27,,28559542
14,55833108,45468,ATG14,27,,55878576
12,113229548,107136,RPH3A,27,,113336684
10,7792924,37066,KIN,27,,7829990
9,129849627,35417,ANGPTL2,27,,129885044
19,44010870,20538,ETHE1,27,,44031408
22,39526778,21760,CBX7,27,,39548538
9,19507449,279568,SLC24A2,27,,19787017
7,56131916,16449,SUMF2,27,,56148365
15,76196199,27009,FBXO22,27,,76223208
1,20439142,6917,PLA2G2D,27,,20446059
8,16850333,9341,FGF20,27,,16859674
22,43192531,60877,ARFGAP3,27,,43253408
11,89933596,22936,CHORDC1,27,,89956532
4,106290233,104994,PPA2,27,,106395227
2,54014067,31889,ERLEC1,27,,54045956
6,108362612,33329,OSTM1,27,,108395941
X,119738551,16465,MCTS1,27,,119755016
19,40928408,3524,SERTAD1,27,,40931932
5,169931039,232598,KCNIP1,27,,170163637
15,42191638,73117,EHD4,27,,42264755
9,117904096,260827,1-Dec,27,,118164923
12,104850691,305101,CHST11,27,,105155792
17,5374570,14980,DERL2,27,,5389550
17,49337896,37396,UTP18,27,,49375292
3,119217367,25758,TIMMDC1,27,,119243125
3,50378536,4641,ZMYND10,27,,50383177
7,120965420,15738,WNT16,27,,120981158
3,134074186,20073,AMOTL2,27,,134094259
17,79869814,6244,SIRT7,27,,79876058
8,103838529,37899,AZIN1,27,,103876428
6,36822605,20195,PPIL1,27,,36842800
17,17397752,1957,RASD1,27,,17399709
15,63481727,78246,RAB8B,27,,63559973
7,87563457,247971,ADAM22,27,,87811428
20,62679078,1901,SOX18,27,,62680979
7,120590816,24895,ING3,27,,120615711
1,16090993,10722,FBLIM1,27,,16101715
9,16409500,461286,BNC2,27,,16870786
1,93913687,106531,FNBP1L,27,,94020218
5,139781398,70664,ANKHD1,27,,139852062
6,170104001,20105,PHF10,27,,170124106
8,74698454,92691,UBE2W,27,,74791145
13,24153498,96746,TNFRSF19,27,,24250244
20,55966453,17933,RBM38,27,,55984386
12,122956145,29475,ZCCHC8,27,,122985620
4,184365743,4475,CDKN2AIP,27,,184370218
19,647525,15708,RNF126,27,,663233
17,2225981,14697,TSR1,27,,2240678
3,25760434,64555,NGLY1,27,,25824989
9,33921690,127257,UBAP2,27,,34048947
3,169490852,16652,MYNN,27,,169507504
9,131770071,20561,SH3GLB2,27,,131790632
14,21756135,63325,RPGRIP1,27,,21819460
6,5186833,74350,LYRM4,27,,5261183
20,24943579,29846,APMAP,27,,24973425
19,10713120,42115,SLC44A2,27,,10755235
1,70225857,363314,LRRC7,27,,70589171
2,219314973,118111,USP37,27,,219433084
1,67390577,63725,MIER1,27,,67454302
1,159141413,31519,CADM3,27,,159172932
11,405715,11682,SIGIRR,27,,417397
17,7999217,23017,ALOXE3,27,,8022234
8,19171486,82243,SH2D4A,27,,19253729
19,46801632,45058,HIF3A,27,,46846690
3,178735010,54646,ZMAT3,27,,178789656
6,109765265,11925,MICAL1,27,,109777190
11,62342516,16593,TUT1,27,,62359109
20,3026674,2222,MRPS26,27,,3028896
13,115047058,24233,UPF3A,27,,115071291
7,30536236,8221,GGCT,27,,30544457
17,78152306,24124,CARD14,27,,78176430
1,15736390,20449,EFHD2,27,,15756839
1,2522080,42401,MMEL1,27,,2564481
7,107384141,17971,CBLL1,27,,107402112
3,132378340,18611,UBA5,27,,132396951
14,89029252,50601,ZC3H14,27,,89079853
14,50709151,69796,L2HGDH,27,,50778947
15,74922898,65488,EDC3,27,,74988386
11,58346586,42437,ZFP91,27,,58389023
1,161040780,18605,PVRL4,27,,161059385
14,78174413,9528,SLIRP,27,,78183941
11,119209643,7740,MFRP,27,,119217383
1,28585962,23040,SESN2,27,,28609002
11,13690205,63688,FAR1,27,,13753893
5,6372038,6601,MED10,27,,6378639
17,77751976,9473,CBX2,27,,77761449
3,158362316,48044,GFM1,27,,158410360
8,118532951,19550,MED30,27,,118552501
16,23399813,64699,COG7,27,,23464512
17,42148097,5615,G6PC3,27,,42153712
1,160061128,7490,IGSF8,27,,160068618
19,38741876,5355,PPP1R14A,27,,38747231
2,130949317,6717,TUBA3E,27,,130956034
12,76745577,208012,OSBPL8,27,,76953589
17,76987797,18102,CANT1,27,,77005899
1,219347172,39035,LYPLAL1,27,,219386207
2,224620046,82273,AP1S3,27,,224702319
1,101361631,85680,SLC30A7,27,,101447311
1,231468476,5142,EXOC8,27,,231473618
17,3413795,47494,TRPV3,27,,3461289
11,59404191,32320,PATL1,27,,59436511
5,114914192,23984,TICAM2,27,,114938176
14,65412531,26344,RAB15,27,,65438875
8,97154560,18460,GDF6,27,,97173020
22,46509565,83,MIRLET7B,27,,46509648
21,17912147,84,MIRLET7C,27,,17912231
4,113569338,69,MIR302A,27,,113569407
1,149783433,495,HIST2H2BF,27,,149783928
X,52541053,5144,XAGE1B,27,,52546197
10,124768428,49378,ACADSB,26,,124817806
9,33384947,17733,AQP7,26,,33402680
1,160147200,9567,ATP1A4,26,,160156767
2,242498145,15408,BOK,26,,242513553
9,139839697,1729,C8G,26,,139841426
17,37329708,24248,CACNB1,26,,37353956
19,49838676,5185,CD37,26,,49843861
9,35609975,8449,CD72,26,,35618424
4,151185810,750609,LRBA,26,,151936419
18,12254317,23277,CIDEA,26,,12277594
19,1941160,40176,CSNK1G2,26,,1981336
17,41561284,40402,DHX8,26,,41601686
11,108535751,275906,DDX10,26,,108811657
5,13690436,254153,DNAH5,26,,13944589
3,58178352,18378,DNASE1L3,26,,58196730
10,112257624,13678,DUSP5,26,,112271302
X,129198894,45794,ELF4,26,,129244688
1,205577070,24930,ELK4,26,,205602000
17,4854383,6043,ENO3,26,,4860426
4,5712923,103108,EVC,26,,5816031
X,132435063,114142,GPC4,26,,132549205
X,30671475,78102,GK,26,,30749577
12,65107221,46005,GNS,26,,65153226
1,181002560,28514,MR1,26,,181031074
1,120290618,20937,HMGCS2,26,,120311555
17,68071365,60381,KCNJ16,26,,68131746
17,39017429,6033,KRT12,26,,39023462
5,135282599,8124,LECT2,26,,135290723
5,66478103,14514,CD180,26,,66492617
2,160659867,101400,LY75,26,,160761267
18,13825542,1319,MC5R,26,,13826861
11,61976139,5272,SCGB2A1,26,,61981411
12,132312937,23379,MMP17,26,,132336316
12,57422300,22249,MYO1A,26,,57444549
7,10971579,8234,NDUFA4,26,,10979813
4,170314420,219358,NEK1,26,,170533778
X,17653412,100701,NHS,26,,17754113
12,96672038,122328,CDK17,26,,96794366
8,66626568,127401,PDE7A,26,,66753969
6,131958374,110176,ENPP3,26,,132068550
19,35606731,8497,FXYD3,26,,35615228
22,41972889,12982,PMM1,26,,41985871
10,48381486,9505,RBP3,26,,48390991
17,9801026,7658,RCVRN,26,,9808684
11,121163576,20543,SC5D,26,,121184119
3,157813799,10153,SHOX2,26,,157823952
6,100836749,74802,SIM1,26,,100911551
8,17354596,73481,SLC7A2,26,,17428077
2,103235992,91817,SLC9A2,26,,103327809
6,25783125,49162,SLC17A1,26,,25832287
17,45973515,32808,SP2,26,,46006323
16,71600753,10245,TAT,26,,71610998
6,30034931,3177,PPP1R11,26,,30038108
3,141663269,205117,TFDP2,26,,141868386
16,11361713,1447,TNP2,26,,11363160
1,55181494,26834,TTC4,26,,55208328
4,48068409,67864,TXK,26,,48136273
19,29698166,5970,UQCRFS1,26,,29704136
19,59073283,11659,MZF1,26,,59084942
11,9482511,67560,ZNF143,26,,9550071
15,45771810,43192,SLC30A4,26,,45815002
1,55464616,9849,BSND,26,,55474465
6,31654725,16125,ABHD16A,26,,31670850
10,112679300,94125,SHOC2,26,,112773425
6,27805657,460,HIST1H2AK,26,,27806117
6,26123694,438,HIST1H2BC,26,,26124132
3,50330258,6035,HYAL3,26,,50336293
12,68042511,13933,DYRK2,26,,68056444
12,27677044,171453,PPFIBP1,26,,27848497
1,19629201,9439,AKR7A2,26,,19638640
19,19303007,9671,RFXANK,26,,19312678
1,171669295,42084,VAMP4,26,,171711379
2,119699744,52492,MARCO,26,,119752236
9,139756565,4223,EDF1,26,,139760788
8,145137523,3596,GPAA1,26,,145141119
22,22311396,25844,TOP3B,26,,22337240
6,27100816,498,HIST1H2AG,26,,27101314
13,96085852,146158,CLDN10,26,,96232010
21,31586323,2146,CLDN8,26,,31588469
20,32077927,159910,CBFA2T2,26,,32237837
11,65651210,4800,FIBP,26,,65656010
8,1449531,207111,DLGAP2,26,,1656642
5,111064999,247629,NREP,26,,111312628
X,102883891,1985,TCEAL1,26,,102885876
11,118230295,39631,UBE4A,26,,118269926
19,19040009,11152,HOMER3,26,,19051161
1,54492353,26758,TMEM59,26,,54519111
19,11432721,17623,RAB3D,26,,11450344
1,86889565,32675,CLCA2,26,,86922240
22,22273791,33459,PPM1F,26,,22307250
4,56814973,84556,CEP135,26,,56899529
2,61414589,283260,USP34,26,,61697849
2,75873908,15426,MRPL19,26,,75889334
20,60813540,57729,OSBPL2,26,,60871269
12,114259858,144318,RBM19,26,,114404176
X,140991641,5546,MAGEC1,26,,140997187
9,114979994,115950,PTBP3,26,,115095944
1,77554666,130466,PIGK,26,,77685132
13,93879077,1181196,GPC6,26,,95060273
4,89647104,97408,FAM13A,26,,89744512
11,114271250,10082,RBM7,26,,114281332
13,50571142,21461,TRIM13,26,,50592603
17,39845126,2772,EIF1,26,,39847898
15,77712992,64954,HMG20A,26,,77777946
16,29869676,4933,CDIPT,26,,29874609
11,308106,1304,IFITM2,26,,309410
3,121150272,114581,POLQ,26,,121264853
5,1050488,61684,SLC12A7,26,,1112172
10,27399039,44310,YME1L1,26,,27443349
1,243419306,244087,SDCCAG8,26,,243663393
4,778744,41201,CPLX1,26,,819945
15,65440557,37201,CLPX,26,,65477758
9,132597695,46422,USP20,26,,132644117
5,44809026,6592,MRPS30,26,,44815618
18,9708227,154326,RAB31,26,,9862553
12,108079508,27431,PWP1,26,,108106939
3,58549838,13653,FAM107A,26,,58563491
17,35874899,94587,SYNRG,26,,35969486
5,179224597,9355,MGAT4B,26,,179233952
5,95066849,65222,RHOBTB3,26,,95132071
1,9789078,95506,CLSTN1,26,,9884584
20,25433332,132835,NINL,26,,25566167
12,50260678,37082,FAIM2,26,,50297760
13,46536313,90600,ZC3H13,26,,46626913
17,26698682,29373,SARM1,26,,26728055
10,126490353,34886,FAM175B,26,,126525239
10,852853,124792,LARP4B,26,,977645
1,150336586,112455,RPRD2,26,,150449041
12,77157853,89621,ZDHHC17,26,,77247474
3,45430074,160254,LARS2,26,,45590328
8,71485452,35242,TRAM1,26,,71520694
X,48334408,10344,FTSJ1,26,,48344752
9,117164359,101136,DFNB31,26,,117265495
3,32726636,88731,CNOT10,26,,32815367
3,42824399,21535,HIGD1A,26,,42845934
14,71996028,211918,SIPA1L1,26,,72207946
1,11724149,10260,FBXO6,26,,11734409
7,89783688,10453,STEAP1,26,,89794141
3,132399452,41851,NPHP3,26,,132441303
4,84184976,21091,COQ2,26,,84206067
3,128598332,33625,ACAD9,26,,128631957
15,51973549,39674,SCG3,26,,52013223
1,38032412,29174,GNL2,26,,38061586
1,169101767,235434,NME7,26,,169337201
9,140004991,4204,DPP7,26,,140009195
1,94335013,9749,DNTTIP2,26,,94344762
12,102122425,10825,SYCP3,26,,102133250
20,62271057,13062,STMN3,26,,62284119
13,52986736,38077,VPS36,26,,53024813
12,32899477,9410,YARS2,26,,32908887
4,38665789,37340,KLF3,26,,38703129
14,59104756,10282,DACT1,26,,59115038
6,110501623,51799,CDC40,26,,110553422
20,850541,46436,ANGPT4,26,,896977
6,13615558,6386,NOL7,26,,13621944
7,100240725,13359,ACTL6B,26,,100254084
X,100878119,4712,ARMCX3,26,,100882831
20,31946644,42731,CDK5RAP1,26,,31989375
6,45866189,181896,CLIC5,26,,46048085
10,26727265,129467,APBB1IP,26,,26856732
13,80055258,74954,NDFIP2,26,,80130212
16,15153878,34314,RRN3,26,,15188192
8,94929174,9122,PDP1,26,,94938296
10,94050919,62802,5-Mar,26,,94113721
4,146054801,46031,OTUD4,26,,146100832
18,46570171,416908,DYM,26,,46987079
8,74888376,6642,TMEM70,26,,74895018
6,79644135,143876,PHIP,26,,79788011
8,22133079,80505,PIWIL2,26,,22213584
4,37828281,36278,PGM2,26,,37864559
11,27387507,106827,LGR4,26,,27494334
16,68392229,90180,SMPD3,26,,68482409
2,71295407,10591,NAGK,26,,71305998
6,82455446,6982,FAM46A,26,,82462428
6,75962637,31995,TMEM30A,26,,75994632
2,203745322,31627,WDR12,26,,203776949
4,56719815,51429,EXOC1,26,,56771244
12,68595128,24443,IL26,26,,68619571
17,30190189,38540,UTP6,26,,30228729
2,187350884,23203,ZC3H15,26,,187374087
1,112938799,64987,CTTNBP2NL,26,,113003786
12,95365103,32386,NDUFA12,26,,95397489
10,51946999,61371,ASAH2,26,,52008370
X,48830130,28545,GRIPAP1,26,,48858675
1,214454564,55913,SMYD2,26,,214510477
4,71554195,2073,UTP3,26,,71556268
1,11796141,14687,AGTRAP,26,,11810828
11,66081957,2558,CD248,26,,66084515
11,67205517,5775,CORO1B,26,,67211292
20,56884770,57793,RAB22A,26,,56942563
13,40229763,136039,COG6,26,,40365802
22,18317100,72552,MICAL3,26,,18389652
15,41186627,9546,VPS18,26,,41196173
4,77356252,348153,SHROOM3,26,,77704405
11,85368607,7575,CREBZF,26,,85376182
1,24446260,23515,IL22RA1,26,,24469775
1,202860223,36177,KLHL12,26,,202896400
6,17763923,223931,KIF13A,26,,17987854
14,93648540,2709,MOAP1,26,,93651249
1,39303868,21627,RRAGC,26,,39325495
14,77490885,4157,IRF2BPL,26,,77495042
7,137597556,89291,CREB3L2,26,,137686847
14,94492723,22553,OTUB2,26,,94515276
17,5389693,4437,MIS12,26,,5394130
15,101459419,150898,LRRK1,26,,101610317
12,112464492,82143,NAA25,26,,112546635
11,73588013,50768,PAAF1,26,,73638781
16,69458497,41670,CYB5B,26,,69500167
12,12626215,89233,DUSP16,26,,12715448
1,19166092,20063,TAS1R2,26,,19186155
20,45338278,26707,SLC2A10,26,,45364985
6,127587882,21823,RNF146,26,,127609705
1,231473681,17092,SPRTN,26,,231490773
16,57050985,66451,NLRC5,26,,57117436
8,145159304,3211,MAF1,26,,145162515
11,116618885,24829,BUD13,26,,116643714
10,27443752,33130,MASTL,26,,27476882
3,111451326,244038,PHLDB2,26,,111695364
3,48599150,2051,UCN2,26,,48601201
10,74451888,195564,MCU,26,,74647452
17,61780191,39139,STRADA,26,,61819330
4,6641817,2653,MRFAP1,26,,6644470
6,1312674,2319,FOXQ1,26,,1314993
11,3108345,78237,OSBPL5,26,,3186582
17,7835441,17796,CNTROB,26,,7853237
9,75136716,314551,TMC1,26,,75451267
15,23043278,43565,NIPA1,26,,23086843
16,2880172,2113,ZG16B,26,,2882285
17,45900637,8270,MRPL10,26,,45908907
2,183982217,44195,NUP35,26,,184026412
19,11256169,10319,SPC24,26,,11266488
21,44834397,12605,SIK1,26,,44847002
9,79226291,294712,PRUNE2,26,,79521003
14,47308827,835330,MDGA2,26,,48144157
10,46222647,65765,FAM21C,26,,46288412
6,132891460,1038,TAAR6,26,,132892498
13,99852678,186075,UBAC2,26,,100038753
10,95326421,23408,FFAR4,26,,95349829
9,73424890,110,MIR204,26,,73425000
2,211052715,37500,ACADL,25,,211090215
1,65613512,84316,AK4,25,,65697828
12,39945021,68822,ABCD2,25,,40013843
1,104097265,24891,AMY2B,25,,104122156
Y,1683940,28034,ASMT,25,,1711974
13,114303121,9392,ATP4B,25,,114312513
15,83924654,28814,BNC1,25,,83953468
8,22102618,6062,POLR3D,25,,22108680
8,61097978,96004,CA8,25,,61193982
10,5566851,1380,CALML3,25,,5568231
15,93443550,48913,CHD2,25,,93492463
10,101802064,39578,CPN1,25,,101841642
2,209007296,3581,CRYGB,25,,209010877
3,185864989,215034,DGKG,25,,186080023
8,6782215,1383,DEFA6,25,,6783598
16,2273488,12255,E4F1,25,,2285743
12,13349601,20107,EMP1,25,,13369708
11,76368567,13224,LRRC32,25,,76381791
9,127279553,254036,NR6A1,25,,127533589
X,153485202,14268,OPN1MW,25,,153499470
4,176554087,369755,GPM6A,25,,176923842
2,133174146,230023,GPR39,25,,133404169
14,25075685,3241,GZMH,25,,25078926
2,149632791,250482,KIF5C,25,,149883273
17,56315786,30093,LPO,25,,56345879
1,160765863,6673,LY9,25,,160772536
19,13209841,4133,LYL1,25,,13213974
3,149086804,8764,TM4SF1,25,,149095568
X,151899292,3809,MAGEA12,25,,151903101
1,31184123,12309,MATN1,25,,31196432
X,71521487,4277,CITED1,25,,71525764
X,119005733,4896,NDUFA1,25,,119010629
5,1801495,14672,NDUFS6,25,,1816167
21,44313377,16396,NDUFV3,25,,44329773
20,52824501,11991,PFDN4,25,,52836492
7,56147975,12714,PHKG1,25,,56160689
14,50110269,44829,POLE2,25,,50155098
4,57259528,42274,PPAT,25,,57301802
10,104162373,17318,PSD,25,,104179691
3,158422439,27836,RARRES1,25,,158450275
1,44173203,223634,ST3GAL3,25,,44396837
16,31494438,7653,SLC5A2,25,,31502091
8,20002365,38352,SLC18A1,25,,20040717
2,182756442,39022,SSFA2,25,,182795464
3,69068977,32507,TMF1,25,,69101484
22,46316247,56761,WNT7B,25,,46373008
13,21140954,124622,IFT88,25,,21265576
21,45553493,12112,C21orf33,25,,45565605
Y,21867300,39525,KDM5D,25,,21906825
12,10559982,2374,KLRC4,25,,10562356
6,27775976,469,HIST1H2AI,25,,27776445
9,71320329,303763,PIP5K1B,25,,71624092
1,6094347,66906,KCNAB2,25,,6161253
11,45669238,17968,CHST1,25,,45687206
21,45209417,14566,RRP1,25,,45223983
1,19197923,19462,ALDH4A1,25,,19217385
7,21582832,358354,DNAH11,25,,21941186
3,160801670,21490,B3GALNT1,25,,160823160
2,207308367,177487,ADAM23,25,,207485854
2,102803432,52379,IL1RL2,25,,102855811
2,143635194,111912,KYNU,25,,143747106
6,136663418,183933,MAP7,25,,136847351
20,34256609,30678,NFS1,25,,34287287
X,153672472,6530,FAM50A,25,,153679002
17,9728867,66553,GLP2R,25,,9795420
19,16685717,53298,MED26,25,,16739015
10,73724119,49203,CHST3,25,,73773322
12,121078421,26706,CABP1,25,,121105127
14,77972339,110771,SPTLC2,25,,78083110
10,89264222,48996,MINPP1,25,,89313218
14,103398715,125027,CDC42BPB,25,,103523742
9,74764266,102874,GDA,25,,74867140
18,2916991,94954,LPIN2,25,,3011945
15,35148551,113444,AQR,25,,35261995
3,183993798,17021,ECE2,25,,184010819
11,128834954,227139,ARHGAP32,25,,129062093
1,65775217,106335,DNAJC6,25,,65881552
3,9022275,269094,SRGAP3,25,,9291369
7,86781676,43972,DMTF1,25,,86825648
5,141380233,12387,GNPDA1,25,,141392620
3,119388371,7872,COX17,25,,119396243
5,83236413,444272,EDIL3,25,,83680685
1,46640748,10886,TSPAN1,25,,46651634
2,71357443,19789,MPHOSPH10,25,,71377232
4,1283638,50298,MAEA,25,,1333936
16,57769659,21503,KATNB1,25,,57791162
7,98923495,40390,ARPC1A,25,,98963885
15,80135888,53739,MTHFS,25,,80189627
7,101928352,33826,SH2B2,25,,101962178
20,18448032,17260,POLR3F,25,,18465292
11,62538774,16039,TAF6L,25,,62554813
14,57669193,66424,EXOC5,25,,57735617
6,5261558,510267,FARS2,25,,5771825
3,49146105,12266,USP19,25,,49158371
4,56461395,41070,NMU,25,,56502465
3,122785855,95098,PDIA5,25,,122880953
6,30070673,10210,TRIM31,25,,30080883
12,91444270,7861,KERA,25,,91452131
22,37956470,8940,CDC42EP1,25,,37965410
4,123813798,29963,NUDT6,25,,123843761
14,50885210,114166,MAP4K5,25,,50999376
1,156182778,27090,PMF1,25,,156209868
9,34613541,6979,DCTN3,25,,34620520
1,150039349,78156,VPS45,25,,150117505
10,74894281,33572,ECD,25,,74927853
2,99235568,44368,MGAT4A,25,,99279936
20,35089817,67223,DLGAP4,25,,35157040
4,90816051,59729,MMRN1,25,,90875780
5,95220801,76974,ELL2,25,,95297775
4,85590692,296852,WDFY3,25,,85887544
5,31639516,471522,PDZD2,25,,32111038
16,15068819,63368,PDXDC1,25,,15132187
10,103892750,17340,PPRC1,25,,103910090
16,49521441,370389,ZNF423,25,,49891830
17,42472644,108326,GPATCH8,25,,42580970
19,42788816,11132,CIC,25,,42799948
4,99916787,67173,METAP1,25,,99983960
16,85645028,64784,GSE1,25,,85709812
1,171454665,107985,PRRC2C,25,,171562650
X,62854847,150579,ARHGEF9,25,,63005426
5,131285666,61689,ACSL6,25,,131347355
15,42450898,49626,VPS39,25,,42500524
7,44421964,108421,NUDCD3,25,,44530385
15,85212767,46924,SEC11A,25,,85259691
7,140155982,23387,MKRN1,25,,140179369
X,51486480,2846,GSPT2,25,,51489326
5,78365546,20351,BHMT2,25,,78385897
22,28247656,67638,PITPNB,25,,28315294
22,31089768,214043,OSBP2,25,,31303811
22,38597938,14579,MAFF,25,,38612517
9,130928343,38319,CIZ1,25,,130966662
5,118604386,125913,TNFAIP8,25,,118730299
16,70514471,42986,COG4,25,,70557457
12,51442081,12126,LETMD1,25,,51454207
1,247002401,92325,AHCTF1,25,,247094726
11,114310107,10893,REXO2,25,,114321000
3,114033346,69143,ZBTB20,25,,114102489
11,33762489,33582,FBXO3,25,,33796071
10,99332197,11444,ANKRD2,25,,99343641
2,97481990,19131,CNNM3,25,,97501121
7,38763542,185258,VPS41,25,,38948800
6,30585485,8689,MRPS18B,25,,30594174
5,154320632,28339,MRPL22,25,,154348971
20,23331372,4036,NXT1,25,,23335408
19,41699111,14333,CYP2S1,25,,41713444
7,150065878,5255,REPIN1,25,,150071133
7,8473584,319009,NXPH1,25,,8792593
17,36508006,53840,SOCS7,25,,36561846
2,31456879,34381,EHD3,25,,31491260
3,130397777,67919,PIK3R4,25,,130465696
11,131240370,966346,NTM,25,,132206716
19,50058724,25105,NOSIP,25,,50083829
19,10362639,8082,MRPL4,25,,10370721
6,155577263,58354,TFB1M,25,,155635617
18,44681389,21356,IER3IP1,25,,44702745
17,18012019,71097,MYO15A,25,,18083116
4,88257676,54779,HSD17B11,25,,88312455
2,36583369,194909,CRIM1,25,,36778278
19,35739558,19309,LSR,25,,35758867
20,34129777,15628,ERGIC3,25,,34145405
16,66965957,2369,FAM96B,25,,66968326
17,57774666,10293,PTRH2,25,,57784959
7,24612964,120358,MPP6,25,,24733322
1,235330209,160593,ARID4B,25,,235490802
4,120056938,52006,MYOZ2,25,,120108944
4,1005609,15077,FGFRL1,25,,1020686
12,20848398,57922,SLCO1C1,25,,20906320
15,80351909,78826,ZFAND6,25,,80430735
1,10696665,160068,CASZ1,25,,10856733
1,220921587,36570,2-Mar,25,,220958157
19,49949549,5566,PIH1D1,25,,49955115
1,1337275,5418,MRPL20,25,,1342693
2,119981383,41844,STEAP3,25,,120023227
4,178230990,53102,NEIL3,25,,178284092
2,3501689,21661,ADI1,25,,3523350
5,34915819,9968,BRIX1,25,,34925787
19,4324039,14808,STAP2,25,,4338847
20,47835831,24783,DDX27,25,,47860614
5,612404,41262,CEP72,25,,653666
12,27058111,33143,ASUN,25,,27091254
5,96502449,16556,RIOK2,25,,96519005
6,24667262,38033,ACOT13,25,,24705295
7,104654636,99896,KMT2E,25,,104754532
12,22199107,19499,CMAS,25,,22218606
6,73331570,577003,KCNQ5,25,,73908573
6,30294620,16886,TRIM39,25,,30311506
2,27071156,102063,DPYSL5,25,,27173219
18,12702986,22753,PSMG2,25,,12725739
15,34158427,172876,AVEN,25,,34331303
5,172261222,118466,ERGIC1,25,,172379688
2,55774427,70433,SMEK2,25,,55844860
19,984327,10242,WDR18,25,,994569
7,158523688,98631,ESYT2,25,,158622319
8,17501302,157124,MTUS1,25,,17658426
11,576445,35777,PHRF1,25,,612222
10,113909621,33916,GPAM,25,,113943537
11,67118235,2832,POLD4,25,,67121067
15,45923345,60147,SQRDL,25,,45983492
2,108602969,27474,SLC5A7,25,,108630443
7,105172531,35593,RINT1,25,,105208124
1,176432306,379664,PAPPA2,25,,176811970
20,44994683,41007,ELMO2,25,,45035690
7,45002259,16445,MYO1G,25,,45018704
13,79893002,87354,RBM26,25,,79980356
10,96092982,29751,NOC3L,25,,96122733
3,123632273,47982,CCDC14,25,,123680255
1,114447914,8794,DCLRE1B,25,,114456708
2,204306191,93867,RAPH1,25,,204400058
12,122716093,34975,VPS33A,25,,122751068
3,9975524,11573,CRELD1,25,,9987097
10,104183001,9422,CUEDC2,25,,104192423
12,113594977,28307,DDX54,25,,113623284
13,51483813,60783,RNASEH2B,25,,51544596
11,119039421,15305,NLRX1,25,,119054726
15,67493012,54524,AAGAB,25,,67547536
12,123349874,30838,VPS37B,25,,123380712
10,14920781,25523,SUV39H2,25,,14946304
16,87360592,65121,FBXO31,25,,87425713
17,29158987,63896,ATAD5,25,,29222883
3,113435306,29840,NAA50,25,,113465146
3,138213180,100045,CEP70,25,,138313225
7,55538300,82166,VOPP1,25,,55620466
1,157543538,24332,FCRL4,25,,157567870
16,84853586,89530,CRISPLD2,25,,84943116
1,22054338,55350,USP48,25,,22109688
15,82334118,4366,MEX3B,25,,82338484
5,175386533,8785,THOC3,25,,175395318
20,62338793,28701,ZGPAT,25,,62367494
2,74732169,2652,PCGF1,25,,74734821
22,50656117,27283,TUBGCP6,25,,50683400
19,33469497,86327,RHPN2,25,,33555824
11,111807926,85448,DIXDC1,25,,111893374
22,26846848,32981,HPS4,25,,26879829
11,19372270,770877,NAV2,25,,20143147
17,26655350,7165,IFT20,25,,26662515
1,154929501,4757,PYGO2,25,,154934258
8,94767071,63276,TMEM67,25,,94830347
7,132068246,193077,PLXNA4,25,,132261323
X,99929488,57647,SYTL4,25,,99987135
11,64844926,6689,CDCA5,25,,64851615
20,740723,8505,SLC52A3,25,,749228
7,76090971,44341,DTX2,25,,76135312
8,120220609,37305,MAL2,25,,120257914
18,21742010,149460,OSBPL1A,25,,21891470
13,77454303,6237,KCTD12,25,,77460540
13,50202434,5574,ARL11,25,,50208008
19,14138959,3411,RLN3,25,,14142370
3,98514813,105720,DCBLD2,25,,98620533
8,17104400,51133,VPS37A,25,,17155533
14,47120219,809,RPL10L,25,,47121028
10,114206745,371758,VTI1A,25,,114578503
8,27632057,30367,ESCO2,25,,27662424
16,88520013,81561,ZFPM1,25,,88601574
1,24480646,33119,IFNLR1,25,,24513765
6,31082607,25262,PSORS1C1,25,,31107869
1,36396682,125381,AGO3,25,,36522063
12,2055213,58488,DCP1B,25,,2113701
2,68694690,112604,APLF,25,,68807294
10,45950032,80810,8-Mar,25,,46030842
17,44076615,445,STH,25,,44077060
8,64081111,44235,YTHDF3,25,,64125346
3,111839687,12465,GCSAM,25,,111852152
10,102033034,13087,BLOC1S2,25,,102046121
3,142984063,583310,SLC9A9,25,,143567373
8,126104082,275285,NSMCE2,25,,126379367
8,144806102,9812,FAM83H,25,,144815914
1,234740014,5257,IRF2BP2,25,,234745271
6,128029338,192888,THEMIS,25,,128222226
17,46114526,87,MIR152,25,,46114613
21,17911408,81,MIR99A,25,,17911489
7,27209098,84,MIR196B,25,,27209182
2,131975923,46493,POTEE,25,,132022416
17,49230896,18209,NME1-NME2,25,,49249105
10,51592080,31306,TIMM23,25,,51623386
2,54342409,190026,ACYP2,24,,54532435
4,74347461,22257,AFM,24,,74369718
11,67777774,18975,ALDH3B1,24,,67796749
11,10472223,56903,AMPD3,24,,10529126
2,201450730,85487,AOX1,24,,201536217
4,40812043,404592,APBB2,24,,41216635
8,143545376,80992,BAI1,24,,143626368
1,160160284,11392,CASQ1,24,,160171676
9,131595391,48963,CCBL1,24,,131644354
1,157800703,10931,CD5L,24,,157811634
5,31193761,135492,CDH6,24,,31329253
14,89622515,462979,FOXN3,24,,90085494
4,70796798,15490,CSN1S1,24,,70812288
4,952671,14677,DGKQ,24,,967348
X,153629576,10852,DNASE1L1,24,,153640428
3,50712671,708958,DOCK3,24,,51421629
2,25600111,296405,DTNB,24,,25896516
12,113495661,40172,DTX1,24,,113535833
4,139978870,26698,ELF2,24,,140005568
11,34500341,35006,ELF5,24,,34535347
8,1711869,22867,CLN8,24,,1734736
7,56032269,35606,GBAS,24,,56067875
1,89571815,20027,GBP2,24,,89591842
6,10555948,73653,GCNT2,24,,10629601
19,2511217,191529,GNG7,24,,2702746
2,191208195,28196,INPP1,24,,191236391
1,226819390,107486,ITPKB,24,,226926876
21,39628619,45127,KCNJ15,24,,39673746
16,57792128,39801,KIFC3,24,,57831929
19,39292310,11430,LGALS4,24,,39303740
17,35294771,7144,LHX1,24,,35301915
19,15751706,19864,CYP4F3,24,,15771570
6,10762955,75833,MAK,24,,10838788
8,98881248,167698,MATN2,24,,99048946
22,39883228,4971,MGAT3,24,,39888199
1,158801167,18103,MNDA,24,,158819270
17,2287353,16905,MNT,24,,2304258
2,211154867,25028,MYL1,24,,211179895
2,191513847,43645,NAB1,24,,191557492
1,39491966,8342,NDUFS5,24,,39500308
15,85198359,3443,NMB,24,,85201802
19,5823812,4523,NRTN,24,,5828335
2,63277191,7775,OTX1,24,,63284966
X,69478015,1639,P2RY4,24,,69479654
13,25670275,2429,PABPC3,24,,25672704
20,21686296,12828,PAX1,24,,21699124
17,79617488,6119,PDE6G,24,,79623607
15,85523743,158633,PDE8A,24,,85682376
21,44073861,121757,PDE9A,24,,44195618
17,33901813,3843,PEX12,24,,33905656
7,90225675,614230,CDK14,24,,90839905
2,198669425,345183,PLCL1,24,,199014608
3,142315228,117277,PLS1,24,,142432505
10,93388197,4661,PPP1R3C,24,,93392858
15,75759461,112171,PTPN9,24,,75871632
12,9301435,59531,PZP,24,,9360966
10,86004808,14136,RGR,24,,86018944
5,40831429,3958,RPL37,24,,40835387
14,21989230,16120,SALL2,24,,22005350
17,75137004,76177,SEC14L1,24,,75213181
10,50818346,2420,SLC18A3,24,,50820766
3,133651539,97381,SLCO2A1,24,,133748920
9,139270020,22869,SNAPC4,24,,139292889
5,136310986,524032,SPOCK1,24,,136835018
8,126010719,23806,SQLE,24,,126034525
21,15743436,12073,HSPA13,24,,15755509
5,171469073,146273,STK10,24,,171615346
1,234527058,87791,TARBP1,24,,234614849
20,62694009,9691,TCEA2,24,,62703700
2,75889831,47901,GCFC2,24,,75937732
1,226124297,4895,LEFTY2,24,,226129192
19,2997635,49998,TLE2,24,,3047633
2,217724181,601,TNP1,24,,217724782
12,95424184,43220,NR2C1,24,,95467404
12,6857157,4925,MLF2,24,,6862082
6,27782079,439,HIST1H2AJ,24,,27782518
15,65488336,15504,CILP,24,,65503840
3,88101099,7047,CGGBP1,24,,88108146
9,99262394,66809,CDC14B,24,,99329203
8,54764367,107497,RGS20,24,,54871864
3,125165487,73571,SNX4,24,,125239058
18,13726658,37897,RNMT,24,,13764555
19,46522411,4145,PGLYRP1,24,,46526556
17,4675186,11320,TM4SF5,24,,4686506
4,16503156,397276,LDB2,24,,16900432
1,207076630,18748,FAIM3,24,,207095378
6,10873455,8643,GCM2,24,,10882098
7,6201411,110831,CYTH3,24,,6312242
1,235491752,16092,GGPS1,24,,235507844
1,178310605,138043,RASAL2,24,,178448648
19,3750770,10903,APBA3,24,,3761673
2,44544747,42141,PREPL,24,,44586888
7,28725597,139914,CREB5,24,,28865511
22,46756730,176337,CELSR1,24,,46933067
3,197398264,78306,KIAA0226,24,,197476570
22,39081547,14912,JOSD1,24,,39096459
15,63796709,90130,USP3,24,,63886839
3,23987611,34498,NR1D2,24,,24022109
11,33278867,99701,HIPK3,24,,33378568
4,71494460,18076,ENAM,24,,71512536
13,98795351,102207,FARP1,24,,98897558
14,24105572,9276,DHRS2,24,,24114848
15,90373830,63787,AP3S2,24,,90437617
8,99114566,14852,HRSP12,24,,99129418
3,49866027,27965,TRAIP,24,,49893992
X,55744109,41098,RRAGB,24,,55785207
19,12917427,7035,RNASEH2A,24,,12924462
11,6469842,25847,TRIM3,24,,6495689
12,4647949,21264,RAD51AP1,24,,4669213
3,50384918,3568,NPRL2,24,,50388486
9,19049371,1650,RRAGA,24,,19051021
17,4901242,30452,KIF1C,24,,4931694
X,133699872,92641,PLAC1,24,,133792513
X,107069083,105784,MID2,24,,107174867
11,63341943,39998,PLA2G16,24,,63381941
8,20103675,9128,LZTS1,24,,20112803
10,121652084,52086,SEC23IP,24,,121704170
15,68594041,130451,ITGA11,24,,68724492
6,52866097,60503,ICK,24,,52926600
22,31321116,43157,MORC2,24,,31364273
17,19140689,99339,EPN2,24,,19240028
16,71678828,70915,PHLPP2,24,,71749743
1,27561006,74118,WDTC1,24,,27635124
8,21777179,86917,XPO7,24,,21864096
11,9685623,88915,SWAP70,24,,9774538
1,36023392,8988,NCDN,24,,36032380
8,38089470,30817,DDHD2,24,,38120287
14,23594503,30164,SLC7A8,24,,23624667
17,71279762,28381,CDC42EP4,24,,71308143
15,64199234,139287,DAPK2,24,,64338521
2,235860627,103731,SH3BP4,24,,235964358
6,36935910,18417,MTCH1,24,,36954327
8,101269286,79160,RNF19A,24,,101348446
1,212899494,65645,NSL1,24,,212965139
10,69681655,153448,HERC4,24,,69835103
7,1509912,34106,INTS1,24,,1544018
11,111955538,1984,TIMM8B,24,,111957522
1,161129253,6263,USP21,24,,161135516
7,144149033,384113,TPK1,24,,144533146
2,113779667,30777,IL36B,24,,113810444
19,51954250,7458,SIGLEC8,24,,51961708
3,14220227,19642,LSM3,24,,14239869
X,99899162,27134,SRPX2,24,,99926296
8,80831094,111412,MRPS28,24,,80942506
11,64058792,8711,KCNK4,24,,64067503
7,122634758,996,TAS2R16,24,,122635754
12,49480438,8164,DHH,24,,49488602
17,6546632,8322,MED31,24,,6554954
1,52485803,36040,TXNDC12,24,,52521843
15,41624891,48357,NUSAP1,24,,41673248
6,13305183,23632,TBC1D7,24,,13328815
11,64083963,1593,TRMT112,24,,64085556
17,55916286,11147,MRPS23,24,,55927433
16,85711279,11309,GINS2,24,,85722588
8,29920527,20197,SARAF,24,,29940724
19,2321519,7095,LSM7,24,,2328614
9,35829221,25623,TMEM8B,24,,35854844
19,10623417,5251,S1PR5,24,,10628668
16,2732494,26537,KCTD5,24,,2759031
16,68344876,46293,PRMT7,24,,68391169
5,55033844,79130,DDX4,24,,55112974
2,234621637,60308,UGT1A5,24,,234681945
11,35684299,148304,TRIM44,24,,35832603
10,74092587,22320,DNAJB12,24,,74114907
X,71424506,34352,ERCC6L,24,,71458858
7,158423860,73662,NCAPG2,24,,158497522
11,61197596,16643,SDHAF2,24,,61214239
12,10756788,9420,MAGOHB,24,,10766208
17,46018888,7786,PNPO,24,,46026674
3,135867759,45551,MSL2,24,,135913310
4,122748881,42771,BBS7,24,,122791652
X,152713122,22967,HAUS7,24,,152736089
11,126138934,9093,FOXRED1,24,,126148027
18,72166822,23867,CNDP2,24,,72190689
1,211432707,57018,RCOR3,24,,211489725
20,53092010,175700,DOK5,24,,53267710
7,55433140,68295,LANCL2,24,,55501435
16,5121809,15571,ALG1,24,,5137380
1,240255184,383305,FMN2,24,,240638489
17,61822609,28479,CCDC47,24,,61851088
12,50898767,243683,DIP2B,24,,51142450
4,170015406,176843,SH3RF1,24,,170192249
20,44689625,28955,NCOA5,24,,44718580
1,41972035,412343,HIVEP3,24,,42384378
12,96051582,132954,NTN4,24,,96184536
11,105948291,21128,AASDHPPT,24,,105969419
X,41306712,28193,NYX,24,,41334905
7,127667123,3879,LRRC4,24,,127671002
2,219528586,8195,RNF25,24,,219536781
7,47314751,306991,TNS3,24,,47621742
21,35445822,69512,MRPS6,24,,35515334
11,66202545,3774,MRPL11,24,,66206319
2,224822120,10311,MRPL44,24,,224832431
1,1682670,27627,NADK,24,,1710297
16,1821895,1245,MRPS34,24,,1823140
19,15783827,24157,CYP4F12,24,,15807984
8,11141999,43655,MTMR9,24,,11185654
19,17420336,13770,DDA1,24,,17434106
12,102467966,45943,NUP37,24,,102513909
2,25015983,29262,CENPO,24,,25045245
X,80369199,88242,HMGN5,24,,80457441
11,8127596,62994,RIC3,24,,8190590
5,148361712,81025,SH3TC2,24,,148442737
1,6615337,24480,TAS1R1,24,,6639817
10,104404251,13825,TRIM8,24,,104418076
2,30454396,28503,LBH,24,,30482899
5,33523639,368658,ADAMTS12,24,,33892297
1,157483166,39144,FCRL5,24,,157522310
8,140739967,727894,TRAPPC9,24,,141467861
11,66432464,12928,RBM4B,24,,66445392
X,132159506,2794,USP26,24,,132162300
1,185703682,456403,HMCN1,24,,186160085
13,41765540,3171,KBTBD7,24,,41768711
19,8554939,12599,PRAM1,24,,8567538
5,72861565,17637,UTP15,24,,72879202
17,36452988,26113,MRPL45,24,,36479101
2,106682112,12497,C2orf40,24,,106694609
6,100367785,74314,M2,24,,100442099
16,1401899,11453,GNPTG,24,,1413352
16,4853203,44100,GLYR1,24,,4897303
22,41855720,8988,PHF5A,24,,41864708
12,110437234,40001,ANKRD13A,24,,110477235
12,78225068,381724,NAV3,24,,78606792
1,180199432,44756,LHX4,24,,180244188
11,46299188,43784,CREB3L1,24,,46342972
17,19990334,227738,SPECC1,24,,20218072
2,38790327,39851,HNRNPLL,24,,38830178
4,8271491,37347,HTRA3,24,,8308838
5,53813592,28824,SNX18,24,,53842416
20,45313003,5273,TP53RK,24,,45318276
15,63413998,9672,LACTB,24,,63423670
2,153191750,314598,FMNL2,24,,153506348
1,205882176,30412,SLC26A9,24,,205912588
X,154487518,6356,RAB39B,24,,154493874
12,32654976,144008,FGD4,24,,32798984
6,147525493,186119,STXBP5,24,,147711612
6,126111908,141268,NCOA7,24,,126253176
12,77415025,44335,E2F7,24,,77459360
17,72690446,18693,CD300LF,24,,72709139
9,36136532,27378,GLIPR2,24,,36163910
8,22570764,214657,PEBP4,24,,22785421
9,14734663,44868,FREM1,24,,14779531
10,70587293,65523,STOX1,24,,70652816
13,21727733,23008,SKA3,24,,21750741
7,44617493,4401,TMED4,24,,44621894
13,28120049,74671,LNX2,24,,28194720
4,17882217,141281,LCORL,24,,18023498
1,113933474,295071,MAGI3,24,,114228545
15,38746327,33584,FAM98B,24,,38779911
1,12907229,1380,HNRNPCL1,24,,12908609
1,152573137,425,LCE3C,24,,152573562
1,10490158,12714,APITD1,24,,10502872
6,126660934,9087,CENPW,24,,126670021
3,52302293,84,MIRLET7G,24,,52302377
2,136422966,82,MIR128-1,24,,136423048
2,219267368,77,MIR26B,24,,219267445
16,16326388,62280,NOMO3,24,,16388668
19,54291958,69,MIR373,24,,54292027
1,32095462,14756,PEF1,24,,32110218
8,6873390,2433,DEFA1B,24,,6875823
19,58858171,6694,A1BG,23,,58864865
6,106959729,58595,AIM1,23,,107018324
X,2852672,29822,ARSE,23,,2882494
19,1241748,3076,ATP5D,23,,1244824
17,46970147,3085,ATP5G1,23,,46973232
19,40953690,18035,BLVRB,23,,40971725
16,2479394,29465,CCNF,23,,2508859
5,115140429,11976,CDO1,23,,115152405
16,22357256,28682,CDR2,23,,22385938
1,241792166,7066,CHML,23,,241799232
2,233404436,6602,CHRNG,23,,233411038
6,35762758,2363,CLPS,23,,35765121
10,71561643,157261,COL13A1,23,,71718904
17,13972718,139278,COX10,23,,14111996
10,101470624,21799,COX15,23,,101492423
5,122847792,104946,CSNK1G3,23,,122952738
6,31973412,3274,CYP21A1P,23,,31976686
19,42751712,7604,ERF,23,,42759316
17,74002925,20608,EVPL,23,,74023533
8,28558989,52218,EXTL3,23,,28611207
13,102373204,195791,FGF14,23,,102568995
8,17721899,31148,FGL1,23,,17753047
11,64008603,3004,FKBP2,23,,64011607
19,52298398,31045,FPR3,23,,52329443
17,42634811,3819,FZD2,23,,42638630
X,151121595,21556,GABRE,23,,151143151
6,89964185,60833,GABRR2,23,,90025018
8,95261484,13063,GEM,23,,95274547
14,54941208,14536,GMFB,23,,54955744
11,62475065,1613,GNG3,23,,62476678
6,30509154,16217,GNL1,23,,30525371
X,13789040,167903,GPM6B,23,,13956943
10,120352915,2245,PRLHR,23,,120355160
1,53068042,6681,GPX7,23,,53074723
4,93225549,1470157,GRID2,23,,94695706
4,71681498,23722,GRSF1,23,,71705220
19,544033,5887,GZMM,23,,549920
4,3443659,7563,HGFAC,23,,3451222
19,46367517,9538,FOXA3,23,,46377055
12,54393902,3218,HOXC9,23,,54397120
1,161575848,2493,HSPA7,23,,161578341
10,1085359,9947,IDI1,23,,1095306
9,21140630,1270,IFNW1,23,,21141900
17,80477593,84890,FOXK2,23,,80562483
15,41786055,9702,ITPKA,23,,41795757
2,233630511,10764,KCNJ13,23,,233641275
17,73521782,39022,LLGL2,23,,73560804
X,151918386,4022,MAGEA2,23,,151922408
14,39735501,84896,CTAGE5,23,,39820397
3,158288952,35297,MLF1,23,,158324249
6,39872033,30257,MOCS1,23,,39902290
1,19970207,14742,NBL1,23,,19984949
5,140024947,2423,NDUFA2,23,,140027370
22,42481529,5359,NDUFA6,23,,42486888
19,14676889,6000,NDUFB7,23,,14682889
20,21491659,3005,NKX2-2,23,,21494664
14,24563339,6623,PCK2,23,,24569962
12,54943176,29847,PDE1B,23,,54973023
11,61008647,10268,PGA5,23,,61018915
16,47495209,240225,PHKB,23,,47735434
18,61637262,16625,SERPINB8,23,,61653887
1,156737273,33336,PRCC,23,,156770609
8,79428335,89167,PKIA,23,,79517502
11,64556572,14154,MAP4K2,23,,64570726
2,161128661,221657,RBMS1,23,,161350318
13,37393338,10402,RFXAP,23,,37403740
19,51226604,2377,CLEC11A,23,,51228981
10,103370420,84323,FBXW4,23,,103454743
21,35445822,32739,SLC5A3,23,,35478561
13,112721912,4108,SOX1,23,,112726020
1,151148775,13914,VPS72,23,,151162689
X,37698088,8801,DYNLT3,23,,37706889
6,35441373,23488,TEAD3,23,,35464861
1,151512780,43279,TUFT1,23,,151556059
11,123594634,17757,ZNF202,23,,123612391
16,21208772,17059,ZP2,23,,21225831
6,31629005,5055,GPANK1,23,,31634060
14,91698875,11977,GPR68,23,,91710852
X,153706107,1489,LAGE3,23,,153707596
6,27839622,477,HIST1H3I,23,,27840099
6,26271145,467,HIST1H3G,23,,26271612
6,27777841,473,HIST1H3H,23,,27778314
17,36921943,34215,PIP4K2B,23,,36956158
1,169337116,28664,BLZF1,23,,169365780
19,3178735,1595,S1PR4,23,,3180330
11,66330934,5113,CTSF,23,,66336047
4,142944312,823376,INPP4B,23,,143767688
8,21900263,6056,FGF17,23,,21906319
7,141695678,110869,MGAM,23,,141806547
1,178818669,21546,ANGPTL1,23,,178840215
16,3062456,2050,CLDN9,23,,3064506
17,80186281,11094,SLC16A3,23,,80197375
7,99699129,5674,AP4M1,23,,99704803
Y,2354454,14126,ZBED1,23,,2368580
1,35734567,152978,ZMYM4,23,,35887545
7,45139698,11648,TBRG4,23,,45151346
14,74178485,2643,PNMA1,23,,74181128
19,41171811,24752,NUMBL,23,,41196563
3,50400043,140985,CACNA2D2,23,,50541028
15,75212616,17879,COX5A,23,,75230495
3,142838617,4239,CHST2,23,,142842856
3,15295862,87039,SH3BP5,23,,15382901
19,39818996,7730,GMFG,23,,39826726
16,48572636,71484,N4BP1,23,,48644120
2,11674241,108671,GREB1,23,,11782912
2,20232410,19379,LAPTM4A,23,,20251789
17,7239847,14946,ACAP1,23,,7254793
7,29959718,70016,SCRN1,23,,30029734
3,49761727,62246,IP6K1,23,,49823973
21,33683329,81983,URB1,23,,33765312
2,27873675,13032,SUPT7L,23,,27886707
18,9546788,67817,PPP4R1,23,,9614605
10,99079021,2651,FRAT1,23,,99081672
3,51976320,6563,PARP3,23,,51982883
15,75890423,28023,SNUPN,23,,75918446
1,47649260,6511,PDZK1IP1,23,,47655771
3,49977476,137209,RBM6,23,,50114685
2,68269331,20828,C1D,23,,68290159
6,25962916,24641,TRIM38,23,,25987557
7,80371853,176814,SEMA3C,23,,80548667
11,65337929,1430,SSSCA1,23,,65339359
1,145590666,20378,POLR3C,23,,145611044
1,185265521,20940,IVNS1ABP,23,,185286461
8,26362195,9288,PNMA2,23,,26371483
11,94800040,4347,SRSF8,23,,94804387
19,55085297,13731,LILRA2,23,,55099028
10,45471708,2622,C10orf10,23,,45474330
6,26402464,12980,BTN3A1,23,,26415444
1,145695797,19842,CD160,23,,145715639
14,76117232,10306,C14orf1,23,,76127538
12,56989379,40784,BAZ2A,23,,57030163
3,99566766,266591,FILIP1L,23,,99833357
X,21392415,280398,CNKSR2,23,,21672813
16,89939993,37799,TCF25,23,,89977792
14,76127550,293875,TTLL5,23,,76421425
3,129274055,51527,PLXND1,23,,129325582
11,118478305,50443,PHLDB1,23,,118528748
1,224301788,47961,FBXO28,23,,224349749
13,99445740,184598,DOCK9,23,,99630338
1,156219014,33606,SMG5,23,,156252620
5,140071010,7893,HARS2,23,,140078903
1,6281252,14792,ICMT,23,,6296044
20,30795695,30772,POFUT1,23,,30826467
16,8946798,15460,CARHSP1,23,,8962258
7,32524944,9926,LSM5,23,,32534870
16,68279246,15715,PLA2G15,23,,68294961
2,223916647,3710,KCNE4,23,,223920357
22,32014476,12334,PISD,23,,32026810
2,163200582,19036,GCA,23,,163219618
6,74171453,39726,MTO1,23,,74211179
22,44220386,37992,SULT4A1,23,,44258378
11,120107348,83305,POU2F3,23,,120190653
11,118992232,13533,HINFP,23,,119005765
20,60718775,38791,SS18L1,23,,60757566
10,70748476,28263,KIAA1279,23,,70776739
9,128024072,103218,GAPVD1,23,,128127290
9,123519253,36487,FBXW2,23,,123555740
11,62382767,6880,B3GAT3,23,,62389647
5,136953188,103811,KLHL3,23,,137056999
13,51935700,91575,INTS6,23,,52027275
X,102631250,1842,NGFRAP1,23,,102633092
10,85899184,14127,GHITM,23,,85913311
19,43964945,4886,LYPD3,23,,43969831
8,42231585,3089,DKK4,23,,42234674
3,150259779,4649,SERP1,23,,150264428
8,55047780,13294,MRPL15,23,,55061074
2,220363586,8132,GMPPA,23,,220371718
10,52559168,86267,A1CF,23,,52645435
16,1031807,5172,SOX8,23,,1036979
19,51532347,5801,KLK12,23,,51538148
6,155716501,60536,NOX3,23,,155777037
15,48431624,38934,MYEF2,23,,48470558
19,51162513,57682,SHANK1,23,,51220195
10,75008600,3851,MRPS16,23,,75012451
2,32092878,142855,MEMO1,23,,32235733
X,128937263,40298,ZDHHC9,23,,128977561
11,45950869,192116,PHF21A,23,,46142985
20,20015004,21686,CRNKL1,23,,20036690
X,21857655,45886,MBTPS2,23,,21903541
16,69373414,3599,NIP7,23,,69377013
8,130851838,100280,FAM49B,23,,130952118
20,13694968,70611,ESF1,23,,13765579
7,43966034,29701,UBE2D4,23,,43995735
1,202931000,5404,CYB5R1,23,,202936404
5,130759613,211316,RAPGEF6,23,,130970929
17,1397870,22312,INPP5K,23,,1420182
6,137321107,44342,IL20RA,23,,137365449
10,26223001,278464,MYO3A,23,,26501465
15,64457715,190743,CSNK1G1,23,,64648458
21,40668362,17350,BRWD1,23,,40685712
21,26957967,21834,MRPL39,23,,26979801
8,50822285,886931,SNTG1,23,,51709216
12,19282625,243977,PLEKHA5,23,,19526602
10,94586587,232664,EXOC6,23,,94819251
3,122399671,50016,PARP14,23,,122449687
19,46195740,11508,QPCTL,23,,46207248
15,62156504,196160,VPS13C,23,,62352664
20,61826781,20757,YTHDF1,23,,61847538
7,766337,59779,HEATR2,23,,826116
16,69151911,14582,CHTF8,23,,69166493
9,33817181,103220,UBE2R2,23,,33920401
3,101280679,4611,TRMT10C,23,,101285290
4,48833243,30591,OCIAD1,23,,48863834
1,1309109,1471,AURKAIP1,23,,1310580
14,23369853,18543,RBM23,23,,23388396
9,108456805,82087,TMEM38B,23,,108538892
16,74655296,45483,RFWD3,23,,74700779
4,41937136,25688,TMEM33,23,,41962824
18,33709836,48049,ELP2,23,,33757885
1,85483764,30459,MCOLN3,23,,85514223
4,25235652,45179,PI4K2B,23,,25280831
8,6565877,53144,AGPAT5,23,,6619021
12,102271104,46297,DRAM1,23,,102317401
7,94536948,388779,PPP1R9A,23,,94925727
22,18560759,13038,PEX26,23,,18573797
2,128238382,45705,IWS1,23,,128284087
12,100661161,74341,SCYL2,23,,100735502
22,46731297,21940,TRMU,23,,46753237
1,6694227,67739,DNAJC11,23,,6761966
3,10157332,11542,BRK1,23,,10168874
1,155305051,227273,ASH1L,23,,155532324
7,107221203,42559,BCAP29,23,,107263762
7,23145352,69686,KLHL7,23,,23215038
19,3185874,23699,NCLN,23,,3209573
14,56585092,182939,PELI2,23,,56768031
1,154916558,12081,PBXIP1,23,,154928639
16,4511677,13219,NMRAL1,23,,4524896
1,151254787,9594,ZNF687,23,,151264381
6,151685249,27586,ZBTB2,23,,151712835
20,33543637,46603,MYH7B,23,,33590240
1,238045676,8546,ZP4,23,,238054222
17,73269060,16470,SLC25A19,23,,73285530
X,65815481,43659,EDA2R,23,,65859140
20,35201875,20480,TGIF2,23,,35222355
1,156611739,17585,BCAN,23,,156629324
16,838621,9453,CHTF18,23,,848074
4,103182820,83835,SLC39A8,23,,103266655
2,238482964,16805,RAB17,23,,238499769
12,118814357,41483,SUDS3,23,,118855840
3,15090018,16826,MRPS25,23,,15106844
16,58426297,13751,GINS3,23,,58440048
2,160568967,56127,7-Mar,23,,160625094
5,112849358,81626,YTHDC2,23,,112930984
5,68389775,10792,SLC30A5,23,,68400567
9,140446308,699,MRPL41,23,,140447007
8,81398447,40053,ZBTB10,23,,81438500
11,77811987,38712,ALG8,23,,77850699
16,3074031,3725,THOC6,23,,3077756
12,12224401,28226,BCL2L14,23,,12252627
X,119059012,18723,NKAP,23,,119077735
13,79188420,44894,RNF219,23,,79233314
19,17666402,27569,COLGALT1,23,,17693971
2,39005326,3780,GEMIN6,23,,39009106
X,110924345,7682,ALG13,23,,110932027
X,102840412,2252,TCEAL4,23,,102842664
3,169805367,94170,PHC3,23,,169899537
4,78978723,389064,FRAS1,23,,79367787
3,63819545,30054,THOC7,23,,63849599
2,232070912,169678,ARMC9,23,,232240590
12,132413797,14609,PUS1,23,,132428406
13,60971426,176587,TDRD3,23,,61148013
2,85360582,176929,TCF7L1,23,,85537511
5,176732500,6792,MXD3,23,,176739292
3,122246759,36388,PARP9,23,,122283147
5,81267843,283373,ATG10,23,,81551216
17,28443824,69669,NSRP1,23,,28513493
2,219472487,29422,PLCD4,23,,219501909
10,71872022,20668,AIFM2,23,,71892690
22,38302154,36311,MICALL1,23,,38338465
14,81726993,166755,STON2,23,,81893748
17,33677328,23392,SLFN11,23,,33700720
1,78354199,55379,NEXN,23,,78409578
4,164047859,40214,NAF1,23,,164088073
4,71768056,85835,MOB1B,23,,71853891
16,30960404,5855,ORAI3,23,,30966259
19,49557530,1467,CGB7,23,,49558997
11,6340175,1565,PRKCDBP,23,,6341740
2,132233579,6928,TUBA3D,23,,132240507
19,15579456,10859,PGLYRP2,23,,15590315
3,31702316,321026,OSBPL10,23,,32023342
6,41514163,55959,FOXP4,23,,41570122
21,34442449,2279,OLIG1,23,,34444728
5,147258273,3483,SCGB3A2,23,,147261756
17,33336130,54629,RFFL,23,,33390759
16,70284133,1700,EXOSC6,23,,70285833
16,88636788,61584,ZC3H18,23,,88698372
17,72912175,7183,USH1G,23,,72919358
17,43237540,9867,HEXIM2,23,,43247407
6,42018250,30394,TAF8,23,,42048644
2,19551245,7127,OSR1,23,,19558372
4,5564145,147130,EVC2,23,,5711275
X,129518318,1193,GPR119,23,,129519511
8,7693992,4772,DEFB104A,23,,7698764
1,198126107,165441,NEK7,23,,198291548
20,15177503,856338,MACROD2,23,,16033841
5,65440045,39399,SREK1,23,,65479444
12,39046001,253419,CPNE8,23,,39299420
17,76126858,12191,TMC8,23,,76139049
3,122283184,10865,DTX3L,23,,122294049
7,155437202,136977,RBM33,23,,155574179
17,42082031,4405,NAGS,23,,42086436
1,179809101,37840,TOR1AIP2,23,,179846941
14,24787554,16723,ADCY4,23,,24804277
3,93698982,75540,ARL13B,23,,93774522
6,46820241,69473,GPR116,23,,46889714
1,201103898,36812,TMEM9,23,,201140710
1,168148082,13551,TIPRL,23,,168161633
12,117890816,515212,KSR2,23,,118406028
14,74706174,23267,VSX2,23,,74729441
1,152586286,288,LCE3B,23,,152586574
1,152184551,12121,HRNR,23,,152196672
6,11102721,9350,ERVFRD-1,23,,11112071
3,44155703,99,MIR138-1,23,,44155802
17,1953564,110,MIR212,23,,1953674
8,22102474,82,MIR320A,23,,22102556
5,149112387,66,MIR378A,23,,149112453
16,14397823,83,MIR193B,23,,14397906
X,133680357,71,MIR503,23,,133680428
4,100125878,14525,ADH6,22,,100140403
7,44143959,10205,AEBP1,22,,44154164
9,34329503,14208,NUDT2,22,,34343711
12,14982244,14169,ART4,22,,14996413
19,36041094,13466,ATP4A,22,,36054560
20,57603732,3690,ATP5E,22,,57607422
9,93976096,148110,AUH,22,,94124206
16,89238162,23738,CDH15,22,,89261900
5,89689151,16452,CETN3,22,,89705603
19,43084394,14688,CEACAM8,22,,43099082
1,16348485,12060,CLCNKA,22,,16360545
1,10509775,2285,CORT,22,,10512060
8,100890222,16020,COX6C,22,,100906242
6,75947390,6254,COX7A2,22,,75953644
9,131857072,15998,CRAT,22,,131873070
14,105939274,7233,CRIP2,22,,105946507
17,61949371,1718,CSH2,22,,61951089
4,71108332,8813,CSN3,22,,71117145
5,10679341,82046,DAP,22,,10761387
16,66754798,30727,DYNC1LI2,22,,66785525
X,152907896,8885,DUSP9,22,,152916781
17,40852292,44822,EZH1,22,,40897114
15,41056284,3627,GCHFR,22,,41059911
11,59596745,16229,GIF,22,,59612974
3,46062290,6689,XCR1,22,,46068979
12,21689122,68659,GYS2,22,,21757781
X,11129405,11799,HCCS,22,,11141204
7,27145808,13406,HOXA3,22,,27159214
2,177016112,1837,HOXD4,22,,177017949
2,176972083,2233,HOXD11,22,,176974316
5,149887673,50100,NDST1,22,,149937773
4,70916131,8434,HTN1,22,,70924565
6,87647023,79374,HTR1E,22,,87726397
17,41158741,7735,IFI35,22,,41166476
1,156810664,18048,INSRR,22,,156828712
14,93406067,176197,ITPK1,22,,93582264
11,17757494,47108,KCNC1,22,,17804602
19,50818764,13870,KCNC3,22,,50832634
22,37415682,10181,MPST,22,,37425863
X,154292308,7239,MTCP1,22,,154299547
19,8585673,56658,MYO1F,22,,8642331
17,10531842,28784,MYH3,22,,10560626
14,26915088,151872,NOVA1,22,,27066960
7,98246596,12585,NPTX2,22,,98259181
17,3576521,23177,P2RX5,22,,3599698
5,141242216,6976,PCDH1,22,,141249192
19,18318770,40240,PDE4C,22,,18359010
10,95372344,53085,PDE6C,22,,95425429
7,44102325,2861,PGAM2,22,,44105186
X,71798663,135366,PHKA1,22,,71934029
16,30759619,12878,PHKG2,22,,30772497
X,71401525,82289,PIN4,22,,71483814
4,147560044,3579,POU4F2,22,,147563623
1,203444882,15597,PRELP,22,,203460479
18,48086483,171713,MAPK4,22,,48258196
1,117452544,80436,PTGFRN,22,,117532980
14,24734743,6090,RABGGTA,22,,24740833
14,102695157,76380,MOK,22,,102771537
4,3315873,118031,RGS12,22,,3433904
1,201951765,23510,RNPEP,22,,201975275
11,62380212,2380,ROM1,22,,62382592
11,1968501,9338,MRPL23,22,,1977839
12,56510373,1243,RPL41,22,,56511616
19,39421593,2066,MRPS12,22,,39423659
4,166248817,15497,MSMO1,22,,166264314
12,329786,42253,SLC6A13,22,,372039
10,98757794,187889,SLIT1,22,,98945683
1,153003678,1698,SPRR1B,22,,153005376
9,136197542,5505,SURF6,22,,136203047
6,31126302,5690,TCF19,22,,31131992
4,166794409,157702,TLL1,22,,166952111
X,99882104,9625,TSPAN6,22,,99891729
6,83073960,3173,TPBG,22,,83077133
22,45680867,10888,UPK3A,22,,45691755
18,5289017,7177,ZBTB14,22,,5296194
12,133707213,28836,ZNF10,22,,133736049
19,52074489,18502,ZNF175,22,,52092991
15,83328032,50628,AP3B2,22,,83378660
18,42792946,470114,SLC14A2,22,,43263060
X,154686574,1702,F8A1,22,,154688276
3,15491639,71619,COLQ,22,,15563258
6,27833106,470,HIST1H2AL,22,,27833576
16,30003641,3776,HIRIP3,22,,30007417
17,1537151,11932,SCARF1,22,,1549083
4,2939663,25570,NOP14,22,,2965233
1,161141099,6659,B4GALT3,22,,161147758
6,33244916,1686,B3GALT4,22,,33246602
18,21032786,30313,RIOK3,22,,21063099
12,123199302,2137,HCAR3,22,,123201439
1,168250277,33387,TBX19,22,,168283664
12,52817853,10257,KRT75,22,,52828110
2,219433302,27856,RQCD1,22,,219461158
22,39745953,35640,SYNGR1,22,,39781593
1,161090768,11710,DEDD,22,,161102478
20,48249482,80939,B4GALT5,22,,48330421
6,6588933,66283,LY86,22,,6655216
7,102937872,17261,PMPCB,22,,102955133
6,134273307,35331,TBPL1,22,,134308638
12,123011808,99139,KNTC1,22,,123110947
13,25875665,40896,NUPL1,22,,25916561
14,21945334,21987,TOX4,22,,21967321
12,56710006,17527,PAN2,22,,56727533
10,115594482,19681,DCLRE1A,22,,115614163
14,93260575,45731,GOLGA5,22,,93306306
22,19023794,86173,DGCR2,22,,19109967
9,130500595,24124,SH2D3C,22,,130524719
2,98272401,8160,ACTR1B,22,,98280561
16,71560153,12340,CHST4,22,,71572493
1,167022072,37796,GPA33,22,,167059868
7,100303675,1448,POP7,22,,100305123
7,93622553,11141,BET1,22,,93633694
16,31119614,4498,BCKDK,22,,31124112
2,211295972,45457,LANCL1,22,,211341429
16,75327607,139780,CFDP1,22,,75467387
7,120988904,47518,FAM3C,22,,121036422
18,47309873,30378,ACAA2,22,,47340251
22,41165633,49770,SLC25A17,22,,41215403
17,58520509,83092,APPBP2,22,,58603601
14,75988783,24551,BATF,22,,76013334
2,62423261,28605,B3GNT2,22,,62451866
6,96463844,199644,FUT9,22,,96663488
6,41737913,9730,FRS3,22,,41747643
19,36393381,1792,HCST,22,,36395173
1,196857143,30700,CFHR4,22,,196887843
7,150773707,4263,FASTK,22,,150777970
11,16760147,19754,C11orf58,22,,16779901
19,48885826,8984,KDELR1,22,,48894810
21,18965967,19301,BTG3,22,,18985268
11,86511281,10992,PRSS23,22,,86522273
6,26458131,11750,BTN2A1,22,,26469881
12,26205490,20317,RASSF8,22,,26225807
X,115567746,24879,SLC6A14,22,,115592625
3,149530474,149451,RNF13,22,,149679925
2,165536694,161984,COBLL1,22,,165698678
10,23384426,26516,MSRB2,22,,23410942
19,17712136,86872,UNC13A,22,,17799008
10,75001713,5376,DNAJC9,22,,75007089
22,41697506,58645,ZC3H7B,22,,41756151
19,7504573,32798,ARHGEF18,22,,7537371
22,24666784,146924,SPECC1L,22,,24813708
16,83932729,17058,MLYCD,22,,83949787
16,57279037,8508,ARL2BP,22,,57287545
1,167885912,20395,MPC2,22,,167906307
17,65713948,26376,NOL11,22,,65740324
19,11274942,33301,KANK2,22,,11308243
2,201170984,176002,SPATS2L,22,,201346986
15,69452935,111609,GLCE,22,,69564544
3,55542338,960053,ERC2,22,,56502391
19,34663351,57069,LSM14A,22,,34720420
19,46386864,2564,IRF2BP1,22,,46389428
13,77579388,21943,FBXL3,22,,77601331
18,21718919,22645,CABYR,22,,21741564
17,80416059,30084,NARF,22,,80446143
11,57295935,2297,TIMM10,22,,57298232
9,34458749,62238,DNAI1,22,,34520987
16,88705000,1882,IL17C,22,,88706882
1,173684079,71761,KLHL20,22,,173755840
X,55026755,7551,APEX2,22,,55034306
15,92396937,318728,SLCO3A1,22,,92715665
11,63766029,167556,MACROD1,22,,63933585
19,54610319,8736,TFPT,22,,54619055
1,226107576,4464,PYCR2,22,,226112040
6,35265594,23954,DEF6,22,,35289548
7,108110865,55897,PNPLA8,22,,108166762
1,74701070,309046,TNNI3K,22,,75010116
9,138392476,4043,MRPS2,22,,138396519
5,172386426,10348,RPL26L1,22,,172396774
20,19997933,16340,NAA20,22,,20014273
17,57936840,33466,TUBD1,22,,57970306
16,66586465,13725,CKLF,22,,66600190
3,119316694,31964,PLA1A,22,,119348658
11,118889178,5206,TRAPPC4,22,,118894384
11,73882107,83641,PPME1,22,,73965748
3,133543079,71612,RAB6B,22,,133614691
2,15307031,394441,NBAS,22,,15701472
11,73498916,76740,MRPL48,22,,73575656
9,132589563,8009,C9orf78,22,,132597572
5,125936606,26338,PHAX,22,,125962944
11,117707690,40511,FXYD6,22,,117748201
18,66340924,41429,TMX3,22,,66382353
5,54551882,51668,DHX29,22,,54603550
17,58755171,715028,BCAS3,22,,59470199
6,10980992,63632,ELOVL2,22,,11044624
3,58318616,93238,PXK,22,,58411854
8,38173934,65856,WHSC1L1,22,,38239790
16,72118755,9013,TXNL4B,22,,72127768
5,76326209,34849,AGGF1,22,,76361058
4,76871058,41057,SDAD1,22,,76912115
12,105567074,62934,APPL2,22,,105630008
7,150434435,6302,GIMAP5,22,,150440737
2,239146907,1858,HES6,22,,239148765
13,37583450,50400,SUPT20H,22,,37633850
2,96915945,15806,TMEM127,22,,96931751
7,4838739,84596,RADIL,22,,4923335
1,54231133,73092,NDC1,22,,54304225
10,122610686,58352,WDR11,22,,122669038
3,54156692,951892,CACNA2D3,22,,55108584
17,29248753,37458,ADAP2,22,,29286211
14,88851987,52817,SPATA7,22,,88904804
1,236378421,66918,ERO1LB,22,,236445339
8,40010986,1841,C8orf4,22,,40012827
6,292056,59299,DUSP22,22,,351355
2,228189866,32686,MFF,22,,228222552
15,81071683,172320,CEMIP,22,,81244003
16,67876212,1886,THAP11,22,,67878098
15,35044641,2141,GJD2,22,,35046782
5,65018022,107089,NLN,22,,65125111
4,88081255,60505,KLHL8,22,,88141760
19,19387321,44000,SUGP1,22,,19431321
19,48497907,30503,ELSPBP1,22,,48528410
17,80693451,15622,FN3K,22,,80709073
17,48423392,15154,XYLT2,22,,48438546
16,53524951,12265,AKTIP,22,,53537216
20,2821342,26036,VPS16,22,,2847378
7,99425635,38092,CYP3A43,22,,99463727
20,45186461,126663,SLC13A3,22,,45313124
9,130267616,73670,FAM129B,22,,130341286
1,36921361,8679,MRPS15,22,,36930040
4,78783804,90140,MRPL1,22,,78873944
9,33461350,12591,NOL6,22,,33473941
16,74746855,61874,FA2H,22,,74808729
6,150382181,8102,ULBP3,22,,150390283
9,88902647,66755,ZCCHC6,22,,88969402
17,80674581,11312,FN3KRP,22,,80685893
1,6581406,33252,NOL9,22,,6614658
11,790474,7521,SLC25A22,22,,797995
1,15898193,13412,AGMAT,22,,15911605
18,12672625,30151,CEP76,22,,12702776
6,151815174,127154,CCDC170,22,,151942328
5,178986692,50335,RUFY1,22,,179037027
14,24583905,10546,DCAF11,22,,24594451
7,150778171,2449,TMUB1,22,,150780620
17,3627196,2796,GSG2,22,,3629992
16,284544,31580,ITFG3,22,,316124
20,40030742,216391,CHD6,22,,40247133
16,2205798,22332,TRAF7,22,,2228130
1,66999638,217184,SGIP1,22,,67216822
1,233086276,28272,NTPCR,22,,233114548
10,102746026,1246,MRPL43,22,,102747272
10,116054582,109955,AFAP1L2,22,,116164537
3,108474485,1645,RETNLB,22,,108476130
22,20795805,54365,KLHL22,22,,20850170
15,30653442,32422,CHRFAM7A,22,,30685864
X,117031775,87601,KLHL13,22,,117119376
5,180650262,12546,TRIM41,22,,180662808
8,82644687,27061,CHMP4C,22,,82671748
3,53901093,15136,ACTR8,22,,53916229
1,45805341,4309,TOE1,22,,45809650
10,5406971,9684,UCN3,22,,5416655
6,38136226,471698,BTBD9,22,,38607924
X,101967103,5558,GPRASP2,22,,101972661
18,43684297,24002,HAUS1,22,,43708299
14,24759803,9236,DHRS1,22,,24769039
11,65784222,9766,CATSPER1,22,,65793988
12,59265936,47391,LRIG3,22,,59313327
19,54597932,8062,OSCAR,22,,54605994
19,50194364,22624,CPT1C,22,,50216988
19,49956472,17833,ALDH16A1,22,,49974305
1,35225341,3984,GJB4,22,,35229325
2,170336005,27160,BBS5,22,,170363165
2,158383278,70794,ACVR1C,22,,158454072
3,14153576,12795,CHCHD4,22,,14166371
5,55149149,64016,IL31RA,22,,55213165
20,34287231,1671,ROMO1,22,,34288902
10,28339922,231104,MPP7,22,,28571026
10,81272356,3836,EIF5AL1,22,,81276192
17,38375573,62866,WIPF2,22,,38438439
19,46268042,4455,SIX5,22,,46272497
2,201390864,57954,SGOL2,22,,201448818
9,36336398,63898,RNF38,22,,36400296
3,113161564,72470,SPICE1,22,,113234034
4,39408472,44681,KLB,22,,39453153
7,2577443,17949,BRAT1,22,,2595392
10,59951277,76417,IPMK,22,,60027694
16,18511181,62253,NOMO2,22,,18573434
17,6588031,28709,SLC13A5,22,,6616740
1,90460653,11355,ZNF326,22,,90472008
3,96533424,934362,EPHA6,22,,97467786
5,171760502,121025,SH3PXD2B,22,,171881527
21,17962556,89,MIR125B2,22,,17962645
3,49058050,92,MIR191,22,,49058142
1,75594118,33100,LHX8,22,,75627218
14,91737666,146522,CCDC88C,22,,91884188
1,1104384,83,MIR429,22,,1104467
12,54058943,11569,ATP5G2,21,,54070512
1,44440319,3653,ATP6V0B,21,,44443972
6,26501494,9158,BTN1A1,21,,26510652
20,25176305,32406,ENTPD6,21,,25208711
14,74429933,56093,ENTPD5,21,,74486026
12,120875892,2653,COX6A1,21,,120878545
20,23856571,3809,CST5,21,,23860380
8,6793341,2519,DEFA4,21,,6795860
19,46286263,9797,DMWD,21,,46296060
17,1933430,13295,DPH1,21,,1946725
1,168664694,33748,DPT,21,,168698442
12,4543307,11473,FGF6,21,,4554780
1,27992571,6153,IFI6,21,,27998724
1,1950767,11425,GABRD,21,,1962192
4,46037786,88296,GABRG1,21,,46126082
5,137588068,22185,GFRA3,21,,137610253
6,16238810,56970,GMPR,21,,16295780
19,35849487,1902,FFAR3,21,,35851389
10,87359311,766939,GRID1,21,,88126250
6,52761438,13058,GSTA3,21,,52774496
11,106544737,344434,GUCY1A2,21,,106889171
6,143072603,193735,HIVEP2,21,,143266338
1,33352097,8150,HPCA,21,,33360247
2,99061320,146176,INPP4A,21,,99207496
20,20348764,2828,INSM1,21,,20351592
12,53183468,6424,KRT3,21,,53189892
12,58162350,3564,METTL1,21,,58165914
16,56703725,1316,MT1H,21,,56705041
12,81110707,2740,MYF5,21,,81113447
20,62795826,77780,MYT1,21,,62873606
20,36149607,2483,NNAT,21,,36152090
16,1820320,1390,NME3,21,,1821710
7,135071821,123054,CNOT4,21,,135194875
17,29621667,2713,OMG,21,,29624380
14,23235730,5268,OXA1L,21,,23240998
8,128427856,1585,POU5F1B,21,,128429441
10,47083533,4787,NPY4R,21,,47088320
2,209271554,87677,PTH2R,21,,209359231
17,79860776,8577,PCYT2,21,,79869353
6,33259430,7735,RGL2,21,,33267165
9,3218296,307705,RFX3,21,,3526001
12,106994914,161668,RFX4,21,,107156582
3,133875977,93609,RYK,21,,133969586
1,153519808,1926,S100A3,21,,153521734
6,33218048,21694,VPS52,21,,33239742
1,162531295,38338,UAP1,21,,162569633
3,156257341,15648,SSR3,21,,156272989
3,44916097,39991,TGM4,21,,44956088
14,103592663,11113,TNFAIP2,21,,103603776
4,115519557,79824,UGT8,21,,115599381
Y,15360258,232292,UTY,21,,15592550
7,100805789,3063,VGF,21,,100808852
X,128872945,30580,XPNPEP2,21,,128903525
7,99613194,26118,ZKSCAN1,21,,99639312
17,30677156,20312,ZNF207,21,,30697468
19,44598481,15502,ZNF224,21,,44613983
3,57742982,172759,SLMAP,21,,57915741
6,27858092,478,HIST1H3J,21,,27858570
2,192699031,12975,SDPR,21,,192712006
22,26921713,39657,TPST2,21,,26961370
7,65670258,155180,TPST1,21,,65825438
7,72742154,30492,FKBP6,21,,72772646
2,39476406,188047,MAP4K3,21,,39664453
12,81651753,500721,PPFIA2,21,,82152474
2,220110176,4883,STK16,21,,220115059
1,44446176,10667,B4GALT2,21,,44456843
14,69517636,102278,DCAF5,21,,69619914
6,31939645,9578,STK19,21,,31949223
15,25200039,23831,SNURF,21,,25223870
1,205737113,7497,RAB29,21,,205744610
1,161551128,19882,FCGR2C,21,,161571010
X,16964813,206590,REPS2,21,,17171403
X,150345055,4882,GPR50,21,,150349937
15,43524792,34263,TGM5,21,,43559055
2,170440849,53405,PPIG,21,,170494254
17,71189172,15473,COG1,21,,71204645
2,46844310,13005,CRIPT,21,,46857315
17,62179,140454,RPH3AL,21,,202633
4,73146685,287831,ADAMTS3,21,,73434516
5,178537851,234580,ADAMTS2,21,,178772431
10,22634373,72166,SPAG6,21,,22706539
1,204042245,54626,SOX13,21,,204096871
11,67259238,13605,PITPNM1,21,,67272843
16,15688225,48798,KIAA0430,21,,15737023
3,108308336,105357,DZIP3,21,,108413693
7,143548460,50818,FAM115A,21,,143599278
8,97274113,72666,PTDSS1,21,,97346779
20,48519928,10348,SPATA2,21,,48530276
20,25388318,40873,GINS1,21,,25429191
4,119643977,113374,SEC24D,21,,119757351
11,72547789,305354,FCHSD2,21,,72853143
1,22778343,79307,ZBTB40,21,,22857650
15,75136070,29650,SCAMP2,21,,75165720
20,42193754,20519,SGK2,21,,42214273
12,123640942,76843,MPHOSPH9,21,,123717785
16,19079238,12179,COQ7,21,,19091417
11,64494382,17947,RASGRP2,21,,64512329
13,41303431,41916,MRPS31,21,,41345347
19,1450147,23096,APC2,21,,1473243
20,1545028,55712,SIRPB1,21,,1600740
5,74062815,9922,NSA2,21,,74072737
4,110354870,106745,SEC24B,21,,110461615
1,244212240,8540,ZBTB18,21,,244220780
1,46744071,24967,LRRC41,21,,46769038
2,74881354,29627,SEMA4F,21,,74910981
12,30781914,48264,IPO8,21,,30830178
10,15139178,7078,RPP38,21,,15146256
6,88182642,39415,SLC35A1,21,,88222057
17,15531279,54914,TRIM16,21,,15586193
17,33254877,33651,CCT6B,21,,33288528
9,139296373,8681,SDCCAG3,21,,139305054
4,72904848,109070,NPFFR2,21,,73013918
2,68870719,11989,PROKR1,21,,68882708
11,66052050,4588,YIF1A,21,,66056638
4,70454134,64833,UGT2A1,21,,70518967
1,151032150,8823,MLLT11,21,,151040973
19,15225784,10826,ILVBL,21,,15236610
17,35849950,23638,DUSP14,21,,35873588
6,26368405,10143,BTN3A2,21,,26378548
6,34254972,105485,NUDT3,21,,34360457
9,112810877,123914,AKAP2,21,,112934791
1,161719557,7397,DUSP12,21,,161726954
17,76108998,15877,TMC6,21,,76124875
1,230778201,51530,COG2,21,,230829731
13,114747193,150905,RASA3,21,,114898098
10,27293044,96383,ANKRD26,21,,27389427
9,99212436,41182,HABP4,21,,99253618
12,117581584,46716,FBXO21,21,,117628300
7,43152197,450741,HECW1,21,,43602938
13,47127295,191741,LRCH1,21,,47319036
15,81268085,14134,MESDC2,21,,81282219
5,15501546,438359,FBXL7,21,,15939905
16,28109297,113942,XPO6,21,,28223239
15,41952609,109532,MGA,21,,42062141
8,28924794,195816,KIF13B,21,,29120610
11,47738061,50969,FNBP4,21,,47789030
8,18384812,486384,PSD3,21,,18871196
12,120740123,10922,SIRT4,21,,120751045
1,229652328,42114,ABCB10,21,,229694442
17,67240575,71199,ABCA5,21,,67311774
6,64356430,68988,PHF3,21,,64425418
14,68213236,70070,ZFYVE26,21,,68283306
2,220236750,15912,DNPEP,21,,220252662
5,176449680,45303,ZNF346,21,,176494983
22,31721789,20460,PATZ1,21,,31742249
2,11798303,12026,NTSR2,21,,11810329
9,125703287,163860,RABGAP1,21,,125867147
X,140269930,1469,LDOC1,21,,140271399
11,6495912,6797,ARFIP2,21,,6502709
1,54691103,180965,SSBP3,21,,54872068
10,91174324,6435,IFIT5,21,,91180759
6,43303807,33374,ZNF318,21,,43337181
6,43479564,5164,YIPF3,21,,43484728
16,67312059,11344,PLEKHG4,21,,67323403
3,156392714,31843,TIPARP,21,,156424557
17,39078947,14948,KRT23,21,,39093895
3,15602210,41149,HACL1,21,,15643359
12,27091304,28277,FGFR1OP2,21,,27119581
7,102952920,32400,DNAJC2,21,,102985320
22,20099388,5430,TRMT2A,21,,20104818
6,136172833,343876,PDE7B,21,,136516709
14,63173290,338666,KCNH5,21,,63511956
X,48970322,9829,GPKOW,21,,48980151
22,42904340,11489,RRP7A,21,,42915829
X,48689501,4539,PCSK1N,21,,48694040
22,40766565,39728,SGSM3,21,,40806293
12,93861265,36283,MRPL42,21,,93897548
9,132371162,27248,NTMT1,21,,132398410
6,97337186,8581,NDUFAF4,21,,97345767
1,1477052,33210,SSU72,21,,1510262
3,51428698,6638,RBM15B,21,,51435336
1,63833260,70973,ALG6,21,,63904233
1,209848669,1066,G0S2,21,,209849735
2,131674223,130603,ARHGEF4,21,,131804826
1,218458628,52697,RRP15,21,,218511325
15,63445538,4203,RPS27L,21,,63449741
11,34903842,34116,APIP,21,,34937958
3,3168599,22107,TRNT1,21,,3190706
1,246887377,44063,SCCPDH,21,,246931440
12,110890290,16236,GPN3,21,,110906526
15,55473511,15720,RSL24D1,21,,55489231
11,2161741,8155,IGF2-AS,21,,2169896
15,65255361,26483,SPG21,21,,65281844
2,189156395,304257,GULP1,21,,189460652
11,82868136,28699,PCF11,21,,82896835
1,171750760,16096,METTL13,21,,171766856
10,5540657,876,CALML5,21,,5541533
22,17659679,40796,CECR1,21,,17700475
2,201735678,18171,PPIL3,21,,201753849
21,33640529,10847,MIS18A,21,,33651376
9,100818958,26407,NANS,21,,100845365
11,124505684,40515,SIAE,21,,124546199
7,105096947,65758,PUS7,21,,105162705
7,22852250,10221,TOMM7,21,,22862471
1,86115105,59011,ZNHIT6,21,,86174116
13,20207787,39812,MPHOSPH8,21,,20247599
19,1481426,9023,PCSK4,21,,1490449
1,155719448,109743,GON4L,21,,155829191
9,17134988,167061,CNTLN,21,,17302049
17,56429860,65083,RNF43,21,,56494943
17,56282796,14170,MKS1,21,,56296966
19,39405903,15633,SARS2,21,,39421536
15,66629007,20047,TIPIN,21,,66649054
3,41288089,715843,ULK4,21,,42003932
20,61569440,10387,GID8,21,,61579827
2,229888688,247369,PID1,21,,230136057
15,42841010,21180,HAUS2,21,,42862190
2,25962252,139060,ASXL2,21,,26101312
20,61427756,5334,MRGBP,21,,61433090
3,183903862,7933,ABCF3,21,,183911795
14,70833212,50595,SYNJ2BP,21,,70883807
4,113152894,41372,AP1AR,21,,113194266
19,4791727,3844,FEM1A,21,,4795571
3,133292433,16685,CDV3,21,,133309118
2,32853086,193032,TTC27,21,,33046118
7,43915492,31176,URGCP,21,,43946668
14,91923824,53000,SMEK1,21,,91976824
9,139702373,33266,RABL6,21,,139735639
1,220267454,53929,IARS2,21,,220321383
1,111489811,16755,LRIF1,21,,111506566
6,42192670,227119,TRERF1,21,,42419789
14,34985134,23809,EAPP,21,,35008943
10,133747959,25379,PPP2R2D,21,,133773338
22,42372930,21295,3-Sep,21,,42394225
X,101502093,79541,NXF2,21,,101581634
21,33664123,20476,MRAP,21,,33684599
9,139323066,11208,INPP5E,21,,139334274
17,5344231,28149,DHX33,21,,5372380
3,107241782,288394,BBX,21,,107530176
19,49932654,12154,SLC17A7,21,,49944808
3,51991469,10013,PCBP4,21,,52001482
15,25923859,184490,ATP10A,21,,26108349
20,35280168,94373,NDRG3,21,,35374541
8,135490030,218771,ZFAT,21,,135708801
13,70274724,407901,KLHL1,21,,70682625
17,27232270,46238,PHF12,21,,27278508
16,84328311,35146,WFDC1,21,,84363457
19,3610626,16187,CACTIN,21,,3626813
10,75391369,10146,MYOZ1,21,,75401515
14,77893017,30966,VIPAS39,21,,77923983
6,8013799,50848,BLOC1S5,21,,8064647
6,32158542,4758,GPSM3,21,,32163300
1,32042085,11202,TINAGL1,21,,32053287
3,15111575,29089,ZFYVE20,21,,15140664
1,156123321,24221,SEMA4A,21,,156147542
11,124735304,16066,ROBO3,21,,124751370
8,22436253,15557,PDLIM2,21,,22451810
5,72921982,315836,ARHGEF28,21,,73237818
13,21351467,125446,XPO4,21,,21476913
15,42704634,45131,ZNF106,21,,42749765
X,154255063,30128,FUNDC2,21,,154285191
2,202241929,74390,TRAK2,21,,202316319
4,110970228,149543,ELOVL6,21,,111119771
11,46958239,225559,C11orf49,21,,47183798
19,54677105,16628,MBOAT7,21,,54693733
7,127220681,4973,GCC1,21,,127225654
8,28747886,162901,HMBOX1,21,,28910787
16,58035276,20251,USB1,21,,58055527
1,45468219,8808,HECTD3,21,,45477027
9,27325206,204644,MOB3B,21,,27529850
13,73302041,28295,BORA,21,,73330336
2,106709758,101037,UXS1,21,,106810795
17,8128138,23275,CTC1,21,,8151413
19,41223007,23758,ITPKC,21,,41246765
5,173315330,72664,CPEB4,21,,173387994
5,143537722,12556,YIPF5,21,,143550278
9,127624396,15616,ARPC5L,21,,127640012
6,144416017,737,SF3B5,21,,144416754
19,30189792,16171,C19orf12,21,,30205963
6,7390061,28209,RIOK1,21,,7418270
19,33087906,78196,ANKRD27,21,,33166102
1,91380856,106209,ZNF644,21,,91487065
6,111303219,46247,RPF2,21,,111349466
1,21766582,44811,NBPF3,21,,21811393
19,13875327,9769,MRI1,21,,13885096
9,115142188,92497,HSDL2,21,,115234685
11,13409542,75302,BTBD10,21,,13484844
16,4743693,2167,NUDT16L1,21,,4745860
7,1036622,141271,C7orf50,21,,1177893
16,69362523,11003,COG8,21,,69373526
19,17448325,5215,GTPBP3,21,,17453540
X,102564273,1610,BEX2,21,,102565883
9,134305476,70099,PRRC2B,21,,134375575
11,18749474,63915,PTPN5,21,,18813389
12,109915427,13100,UBE3B,21,,109928527
6,43027594,15243,KLC4,21,,43042837
5,14664753,35206,OTULIN,21,,14699959
16,2047652,12170,ZNF598,21,,2059822
19,33463122,5279,C19orf40,21,,33468401
19,19144386,24601,ARMC6,21,,19168987
7,121958477,568336,CADPS2,21,,122526813
7,8008373,120336,GLCCI1,21,,8128709
2,154728410,582079,GALNT13,21,,155310489
1,52082545,172346,OSBPL9,21,,52254891
5,34017962,25409,C1QTNF3,21,,34043371
6,74134855,27188,MB21D1,21,,74162043
1,184760158,183560,FAM129A,21,,184943718
10,73975757,19861,ANAPC16,21,,73995618
14,51955838,241606,FRMD6,21,,52197444
1,198492351,17724,ATP6V1G3,21,,198510075
1,162466963,32456,UHMK1,21,,162499419
20,416120,27077,TBC1D20,21,,443197
20,33148345,116744,PIGU,21,,33265089
X,15262108,26185,ASB9,21,,15288293
18,23713815,59504,PSMA8,21,,23773319
13,31774111,132300,B3GALTL,21,,31906411
19,19649073,8395,CILP2,21,,19657468
3,73045935,72417,PPP4R2,21,,73118352
7,65338256,86294,VKORC1L1,21,,65424550
4,108814419,21785,SGMS2,21,,108836204
6,80194707,52440,LCA5,21,,80247147
12,7882010,20059,CLEC4C,21,,7902069
16,77316024,152987,ADAMTS18,21,,77469011
12,6775642,23096,ZNF384,21,,6798738
12,53231587,11191,KRT78,21,,53242778
17,70642084,446769,SLC39A11,21,,71088853
10,65281122,103761,REEP3,21,,65384883
11,43902356,39469,ALKBH3,21,,43941825
12,65672422,188265,MSRB3,21,,65860687
16,29917656,19897,KCTD13,21,,29937553
15,48413168,21421,SLC24A5,21,,48434589
17,38119225,14794,GSDMA,21,,38134019
2,101892062,33116,RNF149,21,,101925178
4,48499379,282937,FRYL,21,,48782316
17,38278789,14256,MSL1,21,,38293045
2,133429371,896660,NCKAP5,21,,134326031
15,90171200,27482,KIF7,21,,90198682
8,11994676,1593,USP17L2,21,,11996269
1,2460183,1501,HES5,21,,2461684
4,9360107,1593,USP17L9P,21,,9361700
1,41222955,89,MIR30C1,21,,41223044
7,38299243,14005,TARP,21,,38313248
2,242673993,34238,D2HGDH,21,,242708231
9,14510,15229,WASH1,21,,29739
12,10524951,37794,KLRC4-KLRK1,21,,10562745
3,151531860,14416,AADAC,20,,151546276
17,41476352,2152,ARL4D,20,,41478504
4,76995847,38108,ART3,20,,77033955
6,69345631,753772,BAI3,20,,70099403
12,122459791,40159,BCL7A,20,,122499950
4,141309606,39209,CLGN,20,,141348815
X,10124984,80715,CLCN4,20,,10205699
7,96635289,5063,DLX6,20,,96640352
12,51722226,18237,CELA1,20,,51740463
1,157094458,13925,ETV3,20,,157108383
1,146655883,41347,FMO5,20,,146697230
X,100354797,63865,CENPI,20,,100418662
12,50497601,7502,GPD1,20,,50505103
2,207040041,42730,GPR1,20,,207082771
2,241544824,25852,GPR35,20,,241570676
19,42502467,67490,GRIK5,20,,42569957
5,178405329,16795,GRM6,20,,178422124
13,27998680,11166,GTF3A,20,,28009846
5,54320106,9854,GZMK,20,,54329960
12,54378945,5117,HOXC10,20,,54384062
2,177053306,2329,HOXD1,20,,177055635
2,176964529,959,HOXD12,20,,176965488
X,48684922,3357,ERAS,20,,48688279
3,88031725,11256,HTR1F,20,,88042981
17,39519745,6307,KRT33B,20,,39526052
X,151867231,3594,MAGEA6,20,,151870825
X,30233674,4532,MAGEB2,20,,30238206
6,41606194,15788,MDFI,20,,41621982
17,19286754,3778,MFAP4,20,,19290532
7,130794854,386544,MKLN1,20,,131181398
16,88718347,11210,MVD,20,,88729557
17,10346607,26269,MYH4,20,,10372876
8,145654162,15650,TONSL,20,,145669812
10,115348582,75247,NRAP,20,,115423829
8,103563847,9398,ODF1,20,,103573245
14,60975937,2588,SIX6,20,,60978525
1,111956936,13463,OVGP1,20,,111970399
13,53418108,4667,PCDH8,20,,53422775
13,66876965,927503,PCDH9,20,,67804468
20,30780306,15240,PLAGL2,20,,30795546
X,49028183,3285,PLP2,20,,49031468
1,38509522,2928,POU3F1,20,,38512450
21,19641432,134538,TMPRSS15,20,,19775970
14,74751979,17788,ABCD4,20,,74769767
2,220492291,14411,SLC4A3,20,,220506702
17,7491497,1991,SOX15,20,,7493488
1,155978838,11920,SSR2,20,,155990758
21,45432205,94227,TRAPPC10,20,,45526432
3,33429828,52042,UBP1,20,,33481870
1,228109164,26512,WNT9A,20,,228135676
19,36705503,24172,ZNF146,20,,36729675
9,74966340,13823,ZFAND5,20,,74980163
1,31205314,25369,LAPTM5,20,,31230683
3,9773433,16266,BRPF1,20,,9789699
7,72848108,2342,FZD9,20,,72850450
X,38008587,71590,SRPX,20,,38080177
2,73989324,17960,DUSP11,20,,74007284
17,40834631,17380,CNTNAP1,20,,40852011
20,24929865,10699,CST7,20,,24940564
9,140083053,1769,SSNA1,20,,140084822
20,43922085,15084,MATN4,20,,43937169
19,40353962,86571,FCGBP,20,,40440533
5,172410762,51138,ATP6V0E1,20,,172461900
X,129473861,33474,SLC25A14,20,,129507335
Y,27768263,2785,CDY1,20,,27771048
1,12627938,49799,DHRS3,20,,12677737
7,72950682,21383,BCL7B,20,,72972065
10,16478941,76803,PTER,20,,16555744
X,78615880,7169,ITM2A,20,,78623049
22,39101806,27786,GTPBP1,20,,39129592
12,7842377,6012,GDF3,20,,7848389
10,91461346,73354,KIF20B,20,,91534700
7,26191846,34910,NFE2L3,20,,26226756
20,36611408,50462,TTI1,20,,36661870
1,17248444,51030,CROCC,20,,17299474
8,59717976,313791,TOX,20,,60031767
15,43619973,2847,LCMT2,20,,43622820
4,15937192,3171,FGFBP1,20,,15940363
12,58176527,14843,TSFM,20,,58191370
13,97874549,171825,MBNL2,20,,98046374
7,121713597,70747,AASS,20,,121784344
16,82181766,22063,MPHOSPH6,20,,82203829
2,220325533,6051,SPEG,20,,220331584
11,10594637,79211,MRVI1,20,,10673848
12,4724673,33540,AKAP3,20,,4758213
6,43193366,3845,DNPH1,20,,43197211
1,226073981,2865,LEFTY1,20,,226076846
15,52839241,22088,ARPP19,20,,52861329
5,133984474,44914,SEC24A,20,,134029388
18,77732866,15726,TXNL4A,20,,77748592
X,11776700,17172,MSL3,20,,11793872
14,74035762,6600,ACOT2,20,,74042362
11,57425215,4122,CLP1,20,,57429337
3,50242678,15733,SLC38A3,20,,50258411
17,35969789,33704,DDX52,20,,36003493
1,2323213,13672,RER1,20,,2336885
X,48932091,5473,WDR45,20,,48937564
8,125487007,13852,RNF139,20,,125500859
12,57388354,2115,GPR182,20,,57390469
15,31196075,7916,FAN1,20,,31203991
1,41492870,134234,SCMH1,20,,41627104
14,71374121,207978,PCNX,20,,71582099
13,109281570,578785,MYO16,20,,109860355
1,235315802,8769,RBM34,20,,235324571
12,62860596,130767,MON2,20,,62991363
1,19542157,35896,EMC1,20,,19578053
6,110931180,205339,CDK19,20,,111136519
3,32148002,62205,GPD1L,20,,32210207
21,47878861,88259,DIP2A,20,,47967120
2,136499188,43445,UBXN4,20,,136542633
1,155829259,25731,SYT11,20,,155854990
1,15272414,122237,KAZN,20,,15394651
1,82266081,192341,LPHN2,20,,82458422
10,101635327,134383,DNMBP,20,,101769710
3,56654159,62976,FAM208A,20,,56717135
12,105501491,61421,KIAA1033,20,,105562912
6,96969701,33450,UFL1,20,,97003151
22,26565439,214124,SEZ6L,20,,26779563
9,90581358,8337,CDK20,20,,90589695
7,120427373,70804,TSPAN12,20,,120498177
10,26986352,49374,PDSS1,20,,27035726
22,22020272,31930,PPIL2,20,,22052202
22,45148437,110227,ARHGAP8,20,,45258664
2,233743395,49466,NGEF,20,,233792861
17,79495416,8740,FSCN2,20,,79504156
3,33318936,109821,FBXL2,20,,33428757
12,86373036,859645,MGAT4C,20,,87232681
8,104426941,28739,DCAF13,20,,104455680
3,39850404,451407,MYRIP,20,,40301811
8,95500004,65742,KIAA1429,20,,95565746
17,21030240,65045,DHRS7B,20,,21095285
20,34824338,20525,AAR2,20,,34844863
11,61100653,15578,DAK,20,,61116231
1,203463270,14807,OPTC,20,,203478077
2,97426638,50990,CNNM4,20,,97477628
1,40089102,16246,HEYL,20,,40105348
4,54875957,54858,CHIC2,20,,54930815
9,35649296,1651,SIT1,20,,35650947
7,33169151,476529,BBS9,20,,33645680
6,109307639,23119,SESN1,20,,109330758
3,1134341,310951,CNTN6,20,,1445292
4,186421814,34898,PDLIM3,20,,186456712
2,69088047,10602,BMP10,20,,69098649
12,70760061,68011,KCNMB4,20,,70828072
X,55478521,1480,MAGEH1,20,,55480001
16,11844441,46673,ZC3H7A,20,,11891114
6,160211477,7984,MRPL18,20,,160219461
12,9822303,29848,CLEC2D,20,,9852151
7,2291404,62706,SNX8,20,,2354110
14,105515725,16162,GPR132,20,,105531887
X,70279096,14180,SNX12,20,,70293276
1,152381718,5032,CRNN,20,,152386750
X,79270254,17014,TBX22,20,,79287268
10,101491957,23937,CUTC,20,,101515894
17,7191570,6306,YBX2,20,,7197876
4,25121626,40578,SEPSECS,20,,25162204
5,133936838,31695,SAR1B,20,,133968533
1,60280532,61518,HOOK1,20,,60342050
17,29109701,42077,CRLF3,20,,29151778
11,94695786,10990,CWC15,20,,94706776
1,161123533,5113,UFC1,20,,161128646
3,132316080,5405,ACKR4,20,,132321485
14,36767763,22119,MBIP,20,,36789882
1,17575592,35135,PADI3,20,,17610727
11,98891705,1337911,CNTN5,20,,100229616
22,39898234,15905,MIEF1,20,,39914139
X,54556643,37077,GNL3L,20,,54593720
5,53180613,425790,ARL15,20,,53606403
11,62600376,7252,WDR74,20,,62607628
7,86974950,54162,CROT,20,,87029112
7,92728825,18511,SAMD9,20,,92747336
8,95653363,66331,ESRP1,20,,95719694
5,157158396,10059,THG1L,20,,157168455
22,31365196,10184,TUG1,20,,31375380
12,85253266,53342,SLC6A15,20,,85306608
X,51232862,6597,NUDT11,20,,51239459
6,53659777,129142,LRRC1,20,,53788919
1,2439969,18098,PANK4,20,,2458067
17,411907,206189,VPS53,20,,618096
14,45672392,50213,MIS18BP1,20,,45722605
3,111697722,14493,ABHD10,20,,111712215
12,10771537,55354,STYK1,20,,10826891
15,34633916,1446,NOP10,20,,34635362
14,20915206,8061,OSGEP,20,,20923267
16,70721341,113720,VAC14,20,,70835061
1,16767166,19418,NECAP2,20,,16786584
12,8185358,22760,FOXJ2,20,,8208118
9,21329669,5762,KLHL9,20,,21335431
9,131644780,35537,LRRC8A,20,,131680317
1,89401455,57188,CCBL2,20,,89458643
12,3490514,212624,PRMT8,20,,3703138
11,8932700,8926,AKIP1,20,,8941626
18,34823007,322993,CELF4,20,,35146000
2,85198230,88365,KCMF1,20,,85286595
4,103998781,22243,BDH2,20,,104021024
5,133291197,13209,C5orf15,20,,133304406
5,23507717,20989,PRDM9,20,,23528706
1,227127937,47309,ADCK3,20,,227175246
6,107473760,307019,PDSS2,20,,107780779
9,136271181,12035,REXO4,20,,136283216
20,42740336,75882,JPH2,20,,42816218
6,30881984,12251,VARS2,20,,30894235
7,129074273,49202,STRIP2,20,,129123475
1,3696783,16285,LRRC47,20,,3713068
6,122764492,28534,SERINC1,20,,122793026
10,90639943,43316,STAMBPL1,20,,90683259
19,31765850,74581,TSHZ3,20,,31840431
2,18735988,5971,RDH14,20,,18741959
2,180809603,62177,CWC22,20,,180871780
19,40973125,109240,SPTBN4,20,,41082365
2,219263060,7604,CTDSP1,20,,219270664
9,109625377,148419,ZNF462,20,,109773796
4,71263598,12316,PROL1,20,,71275914
19,50145381,16525,SCAF1,20,,50161906
12,31433519,45602,FAM60A,20,,31479121
12,27863705,45532,MRPS35,20,,27909237
2,201754049,14606,NIF3L1,20,,201768655
11,125034558,268727,PKNOX2,20,,125303285
11,128805269,2460,TP53AIP1,20,,128807729
3,139654026,632893,CLSTN2,20,,140286919
14,70346113,152970,SMOC1,20,,70499083
X,99839789,15093,TNMD,20,,99854882
11,119020298,13076,ABCG4,20,,119033374
3,28373179,17439,AZI2,20,,28390618
3,171758343,360149,FNDC3B,20,,172118492
7,43906156,2989,MRPS24,20,,43909145
2,95751135,36637,MRPS5,20,,95787772
17,73894723,6458,MRPL38,20,,73901181
8,144685393,6391,PYCRL,20,,144691784
11,867858,43016,CHID1,20,,910874
2,198591602,59434,BOLL,20,,198651036
19,54695064,3330,TSEN34,20,,54698394
11,60609428,9133,CCDC86,20,,60618561
3,45959390,77926,FYCO1,20,,46037316
2,220403668,4151,CHPF,20,,220407819
1,156707093,3830,MRPL24,20,,156710923
3,101443436,45970,CEP97,20,,101489406
13,41885340,47514,NAA16,20,,41932854
10,103825123,2672,HPS6,20,,103827795
15,71839540,236182,THSD4,20,,72075722
2,172378865,35778,CYBRD1,20,,172414643
20,37377096,23993,ACTR5,20,,37401089
5,176928905,8522,DOK3,20,,176937427
16,57186377,33599,FAM192A,20,,57219976
16,67862059,19302,CENPT,20,,67881361
12,121837885,24270,RNF34,20,,121862155
1,150459839,20246,TARS2,20,,150480085
6,31830969,15854,SLC44A4,20,,31846823
14,64150934,43879,SGPP1,20,,64194813
X,51804922,7446,MAGED4B,20,,51812368
1,228581376,13141,TRIM11,20,,228594517
1,185087217,39013,TRMT1L,20,,185126230
19,8645123,11957,ADAMTS10,20,,8657080
7,100728719,6300,TRIM56,20,,100735019
4,128651532,43922,SLC25A31,20,,128695454
13,46039029,71804,COG3,20,,46110833
7,110303105,899468,IMMP2L,20,,111202573
2,130737234,3077,RAB6C,20,,130740311
9,80850990,30993,CEP78,20,,80881983
7,1606969,2699,PSMG3,20,,1609668
4,57829509,14317,NOA1,20,,57843826
1,15943952,43600,DDI2,20,,15987552
8,42752032,133650,HOOK3,20,,42885682
10,98592016,132182,LCOR,20,,98724198
5,126626455,170455,MEGF10,20,,126796910
14,21510384,2008,RNASE7,20,,21512392
20,30225690,7110,COX4I2,20,,30232800
9,35088684,7862,PIGO,20,,35096546
15,50999736,58174,SPPL2A,20,,51057910
1,27668482,11941,SYTL1,20,,27680423
15,74738317,15212,UBL7,20,,74753529
6,149825630,41608,PPIL4,20,,149867238
10,106069453,19297,ITPRIP,20,,106088750
7,99488029,29194,TRIM4,20,,99517223
1,201708962,87140,NAV1,20,,201796102
5,16451627,14267,ZNF622,20,,16465894
8,8860313,30536,ERI1,20,,8890849
15,45409563,12496,DUOXA1,20,,45422059
22,31556137,46868,RNF185,20,,31603005
14,74181824,72137,ELMSAN1,20,,74253961
19,41082756,14549,SHKBP1,20,,41097305
9,18474078,436869,ADAMTSL1,20,,18910947
X,16737706,43101,SYAP1,20,,16780807
21,34113649,30520,PAXBP1,20,,34144169
10,32094325,123479,ARHGAP12,20,,32217804
16,28565248,37863,CCDC101,20,,28603111
14,51441980,120442,TRIM9,20,,51562422
1,33979598,651277,CSMD2,20,,34630875
5,72251807,134542,FCHO2,20,,72386349
12,58003962,7066,ARHGEF25,20,,58011028
8,144391496,50651,TOP1MT,20,,144442147
2,236402732,637712,AGAP1,20,,237040444
12,70172731,44253,RAB3IP,20,,70216984
2,205410515,1074371,PARD3B,20,,206484886
12,129277738,30803,SLC15A4,20,,129308541
2,232826292,382386,DIS3L2,20,,233208678
6,132966036,1129,TAAR1,20,,132967165
9,132396882,7566,ASB6,20,,132404448
1,153579358,6286,S100A16,20,,153585644
15,43015759,13658,CDAN1,20,,43029417
4,152041432,106228,SH3D19,20,,152147660
4,89178760,27223,PPM1K,20,,89205983
8,25316446,48987,CDCA2,20,,25365433
8,74206836,30684,RDH10,20,,74237520
6,30644165,10928,PPP1R18,20,,30655093
16,74705752,29294,MLKL,20,,74735046
3,57541973,7301,PDE12,20,,57549274
6,62389864,606268,KHDRBS2,20,,62996132
7,4169316,139315,SDK1,20,,4308631
7,4721929,89145,FOXK1,20,,4811074
8,144798506,6127,MAPK15,20,,144804633
11,62369690,10547,EML3,20,,62380237
15,53805937,27363,WDR72,20,,53833300
19,17581252,35725,SLC27A1,20,,17616977
8,7189908,1593,USP17L1,20,,7191501
6,158589378,30998,GTF2H5,20,,158620376
22,22007592,82,MIR130B,20,,22007674
11,72326106,68,MIR139,20,,72326174
8,7738725,1455,DEFB103A,20,,7740180
16,67236223,75,MIR328,20,,67236298
X,133680643,98,MIR424,20,,133680741
5,54466359,91,MIR449A,20,,54466450
11,2167852,14587,INS-IGF2,20,,2182439
4,71457974,15030,AMBN,19,,71473004
12,56754354,2229,APOF,19,,56756583
11,2289727,2455,ASCL2,19,,2292182
9,104122698,23103,BAAT,19,,104145801
7,128412542,3302,OPN1SW,19,,128415844
1,92414927,65058,BRDT,19,,92479985
11,64889715,5126,MRPL49,19,,64894841
11,15095145,5032,CALCB,19,,15100177
5,21750974,1102757,CDH12,19,,22853731
4,47937993,76968,CNGA1,19,,48014961
1,32117847,51921,COL16A1,19,,32169768
16,2289872,11730,ECI1,19,,2301602
2,242615156,11227,DTYMK,19,,242626383
13,99946788,12961,GPR183,19,,99959749
3,184908411,63475,EHHADH,19,,184971886
19,48828628,5182,EMP3,19,,48833810
X,137713733,573452,FGF13,19,,138287185
6,143815948,17072,FUCA2,19,,143833020
18,60994970,39536,KDSR,19,,61034506
12,58019677,6787,B4GALNT1,19,,58026464
1,235710984,103070,GNG4,19,,235814054
17,47283595,4341,GNGT2,19,,47287936
9,127640572,62814,GOLGA1,19,,127703386
19,46093022,12444,GPR4,19,,46105466
1,42628361,2034,GUCA2A,19,,42630395
1,42619091,2404,GUCA2B,19,,42621495
5,176307869,18464,HK3,19,,176326333
12,122277432,49085,HPD,19,,122326517
15,89181973,17602,ISG20,19,,89199575
1,110753335,23339,KCNC4,19,,110776674
12,52753789,7520,KRT85,19,,52761309
7,2559478,8585,LFNG,19,,2568063
15,41795839,10246,LTK,19,,41806085
19,19256375,47025,MEF2BNB-MEF2B,19,,19303400
16,10837642,25566,NUBP1,19,,10863208
21,22370632,541885,NCAM2,19,,22912517
19,8376233,10064,NDUFA7,19,,8386297
16,23592334,15305,NDUFAB1,19,,23607639
2,233897381,2386,NEU2,19,,233899767
17,37760020,4155,NEUROD2,19,,37764175
9,95883770,12800,NINJ1,19,,95896570
7,97614012,5404,OCM2,19,,97619416
13,30338544,86276,UBL3,19,,30424820
5,145718586,1497,POU4F3,19,,145720083
9,104353896,3387,PPP3R2,19,,104357283
12,11504756,3768,PRB1,19,,11508524
6,122793061,254457,PKIB,19,,123047518
11,76061000,31009,PRKRIR,19,,76092009
X,3522383,109292,PRKX,19,,3631675
19,43671894,18794,PSG5,19,,43690688
11,118033518,13819,SCN2B,19,,118047337
12,299242,23621,SLC6A12,19,,322863
7,123565285,34815,SPAM1,19,,123600100
1,153028595,1393,SPRR2A,19,,153029988
11,126132813,6064,SRPR,19,,126138877
7,105730813,22280,SYPL1,19,,105753093
22,41763336,31996,TEF,19,,41795332
21,38445483,129936,TTC3,19,,38575419
3,118892424,31576,UPK1B,19,,118924000
X,48760888,8347,SLC35A2,19,,48769235
11,118827007,2262,UPK2,19,,118829269
22,22599191,736,VPREB1,19,,22599927
17,44928951,28975,WNT9B,19,,44957926
3,50325162,4864,IFRD2,19,,50330026
16,135803,52894,NPRL3,19,,188697
17,41177257,6801,RND2,19,,41184058
6,26199786,430,HIST1H2BF,19,,26200216
6,26273203,437,HIST1H2BI,19,,26273640
1,150954498,13616,ANXA9,19,,150968114
11,27062508,86846,BBOX1,19,,27149354
19,49843852,21862,TEAD2,19,,49865714
14,88471467,9688,GPR65,19,,88481155
X,15402923,108788,PIR,19,,15511711
1,224370909,10233,DEGS1,19,,224381142
1,241695433,63516,KMO,19,,241758949
2,207938861,92719,KLF7,19,,208031580
Y,1472031,50624,ASMTL,19,,1522655
12,57157001,24573,HSD17B6,19,,57181574
5,139927250,1913,EIF4EBP3,19,,139929163
17,7284292,8800,TNK1,19,,7293092
18,3066804,153302,MYOM1,19,,3220106
20,5107406,71127,CDS2,19,,5178533
X,49955410,10254,AKAP4,19,,49965664
4,89513573,116120,HERC3,19,,89629693
X,134166332,1243,FAM127A,19,,134167575
2,73867849,1688,NAT8,19,,73869537
22,21369441,12861,P2RX6,19,,21382302
6,33246879,10425,WDR46,19,,33257304
6,79910961,33494,HMGN3,19,,79944455
15,64680002,67500,TRIP4,19,,64747502
9,14719731,2984,CER1,19,,14722715
1,94634462,68845,ARHGAP29,19,,94703307
19,14142551,21166,IL27RA,19,,14163717
11,125439282,15302,EI24,19,,125454584
2,158271130,29474,CYTIP,19,,158300604
3,11597540,87911,VGLL4,19,,11685451
17,19674142,97097,ULK2,19,,19771239
6,143999101,153221,PHACTR2,19,,144152322
3,17198653,542859,TBC1D5,19,,17741512
6,109802151,2289,ZBTB24,19,,109804440
2,242295663,109788,FARP2,19,,242405451
10,62629197,74836,RHOBTB1,19,,62704033
15,91643109,202686,SV2B,19,,91845795
15,65409716,16458,PDCD7,19,,65426174
12,42550906,81264,YAF2,19,,42632170
12,94542498,158953,PLXNC1,19,,94701451
X,123509755,587911,TENM1,19,,124097666
11,58477560,21887,GLYAT,19,,58499447
16,85812230,20918,EMC8,19,,85833148
4,42410391,248731,ATP8A1,19,,42659122
3,98451079,63610,ST3GAL6,19,,98514689
1,201924618,15171,TIMM17A,19,,201939789
19,7991602,17106,TIMM44,19,,8008708
15,78396947,26930,CIB2,19,,78423877
1,114239823,61954,PHTF1,19,,114301777
12,10741076,11358,KLRAP1,19,,10752434
22,41829491,13536,TOB2,19,,41843027
12,133758059,25638,ZNF268,19,,133783697
11,72465773,38977,STARD10,19,,72504750
20,33814538,50266,MMP24,19,,33864804
1,153946744,3707,JTB,19,,153950451
19,55105040,8806,LILRA1,19,,55113846
19,54720146,26565,LILRB3,19,,54746711
13,53277399,36548,LECT1,19,,53313947
3,58291971,13949,RPP14,19,,58305920
6,105544698,40351,BVES,19,,105585049
13,41635696,22443,WBP4,19,,41658139
4,169013687,95206,ANXA10,19,,169108893
3,131181044,40816,MRPL3,19,,131221860
2,231090444,13347,SP140,19,,231103791
3,50362339,3330,TUSC2,19,,50365669
17,47366567,72909,ZNF652,19,,47439476
3,45730732,56185,SACM1L,19,,45786917
2,1792884,542201,MYT1L,19,,2335085
3,12838170,38143,CAND2,19,,12876313
22,21771692,34058,HIC2,19,,21805750
2,65283494,30648,CEP68,19,,65314142
9,119187503,262039,ASTN2,19,,119449542
13,113344642,196840,ATP11A,19,,113541482
17,2592679,22248,CLUH,19,,2614927
9,115927799,55842,FKBP15,19,,115983641
22,39257431,10908,CBX6,19,,39268339
2,42994228,25523,HAAO,19,,43019751
17,8782232,86797,PIK3R5,19,,8869029
22,35937351,12694,RASD2,19,,35950045
1,25664788,24064,TMEM50A,19,,25688852
22,38035683,16367,SH3BP1,19,,38052050
22,36622254,13435,APOL2,19,,36635689
7,100875372,5855,CLDN15,19,,100881227
4,75858284,117041,PARM1,19,,75975325
3,100468178,244156,ABI3BP,19,,100712334
11,63391553,47649,ATL3,19,,63439202
6,82879703,77768,IBTK,19,,82957471
17,4843302,5216,RNF167,19,,4848518
9,140342022,11764,NSMF,19,,140353786
21,30300465,64812,LTN1,19,,30365277
4,68424414,48645,STAP1,19,,68473059
12,8685900,7658,CLEC4E,19,,8693558
2,191069359,115412,HIBCH,19,,191184771
9,124964855,25852,LHX6,19,,124990707
19,36195388,12552,ZBTB32,19,,36207940
4,100737980,53366,DAPP1,19,,100791346
3,178957536,27302,KCNMB3,19,,178984838
20,1290554,15959,SDCBP2,19,,1306513
2,219536748,30692,STK36,19,,219567440
4,153701088,131975,ARFIP1,19,,153833063
2,150426146,18184,MMADHC,19,,150444330
4,142142040,13810,ZNF330,19,,142155850
X,49091926,15061,CCDC22,19,,49106987
16,89334028,222941,ANKRD11,19,,89556969
11,64794879,13165,SNX15,19,,64808044
3,49758908,2499,GMPPB,19,,49761407
9,131464782,18417,PKN3,19,,131483199
16,83986826,13111,OSGIN1,19,,83999937
1,108677343,65637,SLC25A24,19,,108742980
7,114562208,97762,MDFIC,19,,114659970
7,99955625,9829,PILRB,19,,99965454
7,99971067,26655,PILRA,19,,99997722
9,4709556,31753,AK3,19,,4741309
7,141463896,1101,TAS2R3,19,,141464997
5,9629108,1355,TAS2R1,19,,9630463
12,8276227,14976,CLEC4A,19,,8291203
11,125826712,106475,CDON,19,,125933187
20,44978166,14931,SLC35C2,19,,44993097
10,73855789,120078,ASCC1,19,,73975867
17,662548,23023,GLOD4,19,,685571
3,160939077,30718,NMD3,19,,160969795
11,67933185,47599,SUV420H1,19,,67980784
2,53897116,116869,ASB3,19,,54013985
1,215740721,54442,KCTD3,19,,215795163
3,137879829,13962,DBR1,19,,137893791
5,150088308,50349,DCTN4,19,,150138657
16,5074844,9098,NAGPA,19,,5083942
X,69506210,3588,PDZD11,19,,69509798
20,34541538,1743,SCAND1,19,,34543281
12,29493578,40565,ERGIC2,19,,29534143
2,70485230,23087,PCYOX1,19,,70508317
16,25123046,66505,LCMT1,19,,25189551
3,52937582,142507,SFMBT1,19,,53080089
6,33384318,1747,CUTA,19,,33386065
20,5918478,12726,TRMT6,19,,5931204
16,19870292,25941,GPRC5B,19,,19896233
10,91339253,64395,PANK1,19,,91403648
11,5641173,24452,TRIM34,19,,5665625
21,42688660,40994,FAM3B,19,,42729654
21,43159528,27721,RIPK4,19,,43187249
8,141521396,5856,CHRAC1,19,,141527252
7,141490016,1150,TAS2R5,19,,141491166
20,19867164,115939,RIN2,19,,19983103
19,19030483,8959,DDX49,19,,19039442
20,5987897,32800,CRLS1,19,,6020697
1,28655512,6966,MED18,19,,28662478
1,40306705,42478,TRIT1,19,,40349183
19,9920942,8837,FBXL12,19,,9929779
17,18086866,26401,ALKBH5,19,,18113267
1,159750735,1601,DUSP23,19,,159752336
18,29598444,54710,RNF125,19,,29653154
11,60897727,31189,VPS37C,19,,60928916
13,43787699,415914,ENOX1,19,,44203613
3,107879658,61759,IFT57,19,,107941417
10,99639382,151203,CRTAC1,19,,99790585
11,4619901,9588,TRIM68,19,,4629489
2,45615818,222615,SRBD1,19,,45838433
1,155579960,4798,MSTO1,19,,155584758
17,685568,10181,RNMTL1,19,,695749
18,33569786,77771,RPRD1A,19,,33647557
13,50106081,53638,RCBTB1,19,,50159719
16,56485423,25984,OGFOD1,19,,56511407
7,150264457,6584,GIMAP4,19,,150271041
20,12989626,157785,SPTLC3,19,,13147411
3,194361516,31690,LSG1,19,,194393206
9,100689072,18125,HEMGN,19,,100707197
6,74104284,23005,DDX43,19,,74127289
4,79697531,103063,BMP2K,19,,79800594
20,16252748,301331,KIF16B,19,,16554079
2,225629806,277524,DOCK10,19,,225907330
11,94706844,25832,KDM4D,19,,94732676
7,72716512,6352,NSUN5,19,,72722864
4,40058523,101349,N4BP2,19,,40159872
20,33703159,32002,EDEM2,19,,33735161
2,148778579,492465,MBD5,19,,149271044
15,94841429,185752,MCTP2,19,,95027181
X,16804554,58088,TXLNG,19,,16862642
6,70385640,121409,LMBRD1,19,,70507049
16,68055176,2594,DDX28,19,,68057770
19,17326154,4484,USE1,19,,17330638
6,127609856,54898,ECHDC1,19,,127664754
15,52484514,103481,MYO5C,19,,52587995
2,131349737,7411,CFC1,19,,131357148
21,45345278,62197,AGPAT3,19,,45407475
17,49707673,529488,CA10,19,,50237161
3,119187784,25770,POGLUT1,19,,119213554
7,35242041,51670,TBX20,19,,35293711
11,22359666,41380,SLC17A6,19,,22401046
15,84322837,385756,ADAMTSL3,19,,84708593
2,47168312,134963,TTC7A,19,,47303275
6,24403135,23287,MRS2,19,,24426422
2,169727400,19544,SPC25,19,,169746944
7,75508309,9935,RHBDD2,19,,75518244
16,2525146,30588,TBC1D24,19,,2555734
2,20110028,79856,WDR35,19,,20189884
12,27933186,22787,KLHL42,19,,27955973
5,115779250,131372,SEMA6A,19,,115910622
19,11309968,63200,DOCK6,19,,11373168
1,20990506,54004,KIF17,19,,21044510
17,76000317,104599,TNRC6C,19,,76104916
10,118642887,122201,KIAA1598,19,,118765088
10,49893517,297484,WDFY4,19,,50191001
14,20779526,21945,CCNB1IP1,19,,20801471
X,131337051,16457,RAP2C,19,,131353508
20,36661947,58819,RPRD1B,19,,36720766
6,71377473,194243,SMAP1,19,,71571716
4,184580419,54328,TRAPPC11,19,,184634747
X,129139163,52895,BCORL1,19,,129192058
20,23355155,47001,NAPB,19,,23402156
22,41253084,5701,XPNPEP3,19,,41258785
20,32244892,17372,NECAB3,19,,32262264
17,702552,64799,NXN,19,,767351
16,1278335,1850,TPSB2,19,,1280185
7,139723543,39978,PARP12,19,,139763521
1,43829067,4342,ELOVL1,19,,43833409
4,53457126,65633,USP46,19,,53522759
15,89010683,13315,MRPS11,19,,89023998
22,19419424,4177,MRPL40,19,,19423601
1,151732118,4274,MRPL9,19,,151736392
1,28764660,62221,PHACTR4,19,,28826881
14,24025190,3600,THTPA,19,,24028790
8,96145948,22965,PLEKHF2,19,,96168913
11,111652918,89387,ALG9,19,,111742305
16,28915741,20791,RABEP2,19,,28936532
1,26758772,39023,DHDDS,19,,26797795
4,83550689,169321,SCD5,19,,83720010
7,120629444,272528,CPED1,19,,120901972
7,5515427,38002,FBXL18,19,,5553429
2,172290760,50802,DCAF17,19,,172341562
4,113218498,145266,ALPK1,19,,113363764
7,102073976,23292,ORAI2,19,,102097268
3,12526009,48811,TSEN2,19,,12574820
2,239079042,33282,ILKAP,19,,239112324
8,105352023,16894,DCSTAMP,19,,105368917
5,147763497,58902,FBXO38,19,,147822399
20,30532757,7126,PDRG1,19,,30539883
16,1877224,12979,FAHD1,19,,1890203
15,73043707,32419,ADPGK,19,,73076126
4,140374960,22109,RAB33B,19,,140397069
12,6957971,3123,CDCA3,19,,6961094
9,133971862,26677,AIF1L,19,,133998539
8,10581277,6807,SOX7,19,,10588084
2,174219560,14158,CDCA7,19,,174233718
7,6144549,56646,USP42,19,,6201195
22,29279754,173722,ZNRF3,19,,29453476
2,62051982,29296,FAM161A,19,,62081278
11,65485143,3266,RNASEH2C,19,,65488409
12,110338078,17796,TCHP,19,,110355874
2,32502957,28701,YIPF4,19,,32531658
12,56295196,25713,WIBG,19,,56320909
10,92979907,64181,PCGF5,19,,93044088
11,47185848,12828,ARFGAP2,19,,47198676
17,29718641,146595,RAB11FIP4,19,,29865236
19,55795533,28370,BRSK1,19,,55823903
6,130339727,122867,L3MBTL3,19,,130462594
19,8130285,84445,FBN3,19,,8214730
8,33342684,16094,MAK16,19,,33358778
1,40420783,14857,MFSD2A,19,,40435640
2,70523107,6113,FAM136A,19,,70529220
1,182610948,31119,RGS8,19,,182642067
1,205626980,22650,SLC45A3,19,,205649630
X,50027539,67372,CCNB3,19,,50094911
20,62189438,16154,HELZ2,19,,62205592
17,27952956,304290,SSH2,19,,28257246
7,12610202,83026,SCIN,19,,12693228
6,30130982,9491,TRIM15,19,,30140473
16,1728277,23796,HN1L,19,,1752073
10,37414784,106711,ANKRD30A,19,,37521495
22,39925097,3763,RPS19BP1,19,,39928860
4,113196781,10278,TIFA,19,,113207059
8,144656954,3567,NAPRT,19,,144660521
17,26880405,18482,PIGS,19,,26898887
17,7529551,1643,SAT2,19,,7531194
2,55746730,25486,CFAP36,19,,55772216
15,22833394,39389,TUBGCP5,19,,22872783
1,59120410,45337,MYSM1,19,,59165747
20,44420575,19491,DNTTIP1,19,,44440066
6,42981840,7196,KLHDC3,19,,42989036
20,58152563,270203,PHACTR3,19,,58422766
6,35911290,81015,SLC26A8,19,,35992305
6,137464956,29829,IL22RA2,19,,137494785
10,98353068,127211,PIK3AP1,19,,98480279
14,55493843,22363,SOCS4,19,,55516206
14,89290496,53844,TTC8,19,,89344340
15,78799905,29082,HYKK,19,,78828987
17,42112002,32985,LSM12,19,,42144987
5,110831731,16564,STARD4,19,,110848295
7,130417381,1479,KLF14,19,,130418860
8,85097099,736979,RALYL,19,,85834078
X,150732006,113205,PASD1,19,,150845211
1,1550794,15196,MIB2,19,,1565990
19,45843997,10781,KLC3,19,,45854778
1,173900221,61989,RC3H1,19,,173962210
1,43198763,7162,CLDN19,19,,43205925
3,112323232,36758,CCDC80,19,,112359990
6,134308718,65071,SLC2A12,19,,134373789
7,66093867,14349,KCTD7,19,,66108216
8,101532999,39015,ANKRD46,19,,101572014
9,27948083,1264915,LINGO2,19,,29212998
12,83080933,447714,TMTC2,19,,83528647
1,246729638,81906,CNST,19,,246811544
4,123844224,396380,SPATA5,19,,124240604
4,74437266,49021,RASSF6,19,,74486287
6,137813335,2196,OLIG3,19,,137815531
16,89160216,62038,ACSF3,19,,89222254
2,74213530,121772,TET3,19,,74335302
3,195447752,12672,MUC20,19,,195460424
5,78985658,110391,CMYA5,19,,79096049
X,150565656,12180,VMA21,19,,150577836
13,28009775,14559,MTIF3,19,,28024334
10,69990351,1519,ATOH7,19,,69991870
13,22066827,111528,MICU2,19,,22178355
13,24734854,146358,SPATA13,19,,24881212
16,57126454,55424,CPNE2,19,,57181878
7,102740022,49547,NAPEPLD,19,,102789569
2,169312758,318886,CERS6,19,,169631644
6,146205944,79289,SHPRH,19,,146285233
13,101706129,362684,NALCN,19,,102068813
11,11373488,1416,CSNK2A3,19,,11374904
12,40787195,177362,MUC19,19,,40964557
17,27055831,13953,NEK8,19,,27069784
7,150709296,12290,ATG9B,19,,150721586
12,52862299,5270,KRT6C,19,,52867569
3,128806411,34582,RAB43,19,,128840993
6,41116998,5089,TREML1,19,,41122087
13,39261172,200095,FREM2,19,,39461267
4,2073684,170207,POLN,19,,2243891
1,152321212,11270,FLG2,19,,152332482
8,11989925,1593,USP17L7,19,,11991518
17,27188550,86,MIR144,19,,27188636
19,13947100,73,MIR24-2,19,,13947173
8,135812762,88,MIR30B,19,,135812850
17,7452374,12551,TNFSF12-TNFSF13,19,,7464925
12,31944118,1057,H3F3C,19,,31945175
14,101377475,75,MIR370,19,,101377550
17,28444096,94,MIR423,19,,28444190
17,6921229,112,MIR497,19,,6921341
16,52585998,54889,CASC16,19,,52640887
5,172571444,19946,BNIP1,18,,172591390
6,3118609,34823,BPHL,18,,3153432
18,13611462,41291,LDLRAD4,18,,13652753
12,49212253,10473,CACNB3,18,,49222726
5,26880708,157981,CDH9,18,,27038689
X,72667089,7332,CDX4,18,,72674421
6,70576447,345710,COL19A1,18,,70922157
7,129906702,22935,CPA2,18,,129929637
14,105953256,1868,CRIP1,18,,105955124
17,61509664,13881,CYB561,18,,61523545
19,41620336,13952,CYP2F1,18,,41634288
4,183811243,27387,DCTD,18,,183838630
2,172950207,4194,DLX1,18,,172954401
3,52082936,7525,DUSP7,18,,52090461
19,17342693,13458,NR2F6,18,,17356151
17,29643427,5340,EVI2A,18,,29648767
5,169532916,3813,FOXI1,18,,169536729
16,81115551,14429,GCSH,18,,81129980
X,14547419,202514,GLRA2,18,,14749933
2,128403438,6775,GPR17,18,,128410213
X,78003205,8696,LPAR4,18,,78011901
13,49794473,2040,MLNR,18,,49796513
6,28493788,8940,GPX5,18,,28502728
12,54426831,2313,HOXC5,18,,54429144
12,54366909,3294,HOXC11,18,,54370203
2,176994467,2956,HOXD8,18,,176997423
X,153051220,8758,IDH3G,18,,153059978
19,18062110,47820,KCNN1,18,,18109930
11,75297962,81517,MAP6,18,,75379479
14,74524367,26829,ALDH6A1,18,,74551196
3,39509063,48431,MOBP,18,,39557494
2,55463755,32560,MTIF2,18,,55496315
3,179322574,19714,NDUFB5,18,,179342288
5,134869971,1668,NEUROG1,18,,134871639
5,140855568,36976,PCDHGC3,18,,140892544
21,41239346,61976,PCP4,18,,41301322
4,96761238,1387,PDHA2,18,,96762625
3,48555116,39240,PFKFB4,18,,48594356
5,114546526,52043,PGGT1B,18,,114598569
18,61254533,11900,SERPINB13,18,,61266433
17,18759611,74988,PRPSAP2,18,,18834599
1,202847409,10976,RABIF,18,,202858385
19,5993174,117490,RFX2,18,,6110664
7,33134409,14593,RP9,18,,33149002
17,80278899,13022,SECTM1,18,,80291921
19,48281841,6102,SEPW1,18,,48287943
X,80457302,96744,SH3BGRL,18,,80554046
9,15422781,38846,SNAPC3,18,,15461627
8,101170562,83570,SPAG1,18,,101254132
1,152956563,1727,SPRR1A,18,,152958290
X,48261523,9821,SSX4,18,,48271344
9,136223420,4621,SURF2,18,,136228041
11,77774906,4497,THRSP,18,,77779403
7,48128199,20131,UPP1,18,,48148330
1,46769284,13165,UQCRH,18,,46782449
7,73703804,116469,CLIP2,18,,73820273
Y,2803517,47030,ZFY,18,,2850547
5,43121562,54864,ZNF131,18,,43176426
1,23410515,84836,LUZP1,18,,23495351
22,21336557,16769,LZTR1,18,,21353326
6,25081294,56757,CMAHP,18,,25138051
12,113536623,37421,RASAL1,18,,113574044
11,7618416,56580,PPFIBP2,18,,7674996
6,110713382,23371,DDO,18,,110736753
12,53900471,951,NPFF,18,,53901422
15,42120282,20064,JMJD7-PLA2G4B,18,,42140346
16,318299,7644,RGS11,18,,325943
7,99006600,10639,BUD31,18,,99017239
22,39966757,118983,CACNA1I,18,,40085740
10,90965693,1378,CH25H,18,,90967071
3,37094116,123735,LRRFIP2,18,,37217851
19,18704034,13626,CRLF1,18,,18717660
1,117544371,34802,CD101,18,,117579173
4,68686593,63123,TMPRSS11D,18,,68749716
2,233344536,8033,ECEL1,18,,233352569
6,131571298,33377,AKAP7,18,,131604675
2,101008321,25809,CHST10,18,,101034130
17,79091095,48777,AATK,18,,79139872
8,1772141,134666,ARHGEF10,18,,1906807
15,85291817,57846,ZNF592,18,,85349663
7,11013498,133878,PHF14,18,,11147376
22,32150008,61969,DEPDC5,18,,32211977
11,74660291,29785,SPCS2,18,,74690076
22,31892124,122413,SFI1,18,,32014537
7,4815261,18765,AP5Z1,18,,4834026
1,174844655,82672,RABGAP1L,18,,174927327
3,38080695,83537,DLEC1,18,,38164232
5,179727689,52698,GFPT2,18,,179780387
4,11399987,30550,HS3ST1,18,,11430537
21,37536838,129734,DOPEY2,18,,37666572
X,149531544,150904,MAMLD1,18,,149682448
16,1832923,6269,NUBP2,18,,1839192
19,19101695,42685,SUGP2,18,,19144380
15,44084039,4248,SERF2,18,,44088287
15,65951460,133171,DENND4A,18,,66084631
5,54526980,2565,CCNO,18,,54529545
17,66863427,88106,ABCA8,18,,66951533
15,90728151,44741,SEMA4B,18,,90772892
6,25652428,49580,SCGN,18,,25702008
4,2249159,14580,MXD4,18,,2263739
19,39989556,9565,DLL3,18,,39999121
20,18467187,10700,RBBP9,18,,18477887
19,30097169,10993,POP4,18,,30108162
6,25845327,29144,SLC17A3,18,,25874471
6,146864827,11265,RAB32,18,,146876092
2,48844918,61833,GTF2A1L,18,,48906751
19,36157417,11970,UPK1A,18,,36169387
4,121613067,230954,PRDM5,18,,121844021
7,27565058,137562,HIBADH,18,,27702620
19,45542297,31917,CLASRP,18,,45574214
11,18300216,43505,HPS5,18,,18343721
4,166131170,113138,KLHL2,18,,166244308
6,155054511,100867,SCAF8,18,,155155378
15,101715927,76210,CHSY1,18,,101792137
2,207630111,30800,FASTKD2,18,,207660911
1,204187978,141079,PLEKHA6,18,,204329057
18,29409135,113956,TRAPPC8,18,,29523091
10,13359437,30861,SEPHS1,18,,13390298
10,320129,415479,DIP2C,18,,735608
4,41362647,339414,LIMCH1,18,,41702061
3,73431580,242492,PDZRN3,18,,73674072
X,53262057,88465,IQSEC2,18,,53350522
3,51572698,129978,RAD54L2,18,,51702676
3,16357351,197871,RFTN1,18,,16555222
19,47567446,49563,ZC3H4,18,,47617009
8,67341262,1706,RRS1,18,,67342968
14,105780751,83733,PACS2,18,,105864484
7,51083908,300607,COBL,18,,51384515
20,48429249,79530,SLC9A8,18,,48508779
7,54819939,7000,SEC61G,18,,54826939
X,23721776,39631,ACOT9,18,,23761407
22,19118320,1816,TSSK2,18,,19120136
11,87846414,62221,RAB38,18,,87908635
22,21996541,2047,SDF2L1,18,,21998588
19,416582,44414,SHC2,18,,460996
1,201865583,50133,LMOD1,18,,201915716
3,134196545,8320,ANAPC13,18,,134204865
9,34086380,40391,DCAF12,18,,34126771
7,16501105,4369,SOSTDC1,18,,16505474
15,75128456,7096,ULK3,18,,75135552
11,78364327,787368,TENM4,18,,79151695
16,451857,10630,DECR2,18,,462487
10,127408083,44629,EDRF1,18,,127452712
17,72766667,5897,NAT9,18,,72772564
9,35809806,2453,SPAG8,18,,35812259
6,52935770,29900,FBXO9,18,,52965670
3,122103022,25939,FAM162A,18,,122128961
16,29882479,28106,SEZ6L2,18,,29910585
7,16793350,30811,TSPAN13,18,,16824161
1,16340522,4763,HSPB7,18,,16345285
14,24774392,6184,CIDEB,18,,24780576
4,70592685,33745,SULT1B1,18,,70626430
11,7110164,2215,RBMXL2,18,,7112379
20,49575350,3049,MOCS3,18,,49578399
8,121408082,49565,MRPL13,18,,121457647
22,50946644,16565,NCAPH2,18,,50963209
5,78293386,72111,DMGDH,18,,78365497
3,158991035,624120,SCHIP1,18,,159615155
10,64893006,21785,NRBF2,18,,64914791
3,8543492,66319,LMCD1,18,,8609811
17,73126319,1571,NT5C,18,,73127890
21,43406939,23557,ZBTB21,18,,43430496
12,13127798,25445,HEBP1,18,,13153243
12,21654698,16639,GOLT1B,18,,21671337
6,43021766,5517,MRPL2,18,,43027283
15,41679546,15112,NDUFAF1,18,,41694658
8,41348172,20327,GOLGA7,18,,41368499
17,73131337,19441,HN1,18,,73150778
17,47287588,12999,ABI3,18,,47300587
8,145437879,3075,HGH1,18,,145440954
5,33936490,2533,RXFP3,18,,33939023
3,44956752,60922,ZDHHC3,18,,45017674
12,118587605,223145,TAOK3,18,,118810750
5,175810939,4989,NOP16,18,,175815928
22,30821610,3431,MTFP1,18,,30825041
14,73436152,57768,ZFYVE1,18,,73493920
4,4420695,123098,STX18,18,,4543793
3,136676706,53220,IL20RB,18,,136729926
1,150266261,15153,MRPS21,18,,150281414
2,64751438,68700,AFTPH,18,,64820138
3,43328003,64631,SNRK,18,,43392634
2,85569077,12744,RETSAT,18,,85581821
2,97525472,10263,SEMA4C,18,,97535735
2,26987141,16958,SLC35F6,18,,27004099
6,10695187,14783,PAK1IP1,18,,10709970
19,39833098,42439,SAMD4B,18,,39875537
16,24930704,95995,ARHGAP17,18,,25026699
14,93673400,22161,UBR7,18,,93695561
6,42174538,11095,MRPS10,18,,42185633
1,44870831,246565,RNF220,18,,45117396
X,154722195,120427,TMLHE,18,,154842622
2,111490149,385650,ACOXL,18,,111875799
3,53850323,30097,CHDH,18,,53880420
1,207217193,9132,YOD1,18,,207226325
2,101869344,17434,CNOT11,18,,101886778
19,39881942,9335,MED29,18,,39891277
X,129336672,66250,ZNF280C,18,,129402922
19,13215713,11850,TRMT1,18,,13227563
10,50942686,27739,OGDHL,18,,50970425
8,19261671,198385,CSGALNACT1,18,,19460056
5,70751441,112208,BDP1,18,,70863649
3,52728499,11600,GLT8D1,18,,52740099
3,121554026,51347,EAF2,18,,121605373
2,143886898,639023,ARHGAP15,18,,144525921
4,56262079,30263,TMEM165,18,,56292342
X,102317580,1588,BEX1,18,,102319168
12,118470496,29483,WSB2,18,,118499979
20,33464327,51442,ACSS2,18,,33515769
X,64135681,118943,ZC4H2,18,,64254624
X,16606121,124219,CTPS2,18,,16730340
9,139933908,6768,NPDC1,18,,139940676
21,33973983,10935,C21orf59,18,,33984918
8,75146934,86662,JPH1,18,,75233596
2,68384961,18409,PNO1,18,,68403370
19,2328628,26472,SPPL2B,18,,2355100
3,128997816,26319,HMCES,18,,129024135
12,5671816,382609,ANO2,18,,6054425
19,19756009,18494,ATP13A1,18,,19774503
1,169822214,40886,SCYL3,18,,169863100
13,50486837,23800,SPRYD7,18,,50510637
1,160370363,28105,VANGL2,18,,160398468
14,63671101,89129,RHOJ,18,,63760230
X,15645438,37716,TMEM27,18,,15683154
1,6526151,31333,PLEKHG5,18,,6557484
17,59942727,62650,INTS2,18,,60005377
3,119013219,125104,ARHGAP31,18,,119138323
12,64238532,303111,SRGAP1,18,,64541643
4,15471488,131692,CC2D2A,18,,15603180
5,90664448,14742,ARRDC3,18,,90679190
1,232533711,117643,SIPA1L2,18,,232651354
10,24872537,140060,ARHGAP21,18,,25012597
16,67756968,83587,RANBP10,18,,67840555
1,166808640,16941,POGK,18,,166825581
X,38660684,5099,MID1IP1,18,,38665783
4,7760439,181214,AFAP1,18,,7941653
4,177241089,12307,SPCS3,18,,177253396
8,70963885,19677,PRDM14,18,,70983562
22,44568835,35514,PARVG,18,,44604349
19,49617617,4100,LIN7B,18,,49621717
1,192127591,27354,RGS18,18,,192154945
15,86302558,35631,KLHL25,18,,86338189
9,135468383,77405,DDX31,18,,135545788
19,10663760,12942,KRI1,18,,10676702
1,228288427,2736,C1orf35,18,,228291163
3,194123402,65566,ATP13A3,18,,194188968
16,4404542,62420,CORO7,18,,4466962
3,113775581,31687,QTRTD1,18,,113807268
5,55395506,133680,ANKRD55,18,,55529186
19,45582529,12253,GEMIN7,18,,45594782
11,122942713,123300,CLMP,18,,123066013
15,77400497,311949,PEAK1,18,,77712446
14,92980124,175215,RIN3,18,,93155339
X,84532394,102354,POF1B,18,,84634748
6,31691120,3365,C6orf25,18,,31694485
17,41102542,13973,AARSD1,18,,41116515
10,7613367,95594,ITIH5,18,,7708961
18,319354,181375,COLEC12,18,,500729
11,72003469,142259,CLPB,18,,72145728
20,37554954,26749,FAM83D,18,,37581703
14,103388992,8187,AMN,18,,103397179
1,26606212,1801,SH3BGRL3,18,,26608013
7,44788529,20950,ZMIZ2,18,,44809479
10,14560555,256341,FAM107B,18,,14816896
19,10203012,10413,ANGPTL6,18,,10213425
11,112047088,42561,BCO2,18,,112089649
1,36805219,46309,STK40,18,,36851528
5,92953430,493974,FAM172A,18,,93447404
7,117350705,162856,CTTNBP2,18,,117513561
22,29469065,73743,KREMEN1,18,,29542808
12,95910335,32285,USP44,18,,95942620
5,134240809,57527,PCBD2,18,,134298336
3,132276981,101994,ACAD11,18,,132378975
22,30184596,49697,ASCC2,18,,30234293
17,36337710,10913,TBC1D3F,18,,36348623
2,113125964,65143,RGPD5,18,,113191107
17,29297955,28974,RNF135,18,,29326929
17,37884752,2064,MIEN1,18,,37886816
17,7218950,13688,NEURL4,18,,7232638
9,135037333,80887,NTNG2,18,,135118220
5,147691989,3492,SPINK7,18,,147695481
8,67039277,48441,TRIM55,18,,67087718
22,26138110,288897,MYO18B,18,,26427007
19,4472192,30040,HDGFRP2,18,,4502232
12,6980099,2350,SPSB2,18,,6982449
4,84457259,69768,AGPAT9,18,,84527027
17,6544221,3640,TXNDC17,18,,6547861
3,9958757,16548,IL17RC,18,,9975305
8,145051319,9320,PARP10,18,,145060639
10,89511268,66720,ATAD1,18,,89577988
10,20105371,473413,PLXDC2,18,,20578784
19,1354975,23455,MUM1,18,,1378430
6,139225151,84247,REPS1,18,,139309398
5,1009076,29851,NKD2,18,,1038927
9,129089122,70790,MVB12B,18,,129159912
11,124623018,9205,ESAM,18,,124632223
14,102606188,70679,WDR20,18,,102676867
5,60240955,207909,NDUFAF2,18,,60448864
20,31870940,26744,BPIFB1,18,,31897684
1,11714913,8471,FBXO44,18,,11723384
8,10463859,48758,RP1L1,18,,10512617
19,55555691,18894,RDH13,18,,55574585
21,26934456,13024,MIR155HG,18,,26947480
1,43282775,27885,ERMAP,18,,43310660
1,145509751,6325,GNRHR2,18,,145516076
17,77020157,25713,C1QTNF1,18,,77045870
2,169659099,62750,NOSTRIN,18,,169721849
5,57878870,276352,RAB3C,18,,58155222
8,104384660,10572,CTHRC1,18,,104395232
2,68361224,23468,WDR92,18,,68384692
1,184020784,22560,TSEN15,18,,184043344
10,119039999,94979,PDZD8,18,,119134978
12,129556270,831942,TMEM132D,18,,130388212
12,19592607,82566,AEBP2,18,,19675173
12,121200312,141843,SPPL3,18,,121342155
18,33048290,29665,INO80C,18,,33077955
1,202102531,11340,ARL8A,18,,202113871
2,242752026,6713,NEU4,18,,242758739
2,170684017,256622,UBR3,18,,170940639
3,180701497,5809,DNAJC19,18,,180707306
5,78531924,91114,JMY,18,,78623038
5,34929697,29372,DNAJC21,18,,34959069
5,162873533,13627,NUDCD2,18,,162887160
8,42995591,62379,HGSNAT,18,,43057970
21,33947150,10695,TCP10L,18,,33957845
20,35405844,86243,SOGA1,18,,35492087
11,94898676,67029,SESN3,18,,94965705
11,94300473,54114,PIWIL4,18,,94354587
12,124457761,42225,ZNF664,18,,124499986
18,43753987,92968,C18orf25,18,,43846955
18,28956739,38132,DSG4,18,,28994871
1,43638000,38549,CFAP57,18,,43676549
20,60697516,12918,LSM14B,18,,60710434
2,61167547,77847,PUS10,18,,61245394
5,122680578,78708,CEP120,18,,122759286
1,100549100,49551,SASS6,18,,100598651
3,64079525,131606,PRICKLE2,18,,64211131
7,97841565,706,BHLHA15,18,,97842271
22,41921805,18688,POLR3H,18,,41940493
1,36273827,49663,AGO4,18,,36323490
11,68816349,41723,TPCN2,18,,68858072
6,116421998,144855,NT5DC1,18,,116566853
6,117113247,36973,GPRC6A,18,,117150220
17,53046125,195324,STXBP4,18,,53241449
6,97590036,141016,MMS22L,18,,97731052
14,36007557,270972,RALGAPA1,18,,36278529
1,205758220,24104,SLC41A1,18,,205782324
6,18387580,81525,RNF144B,18,,18469105
13,28712642,156833,PAN3,18,,28869475
10,23481459,1722,PTF1A,18,,23483181
4,128838959,48180,MFSD8,18,,128887139
13,106111405,46625,DAOA-AS1,18,,106158030
6,42847353,10281,RPL7L1,18,,42857634
15,33057744,302489,FMN1,18,,33360233
12,53083410,13837,KRT77,18,,53097247
6,150690027,35738,IYD,18,,150725765
X,151927733,1005,CSAG3,18,,151928738
8,7829182,1593,USP17L8,18,,7830775
8,11985366,1440,LOC392196,18,,11986806
22,46508628,74,MIRLET7A3,18,,46508702
13,92003445,87,MIR19B1,18,,92003532
8,135817118,70,MIR30D,18,,135817188
22,42296947,69,MIR33A,18,,42297016
X,53583183,119,MIR98,18,,53583302
11,75046135,95,MIR326,18,,75046230
11,2155363,76,MIR483,18,,2155439
8,7194636,1593,USP17L4,18,,7196229
8,7833914,1593,USP17L3,18,,7835507
8,12236775,523,LOC649352,18,,12237298
2,130831107,55688,POTEF,18,,130886795
4,9364854,1593,USP17L5,18,,9366447
X,140096760,1116,SPANXB1,18,,140097876
17,36337527,11094,TBC1D3,18,,36348621
8,124693033,56633,ANXA13,17,,124749666
3,197236653,46205,BDH1,17,,197282858
20,17474549,65056,BFSP1,17,,17539605
2,43449540,4205,ZFP36L2,17,,43453745
X,135570124,4474,BRS3,17,,135574598
11,61556601,3484,TMEM258,17,,61560085
16,61685914,384825,CDH8,17,,62070739
5,24487208,157879,CDH10,17,,24645087
16,66942024,10863,CDH16,17,,66952887
18,580342,1678,CETN1,17,,582020
7,130020211,7738,CPA1,17,,130027949
22,27017927,8709,CRYBA4,17,,27026636
12,77252494,20326,CSRP2,17,,77272820
11,65647283,3929,CTSW,17,,65651212
1,28303783,111365,EYA3,17,,28415148
9,116230,2187,FOXD4,17,,118417
16,86612114,3190,FOXL1,17,,86615304
5,170210722,30328,GABRP,17,,170241050
11,22688159,146388,GAS2,17,,22834547
19,18979354,27599,GDF1,17,,19006953
7,93551015,4811,GNG11,17,,93555826
1,27719147,3170,GPR3,17,,27722317
3,98250742,2781,GPR15,17,,98253523
12,54892567,44332,NCKAP1L,17,,54936899
7,27139972,2422,HOXA2,17,,27142394
7,27185201,2192,HOXA6,17,,27187393
17,46689707,2594,HOXB8,17,,46692301
X,130407482,15921,IGSF1,17,,130423403
6,76630830,151565,IMPG1,17,,76782395
10,134351282,245702,INPP5A,17,,134596984
1,160051359,7853,KCNJ9,17,,160059212
2,18059113,55112,KCNS3,17,,18114225
17,39549976,3868,KRT31,17,,39553844
12,25205180,56089,LRMP,17,,25261269
8,144099901,3926,LY6E,17,,144103827
X,151301782,5268,MAGEA10,17,,151307050
22,37865100,17325,MFNG,17,,37882425
14,71189242,86646,MAP3K9,17,,71275888
17,41952726,34353,MPP2,17,,41987079
12,81101407,1849,MYF6,17,,81103256
17,10293641,31626,MYH8,17,,10325267
15,72118360,292080,MYO9A,17,,72410440
3,120315127,6131,NDUFB4,17,,120321258
1,116378998,4335,NHLH2,17,,116383333
6,142395620,14316,NMBR,17,,142409936
11,65554504,10186,OVOL1,17,,65564690
19,708952,39378,PALM,17,,748330
3,74311719,258572,CNTN3,17,,74570291
4,30722036,426387,PCDH7,17,,31148423
7,31823125,287349,PDE1C,17,,32110474
X,54959566,60945,PFKFB1,17,,55020511
10,118380464,24190,PNLIPRP2,17,,118404654
5,122359077,13348,PPIC,17,,122372425
2,210867288,19696,RPE,17,,210886984
16,1994579,10100,RPL3L,17,,2004679
X,118920466,5156,RPL39,17,,118925622
19,45988545,11768,RTN2,17,,46000313
19,15072124,18423,SLC1A6,17,,15090547
11,107578100,4687,SLN,17,,107582787
19,7985193,2943,SNAPC2,17,,7988136
1,155165378,12394,THBS3,17,,155177772
11,844080,23036,TSPAN4,17,,867116
6,125475334,110218,TPD52L1,17,,125585552
4,69870294,15821,UGT2B10,17,,69886115
12,85674035,21526,ALX1,17,,85695561
19,6361462,7453,CLPP,17,,6368915
4,8368008,74444,ACOX3,17,,8442452
22,38219388,2114,GALR3,17,,38221502
12,123237367,18244,DENR,17,,123255611
1,100731713,26612,RTCA,17,,100758325
12,89913189,5394,GALNT4,17,,89918583
6,133065008,19590,VNN2,17,,133084598
X,2746862,53999,GYG2,17,,2800861
1,27681669,11688,MAP3K6,17,,27693357
11,61281187,67157,SYT7,17,,61348344
16,619967,14169,PIGQ,17,,634136
2,42577635,10748,COX7A2L,17,,42588383
1,180601145,258270,XPR1,17,,180859415
2,196998306,38030,STK17B,17,,197036336
4,13369346,116643,RAB28,17,,13485989
13,100153627,62675,TM9SF2,17,,100216302
19,38810483,9166,KCNK6,17,,38819649
11,12132122,153215,MICAL2,17,,12285337
22,50781745,101773,PPP6R2,17,,50883518
19,47852537,33424,DHX34,17,,47885961
17,45772629,16800,TBKBP1,17,,45789429
14,58894102,121447,KIAA0586,17,,59015549
10,73845983,2807,SPOCK2,17,,73848790
11,73019662,60763,ARHGEF17,17,,73080425
9,35538628,23267,RUSC2,17,,35561895
2,235401685,4012,ARL4C,17,,235405697
2,99935486,17374,TXNDC9,17,,99952860
3,183960116,7197,ALG3,17,,183967313
9,133884503,83943,LAMC3,17,,133968446
2,170366211,16561,KLHL41,17,,170382772
19,17905918,18467,B3GNT3,17,,17924385
X,18257432,115412,SCML2,17,,18372844
4,1160720,6279,SPON2,17,,1166999
19,18284589,4345,IFI30,17,,18288934
19,18979354,27599,CERS1,17,,19006953
1,114436816,10729,AP4B1,17,,114447545
3,35721115,6264,ARPP21,17,,35727379
21,44269335,30358,WDR4,17,,44299693
21,47556175,19306,FTCD,17,,47575481
20,36145818,10515,BLCAP,17,,36156333
7,6500711,23138,KDELR2,17,,6523849
5,6714717,42444,PAPD7,17,,6757161
15,89631380,114211,ABHD2,17,,89745591
10,123499935,187643,ATE1,17,,123687578
4,147096834,14379,LSM6,17,,147111213
5,177027118,10228,B4GALT7,17,,177037346
7,98992297,14008,PDAP1,17,,99006305
19,14258548,58449,LPHN1,17,,14316997
10,1102775,75462,WDR37,17,,1178237
20,3088218,52338,UBOX5,17,,3140556
14,64971291,20378,ZBTB1,17,,64991669
2,88991175,59277,RPIA,17,,89050452
9,114325246,36889,PTGR1,17,,114362135
3,155197670,196435,PLCH1,17,,155394105
1,200938513,54315,KIF21B,17,,200992828
20,39807088,121651,ZHX3,17,,39928739
12,122242637,27925,SETD1B,17,,122270562
12,133302252,36222,ANKLE2,17,,133338474
15,78463186,63863,ACSBG1,17,,78527049
8,143692404,3429,ARC,17,,143695833
18,8717368,115407,MTCL1,17,,8832775
1,200708685,121150,CAMSAP2,17,,200829835
11,6621143,3737,RRP8,17,,6624880
3,15247732,46691,CAPN7,17,,15294423
16,29690328,19693,QPRT,17,,29710021
11,67131638,10010,CLCF1,17,,67141648
18,59711457,142832,PIGN,17,,59854289
16,75562427,6641,CHST5,17,,75569068
17,7155519,7740,ELP5,17,,7163259
6,138725335,9247,HEBP2,17,,138734582
3,12598512,26698,MKRN2,17,,12625210
22,47158513,412829,TBC1D22A,17,,47571342
2,33808727,15702,FAM98A,17,,33824429
1,95699710,13071,RWDD3,17,,95712781
16,30368421,13101,TBC1D10B,17,,30381522
19,16296211,6646,FAM32A,17,,16302857
9,123631850,7756,PHF19,17,,123639606
9,37510888,65362,FBXO10,17,,37576250
21,31538240,731,CLDN17,17,,31538971
14,58875369,18963,TIMM9,17,,58894332
15,73852343,73410,NPTN,17,,73925753
1,63788729,2068,FOXD3,17,,63790797
4,76831807,30359,NAAA,17,,76862166
2,69623244,41516,NFU1,17,,69664760
3,167726460,87253,GOLIM4,17,,167813713
17,26646120,9591,TMEM97,17,,26655711
22,43528211,11192,MCAT,17,,43539403
20,61273796,29851,SLCO4A1,17,,61303647
11,134118172,5088,THYN1,17,,134123260
22,30163357,3045,UQCR10,17,,30166402
16,4897631,34771,UBN1,17,,4932402
7,26331514,82435,SNX10,17,,26413949
19,12873816,12618,HOOK2,17,,12886434
7,128095883,2589,HILPDA,17,,128098472
X,96138906,1544,RPA4,17,,96140450
1,17531620,40881,PADI1,17,,17572501
21,33245627,130750,HUNK,17,,33376377
7,141478288,900,TAS2R4,17,,141479188
2,73956963,7570,TPRKB,17,,73964533
5,114948904,12972,TMED7,17,,114961876
11,57479994,28451,TMX2,17,,57508445
8,17013835,66406,ZDHHC2,17,,17080241
5,138723256,2349,MZB1,17,,138725605
12,7247145,14729,C1RL,17,,7261874
7,37888198,51804,NME8,17,,37940002
3,157827840,434784,RSRC1,17,,158262624
18,48700919,23132,MEX3C,17,,48724051
7,56019610,3423,MRPS17,17,,56023033
3,52444523,13134,PHF7,17,,52457657
8,92082423,16900,OTUD6B,17,,92099323
14,60610836,21375,DHRS7,17,,60632211
2,239335568,25323,ASB1,17,,239360891
16,1988233,5061,MSRB1,17,,1993294
16,848040,2693,GNG13,17,,850733
11,616564,8503,CDHR5,17,,625067
7,112720467,7366,GPR85,17,,112727833
5,145583162,85622,RBM27,17,,145668784
2,118673053,98686,CCDC93,17,,118771739
9,104152248,8671,MRPL50,17,,104160919
X,47001614,2995,NDUFB11,17,,47004609
22,19775933,66529,GNB1L,17,,19842462
3,45864809,92407,LZTFL1,17,,45957216
2,219845808,4571,FEV,17,,219850379
10,123716602,18141,NSMCE4A,17,,123734743
10,104503726,72295,WBP1L,17,,104576021
1,156564099,7180,GPATCH4,17,,156571279
4,492988,40722,PIGG,17,,533710
9,20658307,337647,FOCAD,17,,20995954
16,55542912,77670,LPCAT2,17,,55620582
14,35554673,37075,PPP2R3C,17,,35591748
4,164445449,858958,1-Mar,17,,165304407
7,30050198,16219,FKBP14,17,,30066417
2,131862419,45006,PLEKHB2,17,,131907425
1,90286572,115417,LRRC8D,17,,90401989
3,138327541,24672,FAIM,17,,138352213
10,72058725,83681,LRRC20,17,,72142406
1,33611002,36669,TRIM62,17,,33647671
8,37701397,6034,BRF2,17,,37707431
12,28343359,359740,CCDC91,17,,28703099
11,45825622,8945,SLC35C1,17,,45834567
2,202316391,29183,STRADB,17,,202345574
18,670323,42339,ENOSF1,17,,712662
1,154521050,10070,UBE2Q1,17,,154531120
1,70610484,60877,LRRC40,17,,70671361
2,32390909,58539,SLC30A6,17,,32449448
2,97258891,45225,KANSL3,17,,97304116
1,36621565,24886,MAP7D1,17,,36646451
4,183164583,559594,TENM3,17,,183724177
16,22308695,37729,POLR3E,17,,22346424
3,129158878,80472,IFT122,17,,129239350
20,44034654,4596,DBNDD2,17,,44039250
1,4715104,122750,AJAP1,17,,4837854
22,50609159,9565,PANX2,17,,50618724
3,124624288,29307,MUC13,17,,124653595
9,27524311,2185,IFNK,17,,27526496
19,5785152,6097,DUS3L,17,,5791249
7,192968,107772,FAM20C,17,,300740
5,130599701,130681,CDC42SE2,17,,130730382
22,38054736,8203,PDXP,17,,38062939
18,9334764,67654,TWSG1,17,,9402418
17,7293046,5116,PLSCR3,17,,7298162
5,135548998,152166,TRPC7,17,,135701164
4,106603784,26097,INTS12,17,,106629881
17,37219555,88347,PLXDC1,17,,37307902
20,37101448,106056,RALGAPB,17,,37207504
7,152456833,95631,ACTR3B,17,,152552464
5,166711842,979320,TENM2,17,,167691162
6,44266462,14601,AARS2,17,,44281063
11,101785745,86051,KIAA1377,17,,101871796
4,48343612,84603,SLAIN2,17,,48428215
6,107386384,49252,BEND3,17,,107435636
11,40135750,1345436,LRRC4C,17,,41481186
11,9041046,72104,SCUBE2,17,,9113150
1,24646055,35753,GRHL3,17,,24681808
17,53828465,26283,PCTP,17,,53854748
1,150980866,27323,PRUNE,17,,151008189
12,53693469,7496,C12orf10,17,,53700965
X,153734489,10077,FAM3A,17,,153744566
11,6701615,3017,MRPL17,17,,6704632
1,174982093,10498,MRPS14,17,,174992591
6,32096483,1584,FKBPL,17,,32098067
21,15857548,98175,SAMSN1,17,,15955723
2,38521098,83467,ATL2,17,,38604565
12,56414688,17531,IKZF4,17,,56432219
5,141032967,28833,ARAP3,17,,141061800
X,140785567,1088,SPANXC,17,,140786655
16,903634,117350,LMF1,17,,1020984
2,60983364,45857,PAPOLG,17,,61029221
6,44081190,14038,MRPL14,17,,44095228
7,42971938,5515,MRPL32,17,,42977453
2,202484906,23346,TMEM237,17,,202508252
11,8413412,202424,STK33,17,,8615836
20,3170995,14348,DDRGK1,17,,3185343
12,132628971,8047,NOC4L,17,,132637018
11,60681370,9545,TMEM109,17,,60690915
16,30435018,6355,DCTPP1,17,,30441373
22,38082343,7142,NOL12,17,,38089485
3,126177743,17019,ZXDC,17,,126194762
1,157715522,31400,FCRL2,17,,157746922
16,29827527,6289,PAGR1,17,,29833816
X,105937067,103179,RNF128,17,,106040246
4,126237566,176521,FAT4,17,,126414087
5,167982627,23987,PANK3,17,,168006614
17,74466974,17017,RHBDF2,17,,74483991
19,50380681,11326,TBC1D17,17,,50392007
8,77593514,186007,ZFHX4,17,,77779521
7,40174574,725792,SUGCT,17,,40900366
15,59171243,54632,SLTM,17,,59225875
10,88695297,22128,MMRN2,17,,88717425
12,57984941,12270,PIP4K2C,17,,57997211
9,26840682,52144,CAAP1,17,,26892826
4,122052563,85219,TNIP3,17,,122137782
20,327369,8143,NRSN2,17,,335512
11,62104773,56114,ASRGL1,17,,62160887
1,184659624,64417,EDEM3,17,,184724041
4,7060621,9316,GRPEL1,17,,7069937
22,43599228,140166,SCUBE1,17,,43739394
6,30038042,5586,RNF39,17,,30043628
7,2671602,32834,TTYH3,17,,2704436
22,36044423,20033,APOL6,17,,36064456
22,36536370,20607,APOL3,17,,36556977
3,14530618,51232,GRIP2,17,,14581850
7,74470621,19096,WBSCR16,17,,74489717
2,97371666,34147,LMAN2L,17,,97405813
4,110631144,20098,PLA2G12A,17,,110651242
9,88879462,18028,ISCA1,17,,88897490
12,44122409,30167,PUS7L,17,,44152576
19,3490818,10120,DOHH,17,,3500938
19,46913585,3334,CCDC8,17,,46916919
2,135954538,333762,ZRANB3,17,,136288300
2,190306158,34130,WDR75,17,,190340288
2,75719443,68649,EVA1A,17,,75788092
7,74247755,20117,GTF2IRD2,17,,74267872
11,102921412,41532,DCUN1D5,17,,102962944
10,82173574,19179,FAM213A,17,,82192753
3,148847370,43613,HPS3,17,,148890983
4,109745037,478486,COL25A1,17,,110223523
7,22980877,72893,FAM126A,17,,23053770
17,58254690,214896,USP32,17,,58469586
7,30067976,56302,PLEKHA8,17,,30124278
1,161676761,7381,FCRLA,17,,161684142
16,75032914,111978,ZNRF1,17,,75144892
1,52870218,13774,PRPF38A,17,,52883992
3,15469063,15057,EAF1,17,,15484120
12,56214743,8677,DNAJC14,17,,56223420
16,76311114,283533,CNTNAP4,17,,76594647
X,150884507,7157,FATE1,17,,150891664
15,90118817,52436,TICRR,17,,90171253
15,40674921,11568,KNSTRN,17,,40686489
2,39024875,78200,DHX57,17,,39103075
12,50031723,69474,FMNL3,17,,50101197
22,24176689,4510,DERL3,17,,24181199
10,27484142,46926,ACBD5,17,,27531068
12,123718290,24216,C12orf65,17,,123742506
X,109917083,122203,CHRDL1,17,,110039286
5,150273953,10592,ZNF300,17,,150284545
11,77589765,115952,INTS4,17,,77705717
10,135207620,26554,MTG1,17,,135234174
20,18568536,176024,DTD1,17,,18744560
19,17530655,5493,MVB12A,17,,17536148
11,18101889,25749,SAAL1,17,,18127638
15,40763159,2198,CHST14,17,,40765357
1,33546713,39419,AZIN2,17,,33586132
11,63137260,40452,SLC22A9,17,,63177712
1,157764193,25747,FCRL1,17,,157789940
3,120043575,24611,LRRC58,17,,120068186
1,162365055,16873,SH2D1B,17,,162381928
6,111408780,135826,SLC16A10,17,,111544606
10,104474297,24649,SFXN2,17,,104498946
10,120900424,24780,SFXN4,17,,120925204
15,86623038,949245,AGBL1,17,,87572283
1,156495196,47200,IQGAP3,17,,156542396
1,156561557,2534,APOA1BP,17,,156564091
5,158690074,22974,UBLCP1,17,,158713048
6,126277860,23529,HINT3,17,,126301389
7,100663363,38777,MUC17,17,,100702140
7,156433440,36380,RNF32,17,,156469820
X,101380659,2025,TCEAL2,17,,101382684
9,140125208,5798,SLC34A3,17,,140131006
11,95502105,20849,FAM76B,17,,95522954
12,122356462,53512,WDR66,17,,122409974
17,19581627,38416,SLC47A2,17,,19620043
18,57098170,266474,CCBE1,17,,57364644
19,56347943,45277,NLRP4,17,,56393220
1,114631913,64559,SYT6,17,,114696472
4,47849249,67435,NFXL1,17,,47916684
5,145316125,126754,SH3RF2,17,,145442879
6,124124990,1021796,NKAIN2,17,,125146786
8,127564682,6029,FAM84B,17,,127570711
5,71735725,67524,ZNF366,17,,71803249
6,139561198,52010,TXLNB,17,,139613208
7,33944522,250962,BMPER,17,,34195484
15,100511642,370568,ADAMTS17,17,,100882210
11,278569,6819,NLRP6,17,,285388
16,27236314,43799,NSMCE1,17,,27280113
19,36233427,2916,U2AF1L4,17,,36236343
18,71740587,74513,FBXO15,17,,71815100
13,27640286,105747,USP12,17,,27746033
11,68658745,12558,MRPL21,17,,68671303
18,47901391,19147,SKA1,17,,47920538
10,61410521,59128,SLC16A9,17,,61469649
6,18155618,68466,KDM1B,17,,18224084
7,6448746,38897,DAGLB,17,,6487643
7,11410061,461763,THSD7A,17,,11871824
7,5322560,21144,SLC29A4,17,,5343704
2,29038862,24813,SPDYA,17,,29063675
2,10861774,63462,ATP6V1C2,17,,10925236
11,74459912,93546,RNF169,17,,74553458
6,119134611,118292,MCM9,17,,119252903
12,11138511,1000,TAS2R50,17,,11139511
11,65190268,3735,NEAT1,17,,65194003
12,65004292,87055,RASSF3,17,,65091347
16,2261602,3220,PGP,17,,2264822
17,72733355,10119,RAB37,17,,72743474
10,118956999,12811,KCNK18,17,,118969810
19,7793842,3215,CLEC4G,17,,7797057
5,1201709,23521,SLC6A19,17,,1225230
17,59667793,770,NACA2,17,,59668563
20,2361553,51846,TGM6,17,,2413399
2,17935426,31754,GEN1,17,,17967180
1,234509428,10367,COA6,17,,234519795
4,9369599,1197,USP17L6P,17,,9370796
11,43602943,90,MIR129-2,17,,43603033
3,160122375,98,MIR15B,17,,160122473
19,13985512,110,MIR181C,17,,13985622
15,79502129,84,MIR184,17,,79502213
17,29887014,88,MIR193A,17,,29887102
1,220291194,110,MIR215,17,,220291304
1,205417429,97,MIR135B,17,,205417526
10,129347612,3323,NPS,17,,129350935
10,48255203,16165,ANXA8,17,,48271368
12,11544473,4025,PRB2,17,,11548498
10,47746849,16191,ANXA8L1,17,,47763040
4,9364854,1593,USP17L24,17,,9366447
4,9364854,1593,USP17L25,17,,9366447
4,9364854,1593,USP17L26,17,,9366447
4,9364854,1593,USP17L27,17,,9366447
4,9364854,1593,USP17L28,17,,9366447
4,9364854,1593,USP17L29,17,,9366447
4,9364854,1593,USP17L30,17,,9366447
4,9212382,1593,USP17L10,17,,9213975
4,9259849,1593,USP17L11,17,,9261442
4,9264597,1593,USP17L12,17,,9266190
4,9226621,1593,USP17L13,17,,9228214
4,9245604,1593,USP17L17,17,,9247197
4,9250355,1593,USP17L18,17,,9251948
4,9255103,1593,USP17L19,17,,9256696
4,9269344,1593,USP17L20,17,,9270937
4,9264597,1593,USP17L21,17,,9266190
4,9269344,1593,USP17L22,17,,9270937
4,9236110,1950,USP17L15,17,,9238060
7,36552548,211606,AOAH,16,,36764154
11,64863586,15746,VPS51,16,,64879332
11,30406039,201891,MPPED2,16,,30607930
X,110488326,25448,CAPN6,16,,110513774
9,139942550,5953,ENTPD2,16,,139948503
13,49063098,44294,RCBTB2,16,,49107392
6,31937587,2445,DXO,16,,31940032
1,206764973,20931,EIF2D,16,,206785904
17,74132414,4966,FOXJ1,16,,74137380
X,49363615,9524,GAGE1,16,,49373139
22,24615621,25489,GGT5,16,,24641110
1,228327928,8727,GUK1,16,,228336655
1,196912897,15459,CFHR2,16,,196928356
8,76452202,26859,HNF4G,16,,76479061
19,49654455,4226,HRC,16,,49658681
17,73008758,8598,ICT1,16,,73017356
16,31404632,33194,ITGAD,16,,31437826
11,123986110,31508,VWA5A,16,,124017618
3,115521209,643176,LSAMP,16,,116164385
17,41717757,21505,MEOX1,16,,41739262
4,140586921,74978,MGST2,16,,140661899
13,24304327,159260,MIPEP,16,,24463587
17,41878166,32381,MPP3,16,,41910547
2,201936461,14012,NDUFB3,16,,201950473
13,52706778,27218,NEK3,16,,52733996
15,64979772,15708,OAZ2,16,,64995480
17,2995351,939,OR1D2,16,,2996290
4,74719012,1189,PF4V1,16,,74720201
9,96338908,102961,PHF2,16,,96441869
8,82352563,7156,PMP2,16,,82359719
12,11081834,5610,PRH2,16,,11087444
19,43757433,16282,PSG9,16,,43773715
16,67927174,36407,PSKH1,16,,67963581
2,120517206,225268,PTPN4,16,,120742474
14,21152371,16390,RNASE4,16,,21168761
13,26786904,9604,RNF6,16,,26796508
14,50085405,1998,RPL36AL,16,,50087403
12,58138771,3255,TSPAN31,16,,58142026
11,118004091,19539,SCN4B,16,,118023630
14,62229074,34072,SNAPC1,16,,62263146
11,8714898,217600,ST5,16,,8932498
3,52744795,60170,NEK4,16,,52804965
19,55684468,7252,SYT5,16,,55691720
9,35605280,4758,TESK1,16,,35610038
6,49660070,21233,CRISP2,16,,49681303
12,3000032,50274,TULP3,16,,3050306
7,100331248,64171,ZAN,16,,100395419
2,219724545,14409,WNT6,16,,219738954
22,20748404,14349,ZNF74,16,,20762753
6,35227490,36274,ZNF76,16,,35263764
15,23810453,2713,MKRN3,16,,23813166
20,18268926,28714,ZNF133,16,,18297640
16,3451189,3854,ZNF174,16,,3455043
19,44507076,10996,ZNF230,16,,44518072
1,38022519,9939,DNALI1,16,,38032458
2,86830515,20485,RNF103,16,,86851000
12,8798538,16946,MFAP5,16,,8815484
Y,1660485,10926,AKAP17A,16,,1671411
X,15808573,32809,ZRSR2,16,,15841382
3,133118838,75218,BFSP2,16,,133194056
8,59496063,75903,NSMAF,16,,59571966
1,206808880,13662,DYRK3,16,,206822542
16,30016834,8083,DOC2A,16,,30024917
17,26850958,14217,FOXN1,16,,26865175
1,45285515,23101,PTCH2,16,,45308616
3,118930588,29164,B4GALT4,16,,118959752
1,193147859,7884,B3GALT2,16,,193155743
18,31431063,372452,NOL4,16,,31803515
X,149861836,71740,MTMR1,16,,149933576
15,90224761,9254,PEX11A,16,,90234015
2,219824349,2528,CDK5R2,16,,219826877
3,46449048,1966,CCRL2,16,,46451014
17,26800663,24135,SLC13A2,16,,26824798
3,155544300,27948,SLC33A1,16,,155572248
16,30845361,60262,BCL7C,16,,30905623
2,105880846,65325,TGFBRAP1,16,,105946171
X,24576203,114776,PCYT1B,16,,24690979
1,28199053,14143,THEMIS2,16,,28213196
17,59533848,28623,TBX4,16,,59562471
22,30950621,10280,GAL3ST1,16,,30960901
2,175212877,47566,CIR1,16,,175260443
5,139226363,196521,NRG2,16,,139422884
15,43825659,56792,PPIP5K1,16,,43882451
8,109455811,45606,EMC2,16,,109501417
6,52362199,79663,TRAM2,16,,52441862
16,1560427,101682,IFT140,16,,1662109
12,121124926,14741,MLEC,16,,121139667
X,46771710,148931,JADE3,16,,46920641
1,229761962,33985,URB2,16,,229795947
5,146965003,197408,JAKMIP2,16,,147162411
2,160625138,29628,CD302,16,,160654766
17,14204366,48355,HS3ST3B1,16,,14252721
15,77336359,27211,TSPAN3,16,,77363570
20,62329994,9371,ARFRP1,16,,62339365
1,11249345,6693,ANGPTL7,16,,11256038
X,48750729,4697,TIMM17B,16,,48755426
14,23825608,9234,EFS,16,,23834842
3,40351172,2743,EIF1B,16,,40353915
16,31885078,43551,ZNF267,16,,31928629
16,24266873,106864,CACNG3,16,,24373737
6,26440699,12944,BTN3A3,16,,26453643
1,79115476,14287,IFI44,16,,79129763
15,74833517,56955,ARID3B,16,,74890472
8,30013812,27343,DCTN6,16,,30041155
17,18923989,26347,GRAP,16,,18950336
19,58694355,30573,ZNF274,16,,58724928
12,3186520,209210,TSPAN9,16,,3395730
17,72537204,5106,CD300C,16,,72542310
11,86152149,231091,ME3,16,,86383240
16,2867163,4560,PRSS21,16,,2871723
6,89790428,4451,PNRC1,16,,89794879
11,66112842,2319,B3GNT1,16,,66115161
15,41601465,23354,OIP5,16,,41624819
6,84833959,103394,CEP162,16,,84937353
10,93808396,194640,CPEB3,16,,94003036
12,122516633,115261,MLXIP,16,,122631894
6,90142896,200657,ANKRD6,16,,90343553
20,11873140,34103,BTBD3,16,,11907243
11,60635014,8150,ZP1,16,,60643164
5,75379238,250543,SV2C,16,,75629781
11,108376157,88217,EXPH5,16,,108464374
7,149473130,57923,SSPO,16,,149531053
1,109472129,33992,CLCC1,16,,109506121
3,182511290,128131,ATP11B,16,,182639421
11,9160374,126499,DENND5A,16,,9286873
22,45588122,48528,KIAA0930,16,,45636650
22,28374001,701852,TTC28,16,,29075853
7,128864854,205198,AHCYL2,16,,129070052
19,19431629,37934,MAU2,16,,19469563
9,100174301,84104,TDRD7,16,,100258405
1,100435344,57190,SLC35A3,16,,100492534
16,67001377,7675,CES3,16,,67009052
7,141627156,19627,CLEC5A,16,,141646783
1,155290639,10270,RUSC1,16,,155300909
14,85996368,98672,FLRT2,16,,86095040
3,49059073,1853,NDUFAF3,16,,49060926
8,37654400,47104,GPR124,16,,37701504
7,99014361,22101,PTCD1,16,,99036462
X,134184962,1259,FAM127B,16,,134186221
14,73393039,33318,DCAF4,16,,73426357
2,149402559,142577,EPC2,16,,149545136
2,239229184,80357,TRAF3IP1,16,,239309541
2,27667239,45439,IFT172,16,,27712678
6,155538096,40761,TIAM2,16,,155578857
8,356807,63068,FBXO25,16,,419875
17,27181974,6111,ERAL1,16,,27188085
2,131113579,19403,PTPN18,16,,131132982
13,45513383,50230,NUFIP1,16,,45563613
1,213224574,222234,RPS6KC1,16,,213446808
9,6011018,4622,RANBP6,16,,6015640
9,130670164,9141,ST6GALNAC4,16,,130679305
22,37678423,32966,CYTH4,16,,37711389
6,76017799,185746,FILIP1,16,,76203545
9,140100118,13695,NDOR1,16,,140113813
5,148753829,5009,IL17B,16,,148758838
1,3371146,26531,ARHGEF16,16,,3397677
3,29322802,729084,RBMS3,16,,30051886
3,23933571,24966,NKIRAS1,16,,23958537
1,156024516,3785,LAMTOR2,16,,156028301
11,93474759,21509,C11orf54,16,,93496268
12,82746082,6117,CCDC59,16,,82752199
11,2425745,18530,TRPM5,16,,2444275
9,130159416,10754,SLC2A8,16,,130170170
6,155585146,12536,CLDN20,16,,155597682
3,127348001,43652,PODXL2,16,,127391653
10,135138927,11548,CALY,16,,135150475
15,83806803,69967,HDGFRP3,16,,83876770
12,11060524,1637,TAS2R13,16,,11062161
12,11090852,954,TAS2R14,16,,11091806
1,93615298,30948,TMED5,16,,93646246
8,97251625,22216,MTERF3,16,,97273841
16,4390251,11122,PAM16,16,,4401373
16,11772935,63799,TXNDC11,16,,11836734
8,133787603,73449,PHF20L1,16,,133861052
1,38478383,12114,UTP11L,16,,38490497
1,228595635,8948,TRIM17,16,,228604583
6,84569369,100777,CYB5R4,16,,84670146
7,129932973,31047,CPA4,16,,129964020
1,147119167,23467,ACP6,16,,147142634
X,103077254,9958,RAB9B,16,,103087212
14,96001322,9733,GLRX5,16,,96011055
6,107349375,23415,C6orf203,16,,107372790
2,85822836,1995,RNF181,16,,85824831
17,48445227,5335,MRPL27,16,,48450562
8,23386307,46669,SLC25A37,16,,23432976
10,125767181,85942,CHST15,16,,125853123
2,27435218,4828,ATRAID,16,,27440046
8,27491576,38961,SCARA3,16,,27530537
18,29672568,38956,RNF138,16,,29711524
5,139027876,35594,CXXC5,16,,139063470
14,96831072,22555,GSKIP,16,,96853627
1,31769828,67972,ZCCHC17,16,,31837800
16,19513014,20436,GDE1,16,,19533450
1,101455179,36183,DPH5,16,,101491362
7,5938340,27263,CCZ1,16,,5965603
12,66530715,33137,TMBIM4,16,,66563852
22,24891250,31303,UPB1,16,,24922553
12,27124505,42834,TM7SF3,16,,27167339
4,174089903,155215,GALNT7,16,,174245118
4,88343727,36879,NUDT9,16,,88380606
5,176728190,2555,RAB24,16,,176730745
5,16473146,144021,FAM134B,16,,16617167
17,33458340,10930,NLE1,16,,33469270
16,84002236,34143,NECAB2,16,,84036379
3,49027340,17241,P4HTM,16,,49044581
7,37960162,31380,EPDR1,16,,37991542
10,126630691,45314,ZRANB1,16,,126676005
8,25285363,30621,KCTD9,16,,25315984
3,47537129,18070,ELP6,16,,47555199
16,68056846,56380,DUS2,16,,68113226
19,49223841,20129,RASIP1,16,,49243970
1,36554452,5081,ADPRHL2,16,,36559533
20,62571181,11346,UCKL1,16,,62582527
1,53679771,6540,C1orf123,16,,53686311
9,102668914,67904,STX17,16,,102736818
13,107195661,24853,ARGLU1,16,,107220514
3,43407817,255743,ANO10,16,,43663560
6,43638933,16616,MRPS18A,16,,43655549
10,12171639,40318,SEC61A2,16,,12211957
12,123773655,61333,SBNO1,16,,123834988
1,25757348,69350,TMEM57,16,,25826698
19,46969747,5073,PNMAL1,16,,46974820
7,66461791,242716,TYW1,16,,66704507
1,59762624,465778,FGGY,16,,60228402
19,18747774,33535,KLHL26,16,,18781309
16,70380731,26555,DDX19A,16,,70407286
15,71123862,21935,LARP6,16,,71145797
4,5053243,449485,STK32B,16,,5502728
9,100961279,56724,TBC1D2,16,,101018003
17,3710044,39501,C17orf85,16,,3749545
20,1609797,28628,SIRPG,16,,1638425
12,95611521,85045,VEZT,16,,95696566
1,24286300,3649,PNRC2,16,,24289949
14,31028328,60939,G2E3,16,,31089267
8,110586404,117616,SYBU,16,,110704020
1,27114678,10216,PIGV,16,,27124894
2,128395995,36769,LIMS2,16,,128432764
3,183415605,114808,YEATS2,16,,183530413
20,50767816,40708,ZFP64,16,,50808524
8,28625174,122524,INTS9,16,,28747698
13,96453835,251901,UGGT2,16,,96705736
5,179382066,117052,RNF130,16,,179499118
2,216903110,43429,PECR,16,,216946539
16,81040102,24988,CENPN,16,,81065090
12,16701305,59843,LMO3,16,,16761148
16,23568861,16849,UBFD1,16,,23585710
5,140571951,3262,PCDHB10,16,,140575213
14,21966274,13243,METTL3,16,,21979517
2,154333851,1471,RPRM,16,,154335322
11,8968747,17573,TMEM9B,16,,8986320
15,34376223,17830,EMC7,16,,34394053
15,75494220,10290,C15orf39,16,,75504510
8,110346551,11638,ENY2,16,,110358189
5,175773063,15747,KIAA1191,16,,175788810
3,172348434,80574,NCEH1,16,,172429008
11,45261852,46032,SYT13,16,,45307884
1,155247217,12422,HCN3,16,,155259639
17,7362684,20260,ZBTB4,16,,7382944
4,39184023,103407,WDR19,16,,39287430
7,92076761,12620,GATAD1,16,,92089381
19,16023179,22497,CYP4F11,16,,16045676
10,49654067,159109,ARHGAP22,16,,49813176
3,53919225,6764,SELK,16,,53925989
4,141264596,39114,SCOC,16,,141303710
20,37590980,77386,DHX35,16,,37668366
1,173833038,4087,GAS5,16,,173837125
6,3269207,176040,SLC22A23,16,,3445247
1,15783222,15364,CELA2A,16,,15798586
7,50511826,6262,FIGNL1,16,,50518088
10,70044837,47847,PBLD,16,,70092684
2,219138914,18386,TMBIM1,16,,219157300
10,73507313,26024,C10orf54,16,,73533337
16,30670839,11292,FBRS,16,,30682131
1,240652872,122590,GREM2,16,,240775462
7,156742416,23460,NOM1,16,,156765876
8,25699245,203395,EBF2,16,,25902640
1,26560643,44658,CEP85,16,,26605301
2,86947413,57751,RMND5A,16,,87005164
12,121440224,14081,C12orf43,16,,121454305
5,34998205,50035,AGXT2,16,,35048240
8,143845751,13513,LYNX1,16,,143859264
22,24198889,29410,SLC2A11,16,,24228299
1,44686741,134210,ERI3,16,,44820951
22,50296853,15253,ALG12,16,,50312106
19,36119917,8671,RBM42,16,,36128588
5,3596167,5350,IRX1,16,,3601517
2,214149102,33607,SPAG16,16,,214182709
2,31133330,228262,GALNT14,16,,31361592
2,44589042,410689,CAMKMT,16,,44999731
16,27215295,17794,KDM8,16,,27233089
8,33405271,19375,RNF122,16,,33424646
8,67976602,132247,CSPP1,16,,68108849
22,42196625,25678,CCDC134,16,,42222303
2,10710891,119222,NOL10,16,,10830113
9,113127528,214632,SVEP1,16,,113342160
10,99258638,72329,UBTD1,16,,99330967
15,65107828,10039,PIF1,16,,65117867
16,53088944,272470,CHD9,16,,53361414
18,33877658,482525,FHOD3,16,,34360183
17,79506910,12519,C17orf70,16,,79519429
2,24252205,18091,C2orf44,16,,24270296
19,18367905,17414,KIAA1683,16,,18385319
22,21354060,2344,THAP7,16,,21356404
15,81605006,11518,STARD5,16,,81616524
6,32132381,3681,EGFL8,16,,32136062
11,1490677,17332,MOB2,16,,1508009
13,49882785,135477,CAB39L,16,,50018262
7,73150424,2773,ABHD11,16,,73153197
19,17462256,25902,PLVAP,16,,17488158
16,80574848,9858,DYNLRB2,16,,80584706
19,36347951,10097,KIRREL2,16,,36358048
20,35240923,33696,SLA2,16,,35274619
9,37120468,237677,ZCCHC7,16,,37358145
11,85358962,8635,TMEM126A,16,,85367597
3,197476423,34894,FYTTD1,16,,197511317
19,12777617,9029,WDR83,16,,12786646
6,33664537,14991,UQCC2,16,,33679528
20,24986865,51953,ACSS1,16,,25038818
11,126300836,569930,KIRREL3,16,,126870766
16,4382224,7374,GLIS2,16,,4389598
19,4153597,19454,CREB3L3,16,,4173051
10,105148808,7462,USMG5,16,,105156270
6,39266776,15461,KCNK17,16,,39282237
1,154293591,4210,AQP10,16,,154297801
5,176237559,70340,UNC5A,16,,176307899
17,73870244,4412,TRIM47,16,,73874656
5,110074672,26202,SLC25A46,16,,110100874
17,17921333,21147,ATPAF2,16,,17942480
3,112930311,75999,BOC,16,,113006310
1,173768687,25090,CENPL,16,,173793777
8,23101149,18364,CHMP7,16,,23119513
9,125026881,60713,MRRF,16,,125087594
2,230222344,356942,DNER,16,,230579286
15,76136384,57004,UBE2Q2,16,,76193388
19,35988118,4695,DMKN,16,,35992813
X,135042746,13476,MMGT1,16,,135056222
19,1905212,20804,SCAMP4,16,,1926016
4,84328495,48541,HELQ,16,,84377036
18,19109261,71432,ESCO1,16,,19180693
19,54960339,12887,LENG8,16,,54973226
17,45884732,14415,OSBPL7,16,,45899147
22,37576205,8125,C1QTNF6,16,,37584330
X,107334896,63005,ATG4A,16,,107397901
11,64755416,9101,BATF2,16,,64764517
1,151843342,39019,THEM4,16,,151882361
11,5617864,16324,TRIM6,16,,5634188
1,1189291,19943,UBE2J2,16,,1209234
10,99498233,22431,ZFYVE27,16,,99520664
10,127455026,9364,MMP21,16,,127464390
15,65337707,8027,SLC51B,16,,65345734
17,1619816,22077,WDR81,16,,1641893
17,18163847,5248,MIEF2,16,,18169095
1,33402046,28368,RNF19B,16,,33430414
20,23545369,4017,CST9L,16,,23549386
2,220071505,2868,ZFAND2B,16,,220074373
4,123300594,50353,ADAD1,16,,123350947
8,96037213,33731,NDUFAF6,16,,96070944
8,107771710,10762,ABRA,16,,107782472
X,153903526,75832,GAB3,16,,153979358
20,54572412,8116,CBLN4,16,,54580528
10,93170041,104544,HECTD2,16,,93274585
10,120440493,74265,CACUL1,16,,120514758
14,95234559,1940,GSC,16,,95236499
2,110300373,71410,10-Sep,16,,110371783
4,146678778,181334,ZNF827,16,,146860112
4,6027925,174393,JAKMIP1,16,,6202318
X,133903595,26790,FAM122B,16,,133930385
14,24769059,9273,NOP9,16,,24778332
19,42702744,21560,DEDD2,16,,42724304
4,146540539,40648,MMAA,16,,146581187
3,183770834,7627,HTR3C,16,,183778461
15,75287875,25961,SCAMP5,16,,75313836
12,72003378,54371,ZFC3H1,16,,72057749
19,56296762,51366,NLRP11,16,,56348128
11,69480331,9834,ORAOV1,16,,69490165
6,116956780,33193,ZUFSP,16,,116989973
6,36853639,43101,C6orf89,16,,36896740
6,33738989,15730,LEMD2,16,,33754719
7,102105329,8286,LRWD1,16,,102113615
6,36410543,48377,KCTD20,16,,36458920
X,153845864,1658,CTAG1A,16,,153847522
Y,27768263,2222,CDY1B,16,,27770485
2,30670091,197000,LCLAT1,16,,30867091
13,21946709,86800,ZDHHC20,16,,22033509
17,47915670,9709,TAC4,16,,47925379
4,141445311,29613,ELMOD2,16,,141474924
15,34635515,14423,NUTM1,16,,34649938
12,11243885,1027,TAS2R43,16,,11244912
7,89841173,25819,STEAP2,16,,89866992
12,89813497,105847,POC1B,16,,89919344
10,27961802,72976,MKX,16,,28034778
17,73512608,8212,TSEN54,16,,73520820
9,21480838,1474,IFNE,16,,21482312
11,67056761,13194,ANKRD13D,16,,67069955
1,155911479,1146,RXFP4,16,,155912625
1,190066796,380216,BRINP3,16,,190447012
8,108911543,183888,RSPO2,16,,109095431
6,44221837,3471,SLC35B2,16,,44225308
5,156887026,14704,NIPAL4,16,,156901730
6,118781934,191086,CEP85L,16,,118973020
10,51827647,65622,FAM21A,16,,51893269
11,130745765,40617,SNX19,16,,130786382
17,4634702,2203,MED11,16,,4636905
11,122017229,72,MIRLET7A2,16,,122017301
12,62997465,84,MIRLET7I,16,,62997549
9,131006999,110,MIR199B,16,,131007109
15,31357234,110,MIR211,16,,31357344
20,57392669,80,MIR296,16,,57392749
15,89911247,90,MIR9-3,16,,89911337
X,77223457,1678,PGAM4,16,,77225135
14,100575991,99,MIR342,16,,100576090
19,54291143,67,MIR372,16,,54291210
9,112542576,392215,PALM2-AKAP2,16,,112934791
16,31225341,11169,TRIM72,16,,31236510
16,30204250,1377,BOLA2,16,,30205627
2,239140326,2659,LOC643387,16,,239142985
11,2017988,73,MIR675,16,,2018061
15,42131010,9336,PLA2G4B,16,,42140346
5,68647552,18288,AK6,16,,68665840
11,61520108,35882,MYRF,15,,61555990
X,16668280,4511,S100G,15,,16672791
19,5913654,2568,CAPS,15,,5916222
4,85504056,68437,CDS1,15,,85572493
19,42177234,14972,CEACAM7,15,,42192206
1,111770280,15782,CHI3L2,15,,111786062
19,36641823,1948,COX7A1,15,,36643771
17,53038566,7580,COX11,15,,53046146
17,11501747,371318,DNAH9,15,,11873065
14,100259744,148651,EML1,15,,100408395
1,47881743,1981,FOXE3,15,,47883724
X,41548225,8305,GPR34,15,,41556530
6,42151021,11673,GUCA1B,15,,42162694
9,5231418,2549,INSL4,15,,5233967
1,46159997,56488,IPP,15,,46216485
X,48818638,9613,KCND1,15,,48828251
19,55014012,7888,LAIR2,15,,55021900
19,51883162,8048,LIM2,15,,51891210
X,148863599,5800,MAGEA9,15,,148869399
X,30261847,8308,MAGEB1,15,,30270155
17,36861872,24184,MLLT6,15,,36886056
19,50936159,33424,MYBPC2,15,,50969583
12,44902057,368576,NELL2,15,,45270633
1,161087861,7374,NIT1,15,,161095235
3,42642146,48087,NKTR,15,,42690233
4,85414435,4952,NKX6-1,15,,85419387
3,167159576,32344,SERPINI2,15,,167191920
1,172410596,2634,PIGC,15,,172413230
14,68056022,10995,PIGH,15,,68067017
X,153029650,15151,PLXNB3,15,,153044801
12,51580718,11232,POU6F1,15,,51591950
19,43428283,13047,PSG7,15,,43441330
1,40627040,79553,RLF,15,,40706593
1,15986207,2318,RSC1A1,15,,15988525
16,70413337,59654,ST3GAL2,15,,70472991
1,53552850,55454,SLC1A7,15,,53608304
16,67282854,23240,SLC9A5,15,,67306094
16,577855,26781,CAPN15,15,,604636
X,48045655,10544,SSX5,15,,48056199
1,115397423,140567,SYCP1,15,,115537990
9,108424737,648,TAL2,15,,108425385
3,49449638,4271,TCTA,15,,49453909
11,64879325,4382,TM7SF2,15,,64883707
20,44451854,4099,TNNC2,15,,44455953
21,10906186,84757,TPTE,15,,10990943
2,3192694,189009,TSSC1,15,,3381703
10,45496272,4505,ZNF22,15,,45500777
19,21987750,47120,ZNF43,15,,22034870
11,560970,3055,RASSF7,15,,564025
10,44051792,18273,ZNF239,15,,44070065
22,18893735,5866,DGCR6,15,,18899601
7,148892553,30786,ZNF282,15,,148923339
17,6010,25411,DOC2B,15,,31421
19,49622645,31642,PPFIA3,15,,49654287
2,168675181,52185,B3GALT1,15,,168727366
9,97320995,35119,FBP2,15,,97356114
13,50556687,142990,DLEU2,15,,50699677
16,1386197,13245,BAIAP3,15,,1399442
18,43563501,88749,PSTPIP2,15,,43652250
16,68298418,37308,SLC7A6,15,,68335726
10,105253734,98575,NEURL1,15,,105352309
15,65935242,13356,SLC24A1,15,,65948598
4,118955499,224290,NDST3,15,,119179789
9,126773888,21554,LHX2,15,,126795442
13,102104943,268264,ITGBL1,15,,102373207
12,51818593,90954,SLC4A8,15,,51909547
8,23286664,28580,ENTPD4,15,,23315244
2,36779403,45929,FEZ2,15,,36825332
9,129724503,255221,RALGPS1,15,,129979724
5,94799598,91111,TTC37,15,,94890709
1,226033232,37188,TMEM63A,15,,226070420
19,30863299,185667,ZNF536,15,,31048966
6,24804508,131786,FAM65B,15,,24936294
2,7057522,126787,RNF144A,15,,7184309
9,100846634,35001,TRIM14,15,,100881635
12,22601479,96001,C2CD5,15,,22697480
1,113615791,52033,LRIG2,15,,113667824
1,6650783,12175,KLHL21,15,,6662958
1,205198058,44413,TMCC2,15,,205242471
1,211916798,87316,LPGAT1,15,,212004114
16,22825859,101800,HS3ST2,15,,22927659
12,10004967,17491,CLEC2B,15,,10022458
11,66610882,3121,RCE1,15,,66614003
1,67263423,3519,INSL5,15,,67266942
22,35653444,38356,HMGXB4,15,,35691800
20,23471737,4918,CST8,15,,23476655
21,30378079,13606,RWDD2B,15,,30391685
11,2421717,3391,TSSC4,15,,2425108
13,32605436,265340,FRY,15,,32870776
12,56137063,10091,GDF11,15,,56147154
4,699529,65239,PCGF3,15,,764768
1,119573838,109457,WARS2,15,,119683295
11,65082288,7612,CDC42EP2,15,,65089900
9,137979513,33517,OLFM1,15,,138013030
9,131492066,42147,ZER1,15,,131534213
7,100860984,6487,ZNHIT1,15,,100867471
2,45232323,4219,SIX2,15,,45236542
6,43265997,7279,SLC22A7,15,,43273276
2,97202455,15920,ARID5A,15,,97218375
6,41020939,11691,APOBEC2,15,,41032630
1,153747767,4866,SLC27A3,15,,153752633
2,70121074,11294,SNRNP27,15,,70132368
8,30242016,187762,RBPMS,15,,30429778
15,79051544,52261,ADAMTS7,15,,79103805
11,118528941,21440,TREH,15,,118550381
9,33673501,3917,PTENP1,15,,33677418
12,130647003,3282,FZD10,15,,130650285
6,30655823,3083,NRM,15,,30658906
3,38887259,107883,SCN11A,15,,38995142
1,24117645,4384,LYPLA2,15,,24122029
1,93544791,59847,MTF2,15,,93604638
13,49550047,233868,FNDC3A,15,,49783915
5,148521009,118992,ABLIM3,15,,148640001
16,30454945,2351,SEPHS2,15,,30457296
19,12949258,36508,MAST1,15,,12985766
10,75545381,16175,ZSWIM8,15,,75561556
6,37400906,48378,CMTR1,15,,37449284
4,52709165,73838,DCUN1D4,15,,52783003
4,141541935,135536,TBC1D9,15,,141677471
3,16926451,205647,PLCL2,15,,17132098
13,29598747,481337,MTUS2,15,,30080084
16,81069457,11494,ATMIN,15,,81080951
14,24899140,11407,KHNYN,15,,24910547
19,36103645,12606,HAUS5,15,,36116251
12,116396380,318611,MED13L,15,,116714991
17,67074846,63169,ABCA6,15,,67138015
3,194995464,168353,ACAP2,15,,195163817
19,54844455,5985,LILRA4,15,,54850440
X,108866928,1465,KCNE1L,15,,108868393
15,44092618,2151,HYPK,15,,44094769
16,2198650,5491,RAB26,15,,2204141
3,137906089,111139,ARMC8,15,,138017228
3,52109248,79458,POC1A,15,,52188706
11,57435473,33186,ZDHHC5,15,,57468659
18,22641887,290327,ZNF521,15,,22932214
9,107509848,12557,NIPSNAP3A,15,,107522405
12,8234806,15567,NECAP1,15,,8250373
1,78028100,120243,ZZZ3,15,,78148343
15,41809374,27101,RPAP1,15,,41836475
14,23340925,9995,LRP10,15,,23350920
1,55013806,86611,ACOT11,15,,55100417
6,154475617,175598,IPCEF1,15,,154651215
11,64011950,2463,PPP1R14B,15,,64014413
11,69061604,3150,MYEOV,15,,69064754
15,89002708,7925,MRPL46,15,,89010633
1,210001311,29599,DIEXF,15,,210030910
8,121457637,78238,MTBP,15,,121535875
14,50779046,13900,ATP5S,15,,50792946
5,176730762,3198,PRELID1,15,,176733960
12,123212152,2977,HCAR1,15,,123215129
11,82684174,61437,RAB30,15,,82745611
9,132565421,8147,TOR1B,15,,132573568
3,52739856,2341,SPCS1,15,,52742197
20,5080483,13250,TMEM230,15,,5093733
6,31078999,1333,C6orf15,15,,31080332
X,140677834,1065,SPANXA1,15,,140678899
2,242127923,7657,ANO7,15,,242135580
2,242523819,33097,THAP4,15,,242556916
8,87484577,36432,RMDN1,15,,87521009
4,170981372,30000,AADAT,15,,171011372
17,61678230,7495,TACO1,15,,61685725
14,21558204,8969,ZNF219,15,,21567173
19,8478186,25713,2-Mar,15,,8503899
2,99797541,18479,MRPL30,15,,99816020
14,24701627,6820,GMPR2,15,,24708447
5,137774689,7969,REEP2,15,,137782658
12,123464606,2854,ARL6IP4,15,,123467460
1,99127235,98821,SNX7,15,,99226056
1,40144319,12838,HPCAL4,15,,40157157
19,18545197,3914,ISYNA1,15,,18549111
12,120881763,2452,TRIAP1,15,,120884215
14,59951160,20964,JKAMP,15,,59972124
3,179512746,242095,PEX5L,15,,179754841
2,99771536,8077,LIPT1,15,,99779613
X,77385244,9935,TAF9B,15,,77395179
2,30369749,13650,YPEL5,15,,30383399
7,75625654,51667,STYXL1,15,,75677321
4,101316497,122753,EMCN,15,,101439250
13,25946148,653841,ATP8A2,15,,26599989
20,7863630,57463,HAO1,15,,7921093
1,16573334,105652,FBXO42,15,,16678986
4,120133781,82892,USP53,15,,120216673
1,114304453,50645,RSBN1,15,,114355098
16,71065313,199312,HYDIN,15,,71264625
15,56922373,103911,ZNF280D,15,,57026284
3,49067139,64667,QRICH1,15,,49131806
17,15902693,30030,TTC19,15,,15932723
7,1022834,6442,CYP2W1,15,,1029276
10,5726800,78903,FAM208B,15,,5805703
12,49046994,29041,KANSL2,15,,49076035
15,75628336,4282,COMMD4,15,,75632618
11,59573607,4738,MRPL16,15,,59578345
4,47452805,12942,COMMD8,15,,47465747
11,113185250,51864,TTC12,15,,113237114
20,3734145,14307,C20orf27,15,,3748452
12,117476727,60524,TESC,15,,117537251
12,102513948,77350,PARPBP,15,,102591298
16,50099851,41332,HEATR3,15,,50141183
9,95059639,28237,NOL8,15,,95087876
8,107460151,304770,OXR1,15,,107764921
12,6561176,10312,TAPBPL,15,,6571488
X,105855159,67514,CXorf57,15,,105922673
10,115880620,53359,CCDC186,15,,115933979
4,128982420,47639,LARP1B,15,,129030059
2,220094609,6782,ANKZF1,15,,220101391
6,49431095,29725,CENPQ,15,,49460820
8,19674917,34669,INTS10,15,,19709586
17,40004770,16914,KLHL11,15,,40021684
3,109044987,11432,DPPA4,15,,109056419
3,189674516,165710,LEPREL1,15,,189840226
2,234384164,90072,USP40,15,,234474236
9,79000432,9012,RFK,15,,79009444
19,54041332,42191,ZNF331,15,,54083523
12,22778075,19274,ETNK1,15,,22797349
X,153686620,15369,PLXNA3,15,,153701989
22,45064426,69135,PRR5,15,,45133561
1,23755055,55695,ASAP3,15,,23810750
20,13370035,249548,TASP1,15,,13619583
16,57505869,14516,DOK4,15,,57520385
10,127524908,44976,DHX32,15,,127569884
17,57232859,51211,PRR11,15,,57284070
X,131503342,44261,MBNL3,15,,131547603
17,74620837,19083,ST6GALNAC1,15,,74639920
9,5357966,79971,PLGRKT,15,,5437937
9,121037,58038,CBWD1,15,,179075
X,151806636,15189,GABRQ,15,,151821825
8,28203101,40876,ZNF395,15,,28243977
19,36239261,6159,LIN37,15,,36245420
5,140207506,184423,PCDHA6,15,,140391929
15,29560352,1668,NDNL2,15,,29562020
1,26146396,13037,MTFR1L,15,,26159433
20,62371210,4193,SLC2A4RG,15,,62375403
18,12446510,211402,SPIRE1,15,,12657912
2,96850602,23971,STARD7,15,,96874573
21,30449791,98419,MAP3K7CL,15,,30548210
1,114522012,2864,OLFML3,15,,114524876
10,25137535,104038,PRTFDC1,15,,25241573
7,100450340,12820,SLC12A9,15,,100463160
7,39605974,45714,YAE1D1,15,,39651688
11,3686816,5798,CHRNA10,15,,3692614
3,145910123,58843,PLSCR4,15,,145968966
12,3918026,64588,PARP11,15,,3982614
12,6728000,12815,LPAR5,15,,6740815
7,77469446,117375,PHTF2,15,,77586821
2,196521531,80895,SLC39A10,15,,196602426
6,86215214,88660,SNX14,15,,86303874
20,18122867,46164,CSRP2BP,15,,18169031
3,101043032,189053,SENP7,15,,101232085
3,58223228,57235,ABHD6,15,,58280463
20,62588056,13167,ZNF512B,15,,62601223
6,150921000,243801,PLEKHG1,15,,151164801
17,7311501,11682,NLGN2,15,,7323183
14,101003483,30924,BEGAIN,15,,101034407
19,7660787,22409,CAMSAP3,15,,7683196
7,138516126,149938,KIAA1549,15,,138666064
7,5085451,23668,RBAK,15,,5109119
16,639356,39917,RAB40C,15,,679273
6,31626074,2475,C6orf47,15,,31628549
17,7833662,1655,TRAPPC1,15,,7835317
19,57106663,28881,ZNF71,15,,57135544
1,35331036,64150,DLGAP3,15,,35395186
6,90074334,47661,RRAGD,15,,90121995
12,52463757,7522,ATG101,15,,52471279
6,37787306,335093,ZFAND3,15,,38122399
18,10670243,478518,PIEZO2,15,,11148761
11,58910218,12293,FAM111A,15,,58922511
20,44563316,13346,PCIF1,15,,44576662
6,168841830,226844,SMOC2,15,,169068674
6,105605774,22084,POPDC3,15,,105627858
10,22045476,247174,DNAJC1,15,,22292650
1,179051111,14018,TOR3A,15,,179065129
16,108057,14572,RHBDF1,15,,122629
12,57866037,5944,ARHGAP9,15,,57871981
19,34112860,151554,CHST8,15,,34264414
3,9691116,52962,MTMR14,15,,9744078
9,114803060,134517,SUSD1,15,,114937577
16,779754,11284,NARFL,15,,791038
7,100277129,9741,GIGYF1,15,,100286870
19,39903749,15306,PLEKHG2,15,,39919055
13,61983818,5837,PCDH20,15,,61989655
5,56471274,89232,GPBP1,15,,56560506
2,202671301,88972,CDK15,15,,202760273
5,37106329,143201,C5orf42,15,,37249530
19,52392487,15818,ZNF649,15,,52408305
2,3642421,49813,COLEC11,15,,3692234
22,42334724,8444,CENPM,15,,42343168
12,56618124,5514,NABP2,15,,56623638
8,120846180,21990,DSCC1,15,,120868170
17,42264353,4746,TMUB2,15,,42269099
X,23851464,74593,APOO,15,,23926057
1,32665986,5005,CCDC28B,15,,32670991
22,50312277,8911,CRELD2,15,,50321188
9,37800550,67115,DCAF10,15,,37867665
4,2233562,10329,HAUS3,15,,2243891
1,110292701,13943,EPS8L3,15,,110306644
17,57642885,42828,DHX40,15,,57685713
11,19245609,17558,E2F8,15,,19263167
3,21462489,330327,ZNF385D,15,,21792816
11,63706441,18350,NAA40,15,,63724791
3,130745693,323616,NEK11,15,,131069309
17,43100705,28324,DCAKD,15,,43129029
15,44119111,41506,WDR76,15,,44160617
6,30594662,19938,ATAT1,15,,30614600
16,68262449,7687,ESRP2,15,,68270136
15,47476402,590018,SEMA6D,15,,48066420
2,197697727,93727,PGAP1,15,,197791454
10,60272903,318294,BICC1,15,,60591197
15,74610881,17601,CCDC33,15,,74628482
1,155146262,11185,TRIM46,15,,155157447
1,84944919,19114,RPF1,15,,84964033
8,33356026,14677,TTI2,15,,33370703
14,32047121,283308,NUBPL,15,,32330429
16,67143894,38553,C16orf70,15,,67182447
2,233470766,76725,EFHD1,15,,233547491
22,50624340,13688,TRABD,15,,50638028
1,154955769,9818,FLAD1,15,,154965587
2,228844669,201692,SPHKAP,15,,229046361
6,28317690,19264,ZKSCAN3,15,,28336954
20,43538700,29258,PABPC1L,15,,43567958
20,31595383,16132,BPIFB2,15,,31611515
8,21995526,3938,REEP4,15,,21999464
19,19672515,57210,PBX4,15,,19729725
12,112123856,71055,ACAD10,15,,112194911
19,41860321,9757,B9D2,15,,41870078
15,65871095,32532,VWA9,15,,65903627
9,131133597,20698,URM1,15,,131154295
10,82214037,68354,TSPAN14,15,,82282391
7,100064141,12761,TSC22D4,15,,100076902
1,1327667,7051,CCNL2,15,,1334718
6,150464187,107341,PPP1R14C,15,,150571528
18,70409548,125262,NETO1,15,,70534810
10,102790995,10003,SFXN3,15,,102800998
8,11278972,45304,FAM167A,15,,11324276
7,71244475,557733,CALN1,15,,71802208
6,80340821,72566,SH3BGRL2,15,,80413387
1,6484847,36157,ESPN,15,,6521004
12,57849073,2723,INHBE,15,,57851796
18,2847027,67063,EMILIN2,15,,2914090
1,150670534,22830,HORMAD1,15,,150693364
16,67696847,3812,ENKD1,15,,67700659
14,99864082,83144,SETD3,15,,99947226
2,227700670,163253,RHBDD1,15,,227863923
19,51125233,17859,SYT3,15,,51143092
17,5322960,13380,RPAIN,15,,5336340
6,170599790,116369,FAM120B,15,,170716159
16,23652686,9783,DCTN5,15,,23662469
X,119292466,5479,RHOXF2,15,,119297945
X,148678215,35353,TMEM185A,15,,148713568
16,88493878,13287,ZNF469,15,,88507165
17,51900238,2335,KIF2B,15,,51902573
17,8023907,3503,HES7,15,,8027410
16,46919025,46184,GPT2,15,,46965209
12,3724493,137873,CRACR2A,15,,3862366
19,55851220,8269,SUV420H2,15,,55859489
16,28962317,15450,NFATC2IP,15,,28977767
1,204372491,8454,PPP1R15B,15,,204380945
19,16244837,24547,HSH2D,15,,16269384
6,144164409,20540,LTV1,15,,144184949
6,158530535,58777,SERAC1,15,,158589312
15,57668702,174223,CGNL1,15,,57842925
10,98981929,70501,ARHGAP19,15,,99052430
19,3880617,47463,ATCAY,15,,3928080
6,52226925,45650,PAQR8,15,,52272575
20,278203,2760,ZCCHC3,15,,280963
9,131395939,23190,WDR34,15,,131419129
8,58907112,155165,FAM110B,15,,59062277
1,52521856,34532,BTF3L4,15,,52556388
19,54372644,7045,MYADM,15,,54379689
16,71660055,15813,MARVELD3,15,,71675868
10,85954390,24986,CDHR1,15,,85979376
17,37827374,16949,PGAP3,15,,37844323
19,17160570,25773,HAUS8,15,,17186343
4,106965473,271950,TBCK,15,,107237423
6,129898239,133131,ARHGAP18,15,,130031370
2,190634992,14105,ORMDL1,15,,190649097
7,130033611,47440,CEP41,15,,130081051
6,84743419,57186,MRAP2,15,,84800605
9,112403067,310689,PALM2,15,,112713756
8,113235158,1214084,CSMD3,15,,114449242
9,130830478,41059,SLC25A25,15,,130871537
22,37763999,59506,ELFN2,15,,37823505
2,23608297,323186,KLHL29,15,,23931483
11,102267055,56720,TMEM123,15,,102323775
19,39432040,34413,FBXO17,15,,39466453
1,54411998,21843,LRRC42,15,,54433841
1,89724633,13911,GBP5,15,,89738544
19,36266416,13308,ARHGAP33,15,,36279724
16,11439294,6326,RMI2,15,,11445620
14,23846016,2965,CMTM5,15,,23848981
20,3713316,20442,HSPA12B,15,,3733758
12,55248298,3876,MUCL1,15,,55252174
12,52959602,8007,KRT74,15,,52967609
14,92790151,177674,SLC24A4,15,,92967825
16,23533333,35363,EARS2,15,,23568696
17,38024454,9695,ZPBP2,15,,38034149
19,3585568,7971,GIPC3,15,,3593539
1,44584521,16288,KLF17,15,,44600809
1,228294379,2634,MRPL55,15,,228297013
20,51801821,310048,TSHZ2,15,,52111869
4,129805147,209615,SCLT1,15,,130014762
5,157170702,17015,LSM11,15,,157187717
6,150209600,2570,RAET1E,15,,150212170
7,144094332,12988,NOBOX,15,,144107320
15,101142754,27660,ASB7,15,,101170414
15,45028559,31468,TRIM69,15,,45060027
12,52979372,15950,KRT72,15,,52995322
20,138110,1694,DEFB127,15,,139804
11,7273180,217096,SYT9,15,,7490276
11,26580578,13237,MUC15,15,,26593815
13,44453419,14649,LACC1,15,,44468068
15,25380788,2412,PWAR1,15,,25383200
16,66461199,55546,BEAN1,15,,66516745
16,70613797,80788,IL34,15,,70694585
19,1473199,6029,C19orf25,15,,1479228
1,153940314,6526,CREB3L4,15,,153946840
1,222885894,22644,BROX,15,,222908538
1,85715636,9719,C1orf52,15,,85725355
1,151009028,11048,BNIPL,15,,151020076
22,21319417,16232,AIFM3,15,,21335649
2,170590355,18041,KLHL23,15,,170608396
3,32280170,131647,CMTM8,15,,32411817
7,16899029,22584,AGR3,15,,16921613
17,33570085,24676,SLFN5,15,,33594761
1,197473878,270745,DENND1B,15,,197744623
1,26187974,9770,PAQR7,15,,26197744
3,39224705,9382,XIRP1,15,,39234087
5,78908242,74229,PAPD4,15,,78982471
7,64838711,27337,ZNF92,15,,64866048
6,42883726,9849,PTCRA,15,,42893575
8,57212206,21129,SDR16C5,15,,57233335
1,118496287,231561,SPAG17,15,,118727848
3,195943382,16919,SLC51A,15,,195960301
17,63631657,191004,CEP112,15,,63822661
3,57483730,46341,DNAH12,15,,57530071
4,39548916,91702,SMIM14,15,,39640618
13,51285161,132914,DLEU7,15,,51418075
10,18948312,18628,ARL5B,15,,18966940
7,6838565,27361,CCZ1B,15,,6865926
8,87111138,55316,ATP6V0D2,15,,87166454
11,66234335,10473,PELI3,15,,66244808
4,75174186,8334,EPGN,15,,75182520
3,130064358,139332,COL6A5,15,,130203690
1,76540388,502504,ST6GALNAC3,15,,77042892
4,13570365,58963,BOD1L1,15,,13629328
12,56631590,20553,ANKRD52,15,,56652143
12,112597991,221905,HECTD4,15,,112819896
14,105331649,31458,CEP170B,15,,105363107
16,2069520,1236,NPW,15,,2070756
16,30007529,9582,INO80E,15,,30017111
18,24034873,94526,KCTD1,15,,24129399
19,49244144,6022,IZUMO1,15,,49250166
3,183814851,9932,HTR3E,15,,183824783
3,44379943,21351,TCAIM,15,,44401294
8,27727398,122971,SCARA5,15,,27850369
X,138808504,105943,ATP11C,15,,138914447
14,24439223,36394,DHRS4L2,15,,24475617
11,7981155,3904,NLRP10,15,,7985059
12,53215230,12847,KRT79,15,,53228077
17,77704864,11157,ENPP7,15,,77716021
20,939095,43812,RSPO4,15,,982907
17,57187307,45493,SKA2,15,,57232800
1,168195254,16834,SFT2D2,15,,168212088
11,298200,1326,IFITM5,15,,299526
15,62455736,1746,C2CD4B,15,,62457482
11,65383782,21128,PCNXL3,15,,65404910
2,88055478,229831,RGPD1,15,,88285309
9,95087749,289688,CENPP,15,,95377437
14,101521023,73,MIR134,15,,101521096
12,54730999,99,MIR148B,15,,54731098
X,133303838,69,MIR20B,15,,133303907
5,138784242,58086,ECSCR,15,,138842328
8,145490546,1926,SCX,15,,145492472
2,131369105,46505,POTEJ,15,,131415610
4,38869652,96,MIR574,15,,38869748
7,16127151,333796,ISPD,15,,16460947
7,75046059,69506,POM121C,15,,75115565
5,135416179,108,VTRNA2-1,15,,135416287
16,14403141,87,MIR365A,15,,14403228
1,161007421,1353,TSTD1,15,,161008774
11,67429632,12470,ALDH3B2,14,,67442102
Y,6733958,8110,AMELY,14,,6742068
X,9754495,162988,SHROOM2,14,,9917483
16,330605,2398,ARHGDIG,14,,333003
1,40222853,31680,BMP8B,14,,40254533
11,64883874,1336,ZNHIT2,14,,64885210
11,59824100,14488,MS4A3,14,,59838588
18,63417887,131315,CDH7,14,,63549202
X,77154960,5921,COX7B,14,,77160881
3,148545587,32385,CPB1,14,,148577972
3,194060493,11564,CPN2,14,,194072057
22,25595816,7510,CRYBB3,14,,25603326
16,75252883,5942,CTRB1,14,,75258825
19,41381343,7314,CYP2A7,14,,41388657
3,42913683,3950,CYP8B1,14,,42917633
9,136528683,74796,SARDH,14,,136603479
1,44435652,3391,DPH2,14,,44439043
8,105391651,87626,DPYS,14,,105479277
3,48673895,26453,CELSR3,14,,48700348
1,101337927,22808,EXTL2,14,,101360735
1,120926127,9817,FCGR1B,14,,120935944
8,39601254,94554,ADAM2,14,,39695808
1,155183615,13710,GBAP1,14,,155197325
1,35220647,3466,GJB5,14,,35224113
8,53852467,987,NPBWR1,14,,53853454
6,29855349,3507,HLA-H,14,,29858856
2,74741595,2680,TLX2,14,,74744275
7,100136833,29010,AGFG2,14,,100165843
20,49620192,19483,KCNG1,14,,49639675
12,52771595,7822,KRT84,14,,52779417
1,201349965,18704,LAD1,14,,201368669
7,100171633,12178,LRCH4,14,,100183811
1,152850797,6726,SMCP,14,,152857523
8,67474409,51075,MYBL1,14,,67525484
19,54606159,4122,NDUFA3,14,,54610281
12,673461,99446,NINJ2,14,,772907
17,78440632,9772,NPTX1,14,,78450404
12,15125955,8844,PDE6H,14,,15134799
8,17433941,66701,PDGFRL,14,,17500642
2,88047605,11389,PLGLB2,14,,88058994
12,11460014,3355,PRB4,14,,11463369
19,43225793,18875,PSG3,14,,43244668
19,43696853,13073,PSG4,14,,43709926
19,43406233,15843,PSG6,14,,43422076
11,67202980,2173,PTPRCAP,14,,67205153
12,56915608,74372,RBMS2,14,,56989980
1,192605267,24173,RGS13,14,,192629440
1,153509622,4619,S100A5,14,,153514241
18,40847856,9759,SYT4,14,,40857615
5,178138521,19182,ZNF354A,14,,178157703
6,35085848,23339,TCP11,14,,35109187
1,152078792,9138,TCHH,14,,152087930
10,98124362,149321,TLL2,14,,98273683
21,40759691,10124,WRB,14,,40769815
7,99667593,12578,ZNF3,14,,99680171
X,84498996,29372,ZNF711,14,,84528368
8,146155743,20531,ZNF16,14,,146176274
19,23540497,37865,ZNF91,14,,23578362
1,26364512,8117,SLC30A2,14,,26372629
14,73086003,274821,DPF3,14,,73360824
X,153715644,3385,SLC10A3,14,,153719029
5,69321071,17869,SERF1A,14,,69338940
10,135043777,1285,UTF1,14,,135045062
20,52560076,127228,BCAS1,14,,52687304
10,13628938,43930,PRPF18,14,,13672868
19,281039,10396,PPAP2C,14,,291435
12,4714028,9026,DYRK4,14,,4723054
14,50798643,65479,CDKL1,14,,50864122
X,76709646,2367,FGF16,14,,76712013
17,21101262,16646,TMEM11,14,,21117908
17,56566892,28359,MTMR4,14,,56595251
14,50250238,69683,NEMF,14,,50319921
8,1993157,100223,MYOM2,14,,2093380
3,185000728,206154,MAP3K13,14,,185206882
17,27400538,2089,TIAF1,14,,27402627
15,59903981,8229,GCNT3,14,,59912210
7,43622691,44287,STK17A,14,,43666978
8,73449625,400959,KCNB2,14,,73850584
14,24540045,7264,CPNE6,14,,24547309
Y,20137666,1960,CDY2A,14,,20139626
11,44953898,17861,TP53I11,14,,44971759
8,66582107,40691,MTFR1,14,,66622798
18,74069636,137510,ZNF516,14,,74207146
14,35591526,151758,KIAA0391,14,,35743284
7,22157907,238626,RAPGEF5,14,,22396533
20,30697308,57753,TM9SF4,14,,30755061
2,64858754,22292,SERTAD2,14,,64881046
18,46065426,324160,CTIF,14,,46389586
3,37027356,7439,EPM2AIP1,14,,37034795
17,12692828,202133,ARHGAP44,14,,12894961
16,84402128,95665,ATP2C2,14,,84497793
3,38388250,68217,XYLB,14,,38456467
21,34961647,52513,CRYZL1,14,,35014160
17,13397348,107911,HS3ST3A1,14,,13505259
12,49716970,1201,TROAP,14,,49718171
6,149068270,329856,UST,14,,149398126
12,58213709,27038,CTDSP2,14,,58240747
2,169929084,23593,DHRS9,14,,169952677
18,72922709,79196,TSHZ1,14,,73001905
3,111260925,110281,CD96,14,,111371206
6,46188466,271338,RCAN2,14,,46459804
5,64064744,249846,CWC27,14,,64314590
13,50656304,25050,DLEU1,14,,50681354
21,38595725,44108,DSCR3,14,,38639833
12,56708257,1871,CNPY2,14,,56710128
8,21881620,12788,NPM2,14,,21894408
10,134000413,18867,DPYSL4,14,,134019280
17,39958204,10247,LEPREL4,14,,39968451
11,62009723,2557,SCGB1D2,14,,62012280
9,111624507,1528,ACTL7A,14,,111626035
4,77969176,27949,CCNI,14,,77997125
12,113830250,11442,SDS,14,,113841692
X,101768609,3090,TMSB15A,14,,101771699
10,118892800,5012,VAX1,14,,118897812
14,88932121,89002,PTPN21,14,,89021123
12,108126642,28272,PRDM4,14,,108154914
1,24829386,34124,RCAN3,14,,24863510
5,64444562,333185,ADAMTS6,14,,64777747
7,111846642,137347,ZNF277,14,,111983989
19,15726028,14419,CYP4F8,14,,15740447
Y,16733900,111529,NLGN4Y,14,,16845429
16,77224815,8728,MON1B,14,,77233543
2,25264972,117032,EFR3B,14,,25382004
3,108099215,148954,MYH15,14,,108248169
16,3550944,38107,CLUAP1,14,,3589051
8,27142402,26434,TRIM35,14,,27168836
19,38397860,301152,SIPA1L3,14,,38699012
1,183904965,101939,COLGALT2,14,,184006904
17,3907738,138515,ZZEF1,14,,4046253
7,17830384,149747,SNX13,14,,17980131
1,67465014,55066,SLC35D1,14,,67520080
3,47021172,30022,NBEAL2,14,,47051194
2,72403112,650059,EXOC6B,14,,73053171
21,46683842,23969,POFUT2,14,,46707811
15,51739920,175047,DMXL2,14,,51914967
12,111471827,316531,CUX2,14,,111788358
1,43855555,64363,SZT2,14,,43919918
14,50234786,15070,KLHDC2,14,,50249856
1,201433411,4888,PHLDA3,14,,201438299
1,150230137,7343,CA14,14,,150237480
7,99102572,28873,ZKSCAN5,14,,99131445
17,3511555,28061,SHPK,14,,3539616
1,205111630,69097,DSTYK,14,,205180727
7,97910978,11297,BRI3,14,,97922275
22,43435522,49912,TTLL1,14,,43485434
12,51318533,7767,METTL7A,14,,51326300
12,6648693,16556,IFFO1,14,,6665249
11,71820632,3190,ANAPC15,14,,71823822
1,25548766,10247,SYF2,14,,25559013
14,23938897,8505,NGDN,14,,23947402
20,25280833,90785,ABHD12,14,,25371618
10,97423152,30748,TCTN3,14,,97453900
20,60758080,19730,MTG2,14,,60777810
5,140514787,2922,PCDHB5,14,,140517709
17,65373396,319983,PITPNC1,14,,65693379
6,99321600,74282,FBXL4,14,,99395882
4,175157809,47593,FBXO8,14,,175205402
9,136028334,10998,GBGT1,14,,136039332
14,67853695,25222,PLEK2,14,,67878917
3,186358148,12649,FETUB,14,,186370797
11,134123433,12313,ACAD8,14,,134135746
17,64960979,68539,CACNG4,14,,65029518
3,101368282,27706,ZBTB11,14,,101395988
19,3708334,42477,TJP3,14,,3750811
22,41957013,15657,CSDC2,14,,41972670
6,54173202,81748,TINAG,14,,54254950
22,41994031,23030,DESI1,14,,42017061
Y,244667,53023,PPP2R3B,14,,297690
5,122181159,163743,SNX24,14,,122344902
11,57174426,20195,SLC43A3,14,,57194621
1,224544512,20074,CNIH4,14,,224564586
17,8191968,1441,RANGRF,14,,8193409
13,43597361,85945,DNAJC15,14,,43683306
16,58147496,15800,CFAP20,14,,58163296
6,26597170,3107,ABT1,14,,26600277
2,121974163,68615,TFCP2L1,14,,122042778
6,116601225,158229,DSE,14,,116759454
7,2273925,7908,FTSJ2,14,,2281833
16,4560676,27795,CDIP1,14,,4588471
19,2732522,7552,SLC39A3,14,,2740074
2,160175489,297623,BAZ2B,14,,160473112
18,56934266,6359,RAX,14,,56940625
12,10958649,930,TAS2R8,14,,10959579
12,10977944,924,TAS2R10,14,,10978868
3,108541544,32308,TRAT1,14,,108573852
12,102406617,49285,CCDC53,14,,102455902
1,149871134,1214,BOLA1,14,,149872348
1,29519168,38302,MECR,14,,29557470
9,131084786,11565,COQ4,14,,131096351
3,179041550,11773,ZNF639,14,,179053323
11,61159831,6504,TMEM216,14,,61166335
19,19740281,14195,GMIP,14,,19754476
19,11616730,23257,ECSIT,14,,11639987
8,143808620,9730,THEM6,14,,143818350
11,32457063,3073,WT1-AS,14,,32460136
12,121016847,2350,POP5,14,,121019197
5,115420672,208315,COMMD10,14,,115628987
9,131581929,10171,C9orf114,14,,131592100
6,36321997,33580,ETV7,14,,36355577
2,238969564,38490,SCLY,14,,239008054
2,64119666,126548,VPS54,14,,64246214
3,150321065,27169,SELT,14,,150348234
16,96978,6654,POLR3K,14,,103632
12,113659242,77147,TPCN1,14,,113736389
14,88646451,146805,KCNK10,14,,88793256
1,54317391,38096,YIPF1,14,,54355487
X,57162082,1976,SPIN2A,14,,57164058
6,153308500,15450,MTRF1L,14,,153323950
5,176946789,34797,FAM193B,14,,176981586
5,32227112,86002,MTMR12,14,,32313114
1,65886398,15292,LEPROT,14,,65901690
16,87741417,58181,KLHDC4,14,,87799598
19,55602280,26688,PPP1R12C,14,,55628968
19,12863406,5865,BEST2,14,,12869271
4,17802277,10104,DCAF16,14,,17812381
18,60190657,55161,ZCCHC2,14,,60245818
1,203734283,11197,LAX1,14,,203745480
5,169010637,21144,SPDL1,14,,169031781
20,62367811,2649,LIME1,14,,62370460
14,23415436,10915,HAUS4,14,,23426351
4,71062243,8050,ODAM,14,,71070293
X,14024844,23191,GEMIN8,14,,14048035
4,170650618,28475,C4orf27,14,,170679093
14,105475909,11516,CDCA4,14,,105487425
17,48610047,11064,EPN3,14,,48621111
12,47158543,61237,SLC38A4,14,,47219780
17,17380299,16235,MED9,14,,17396534
19,33571785,49533,GPATCH1,14,,33621318
1,32830233,29829,BSDC1,14,,32860062
6,88384577,27408,AKIRIN2,14,,88411985
1,12290095,282003,VPS13D,14,,12572098
1,150618700,50972,GOLPH3L,14,,150669672
3,119147806,34723,TMEM39A,14,,119182529
5,76726757,61608,WDR41,14,,76788365
10,101992052,35386,CWF19L1,14,,102027438
5,31532372,22793,C5orf22,14,,31555165
4,6717841,1546,BLOC1S4,14,,6719387
11,33061560,33549,TCP11L1,14,,33095109
7,150497853,4355,TMEM176A,14,,150502208
15,78556988,17550,DNAJA4,14,,78574538
7,2443194,31022,CHST12,14,,2474216
1,220087605,14388,SLC30A10,14,,220101993
22,50925212,3538,MIOX,14,,50928750
7,92861652,128783,CCDC132,14,,92990435
16,20744985,8301,THUMPD1,14,,20753286
9,19230762,143504,DENND4C,14,,19374266
10,13685705,687178,FRMD4A,14,,14372883
12,49490922,13761,LMBR1L,14,,49504683
14,58666832,35521,ACTR10,14,,58702353
17,72429835,13733,GPRC5C,14,,72443568
19,11350294,2325,C19orf80,14,,11352619
20,35234136,6824,C20orf24,14,,35240960
19,4657556,12859,C19orf10,14,,4670415
19,44232148,27040,SMG9,14,,44259188
5,140174443,217486,PCDHA2,14,,140391929
17,56634037,135379,TEX14,14,,56769416
20,7957999,42477,TMX4,14,,8000476
17,80572437,33974,WDR45B,14,,80606411
3,98234316,7594,CLDND1,14,,98241910
5,151771101,13739,NMUR2,14,,151784840
3,158384202,6280,LXN,14,,158390482
3,44803208,91540,KIF15,14,,44894748
11,67222817,6428,CABP4,14,,67229245
16,57481336,13851,COQ9,14,,57495187
6,88223652,76098,RARS2,14,,88299750
20,47862438,32318,ZNFX1,14,,47894756
1,209757044,30240,CAMK1G,14,,209787284
4,47487409,108094,ATP10D,14,,47595503
12,63037762,290903,PPM1H,14,,63328665
3,128846258,33815,ISY1,14,,128880073
5,123972609,108196,ZNF608,14,,124080805
16,66914263,10739,PDP2,14,,66925002
14,23742843,12466,HOMEZ,14,,23755309
3,3841114,50404,LRRN1,14,,3891518
12,124086623,18867,DDX55,14,,124105490
2,74448560,93592,SLC4A5,14,,74542152
17,55055467,28662,SCPEP1,14,,55084129
20,3127164,13368,FASTKD5,14,,3140532
7,151722758,96674,GALNT11,14,,151819432
8,82711817,42704,SNX16,14,,82754521
1,79355448,117047,ELTD1,14,,79472495
11,59939970,12169,MS4A6A,14,,59952139
12,100593864,24338,ACTR6,14,,100618202
16,1448305,16416,UNKL,14,,1464721
1,40840304,48694,SMAP2,14,,40888998
14,21457964,7230,METTL17,14,,21465194
11,706119,21608,EPS8L2,14,,727727
2,27714749,3377,FNDC4,14,,27718126
3,52558384,9409,NT5DC2,14,,52567793
5,1798498,1458,MRPL36,14,,1799956
3,49895413,12242,CAMKV,14,,49907655
2,101179417,13784,PDCL3,14,,101193201
19,6440074,19707,SLC25A23,14,,6459781
15,41245346,3371,CHAC1,14,,41248717
8,145582240,2708,SLC52A2,14,,145584948
5,49961732,180624,PARP8,14,,50142356
X,106183963,59511,MORC4,14,,106243474
1,42922164,4737,PPCS,14,,42926901
16,74907470,111547,WDR59,14,,75019017
17,29226000,7286,TEFM,14,,29233286
10,5680819,27739,ASB13,14,,5708558
11,46722643,4823,ZNF408,14,,46727466
2,203776940,74268,CARF,14,,203851208
2,166729871,80477,TTC21B,14,,166810348
5,35617988,196725,SPEF2,14,,35814713
10,15820167,82365,FAM188A,14,,15902532
14,91580356,111384,C14orf159,14,,91691740
22,36883232,19916,FOXRED2,14,,36903148
19,7953389,13519,LRRC8E,14,,7966908
8,37553268,4271,ZNF703,14,,37557539
1,115312104,11204,SIKE1,14,,115323308
17,42785975,43661,DBF4B,14,,42829636
8,68864349,284919,PREX2,14,,69149268
16,30996518,3955,HSD3B7,14,,31000473
3,127391780,7989,ABTB1,14,,127399769
1,209941832,11170,TRAF3IP3,14,,209953002
17,36686258,75925,SRCIN1,14,,36762183
14,53503457,116589,DDHD1,14,,53620046
2,176788619,78454,KIAA1715,14,,176867073
11,4701400,17676,OR51E2,14,,4719076
12,12878850,65549,APOLD1,14,,12944399
15,23004683,29744,NIPA2,14,,23034427
8,42708437,43429,RNF170,14,,42751866
19,10812111,11932,QTRT1,14,,10824043
10,101370274,9947,SLC25A28,14,,101380221
2,74682149,2938,INO80B,14,,74685087
12,104382760,75195,GLT8D2,14,,104457955
12,72057676,16752,THAP2,14,,72074428
5,102884555,13947,NUDT12,14,,102898502
X,34645180,30225,TMEM47,14,,34675405
16,84155743,23057,HSDL1,14,,84178800
X,154689079,517,H2AFB3,14,,154689596
10,45455218,34954,RASSF4,14,,45490172
13,30776766,104425,KATNAL1,14,,30881191
18,44633780,43091,HDHD2,14,,44676871
6,146119271,16650,FBXO30,14,,146135921
3,147103834,18237,ZIC4,14,,147122071
19,34895302,21770,PDCD2L,14,,34917072
3,99833773,63703,CMSS1,14,,99897476
1,180257351,214671,ACBD6,14,,180472022
4,7967036,193523,ABLIM2,14,,8160559
2,27805835,40247,ZNF512,14,,27846082
10,60937226,70308,PHYHIPL,14,,61007534
7,5346422,116755,TNRC18,14,,5463177
6,43211417,44580,TTBK1,14,,43255997
4,144106069,38958,USP38,14,,144145027
2,74759385,21737,LOXL3,14,,74781122
9,131483148,3260,ZDHHC12,14,,131486408
7,129804554,40784,TMEM209,14,,129845338
14,21927178,17654,RAB2B,14,,21944832
1,63249776,81165,ATG4C,14,,63330941
1,166958325,33124,MAEL,14,,166991449
1,36859020,4540,LSM10,14,,36863560
X,152338258,2606,PNMA6A,14,,152340864
9,116917824,156972,COL27A1,14,,117074796
6,110745891,51953,SLC22A16,14,,110797844
11,93394815,68707,CEP295,14,,93463522
2,26568953,49806,EPT1,14,,26618759
9,95709600,88918,FGD3,14,,95798518
5,141018868,12118,FCHSD1,14,,141030986
19,51994480,9167,SIGLEC12,14,,52003647
13,41701708,5228,KBTBD6,14,,41706936
15,35812473,25931,DPH6,14,,35838404
6,53883713,199169,MLIP,14,,54082882
5,177664616,352940,COL23A1,14,,178017556
1,26608772,24423,UBXN11,14,,26633195
3,53122500,41970,RFT1,14,,53164470
16,12070590,597556,SNX29,14,,12668146
1,170501262,13667,GORAB,14,,170514929
19,6464248,2982,CRB3,14,,6467230
3,140770243,97210,SPSB4,14,,140867453
4,38869353,78012,FAM114A1,14,,38947365
X,48316919,11725,SLC38A5,14,,48328644
19,1491003,6921,REEP6,14,,1497924
2,131099797,5737,IMP4,14,,131105534
6,43445260,29034,TJAP1,14,,43474294
12,52937692,9239,KRT71,14,,52946931
10,99344101,28454,HOGA1,14,,99372555
22,31677578,10942,PIK3IP1,14,,31688520
19,49538825,1366,CGB1,14,,49540191
2,179059207,204953,OSBPL6,14,,179264160
8,92221721,188661,SLC26A7,14,,92410382
7,23338939,10241,MALSU1,14,,23349180
1,244998630,9735,COX20,14,,245008365
16,20634558,68020,ACSM1,14,,20702578
19,3762664,4899,MRPL54,14,,3767563
4,36067619,178360,ARAP2,14,,36245979
7,150783508,37217,AGAP3,14,,150820725
1,166825748,19906,TADA1,14,,166845654
12,99018029,20800,IKBIP,14,,99038829
14,23299091,5155,MRPL52,14,,23304246
14,50065414,15976,LRR1,14,,50081390
16,4827614,10908,12-Sep,14,,4838522
17,6918055,2788,C17orf49,14,,6920843
19,2071034,25235,MOB3A,14,,2096269
1,2518188,4720,FAM213B,14,,2522908
1,36883506,32580,OSCP1,14,,36916086
1,236558715,89293,EDARADD,14,,236648008
2,167744996,371265,XIRP2,14,,168116261
2,202152993,69128,ALS2CR12,14,,202222121
2,242034980,6767,MTERF4,14,,242041747
3,52321835,5186,GLYCTK,14,,52327021
4,188916924,9279,ZFP42,14,,188926203
6,71571068,95720,B3GAT2,14,,71666788
7,150872784,11694,ASB10,14,,150884478
8,8559665,1952,CLDN23,14,,8561617
2,171034654,477020,MYO3B,14,,171511674
21,19618191,21496,CHODL,14,,19639687
20,37353104,4911,SLC32A1,14,,37358015
2,238877434,73989,UBE2F,14,,238951423
X,90689596,3987,PABPC5,14,,90693583
11,6518525,74729,DNHD1,14,,6593254
13,53191604,26315,HNRNPA1L2,14,,53217919
14,74318533,33635,PTGR2,14,,74352168
15,76234327,70458,NRG4,14,,76304785
16,68573115,27924,ZFP90,14,,68601039
20,43738092,5721,WFDC5,14,,43743813
2,114195267,58514,CBWD2,14,,114253781
3,160473991,322704,PPM1L,14,,160796695
3,109012634,22730,DPPA2,14,,109035364
6,20099915,112780,MBOAT1,14,,20212695
9,15170841,136517,TTC39B,14,,15307358
12,10103914,34280,CLEC12A,14,,10138194
2,42989638,1763,OXER1,14,,42991401
2,24163375,60318,UBXN2A,14,,24223693
8,39792473,81437,IDO2,14,,39873910
9,139098181,39506,QSOX2,14,,139137687
X,117957705,3231,ZCCHC12,14,,117960936
13,76099354,12654,COMMD6,14,,76112008
13,100258917,286101,CLYBL,14,,100545018
1,2115898,23274,C1orf86,14,,2139172
2,69172363,7739,GKN2,14,,69180102
17,79976578,4207,STRA13,14,,79980785
4,165997229,36795,TMEM192,14,,166034024
10,63997908,30714,RTKN2,14,,64028622
6,109814058,198357,AK9,14,,110012415
6,47749774,44342,OPN5,14,,47794116
4,78634540,106004,CNOT6L,14,,78740544
3,85008132,1115447,CADM2,14,,86123579
10,131633495,128596,EBF3,14,,131762091
15,42834719,6283,LRRC57,14,,42841002
3,46742822,9591,TMIE,14,,46752413
19,50392912,39884,IL4I1,14,,50432796
X,151918386,4022,MAGEA2B,14,,151922408
4,89617063,2323,NAP1L5,14,,89619386
11,62495951,10157,TTC9C,14,,62506108
12,131438451,187562,GPR133,14,,131626013
17,72946838,22062,HID1,14,,72968900
17,78194199,33109,SLC26A11,14,,78227308
17,78388966,22918,ENDOV,14,,78411884
4,73920412,15064,COX18,14,,73935476
6,117803766,87254,DCBLD1,14,,117891020
12,132621139,7741,DDX51,14,,132628880
6,29640168,4763,ZFP57,14,,29644931
2,80529002,2485,LRRTM1,14,,80531487
3,139279024,117868,NMNAT3,14,,139396892
1,182419255,110477,RGSL1,14,,182529732
5,140050380,2791,DND1,14,,140053171
11,11292420,351141,GALNT18,14,,11643561
1,46806849,23975,NSUN4,14,,46830824
20,48740273,30062,TMEM189,14,,48770335
20,48697660,72675,TMEM189-UBE2V1,14,,48770335
8,94743730,9494,RBM12B,14,,94753224
6,30951484,4930,MUC21,14,,30956414
X,21874104,2741,YY2,14,,21876845
20,61809851,87,MIR124-3,14,,61809938
3,52328234,90,MIR135A1,14,,52328324
3,160122532,81,MIR16-2,14,,160122613
3,120114514,62,MIR198,14,,120114576
6,33175611,110,MIR219A1,14,,33175721
6,72086662,72,MIR30C2,14,,72086734
1,41220026,92,MIR30E,14,,41220118
5,87962670,87,MIR9-2,14,,87962757
X,133303567,75,MIR92A2,14,,133303642
17,34623841,1880,CCL3L3,14,,34625721
1,242158791,3594,MAP1LC3C,14,,242162385
17,79099682,67,MIR338,14,,79099749
2,179316162,9948,DFNB59,14,,179326110
X,133303407,75,MIR363,14,,133303482
19,15939756,7375,UCA1,14,,15947131
19,39279849,2545,LGALS7B,14,,39282394
1,145764594,62509,GPR89A,14,,145827103
20,26188821,93,MIR663A,14,,26188914
2,111296064,40245,RGPD6,14,,111336309
7,141940555,6331,MOXD2P,14,,141946886
14,75519927,10825,ACYP1,13,,75530752
6,49801978,32240,CRISP1,13,,49834218
1,104292462,8848,AMY1B,13,,104301310
1,104292440,8870,AMY1C,13,,104301310
1,176826440,307600,ASTN1,13,,177134040
2,176040985,5406,ATP5G3,13,,176046391
19,49141198,8371,CA11,13,,49149569
17,65040651,12260,CACNG1,13,,65052911
16,49311828,3914,CBLN1,13,,49315742
5,19473154,515199,CDH18,13,,19988353
9,115913237,13185,SLC31A2,13,,115926422
5,85913783,2800,COX7C,13,,85916583
3,148583042,31836,CPA3,13,,148614878
2,209025463,2834,CRYGA,13,,209028297
1,85018803,21360,CTBS,13,,85040163
16,2286467,2245,DNASE1L2,13,,2288712
19,11562142,29661,ELAVL3,13,,11591803
2,73144603,17417,EMX1,13,,73162020
6,1390068,5764,FOXF2,13,,1395832
1,171283321,27902,FMO4,13,,171311223
19,5865836,4715,FUT5,13,,5870551
15,49447955,174047,GALK2,13,,49622002
20,33432522,28139,GGT7,13,,33460661
9,114423850,8676,GNG10,13,,114432526
16,83841507,5100,HSBP1,13,,83846607
2,26149454,55989,KIF3C,13,,26205443
17,39533920,4716,KRT34,13,,39538636
17,39632940,4452,KRT35,13,,39637392
2,128293377,101926,MYO7B,13,,128395303
X,72432136,2574,NAP1L2,13,,72434710
4,140211070,11294,NDUFC1,13,,140222364
X,48398074,22923,TBC1D25,13,,48420997
19,43568361,18532,PSG2,13,,43586893
3,10857884,124535,SLC6A11,13,,10982419
22,21383006,3841,SLC7A4,13,,21386847
20,306214,4658,SOX12,13,,310872
1,153012200,1394,SPRR2D,13,,153013594
9,100883256,51918,CORO2A,13,,100935174
2,95831161,18903,ZNF2,13,,95850064
19,58790317,16937,ZNF8,13,,58807254
10,43084531,49754,ZNF33B,13,,43134285
7,99647416,15247,ZSCAN21,13,,99662663
9,130186652,20999,ZNF79,13,,130207651
1,247285276,50043,ZNF124,13,,247335319
X,152082985,59040,ZNF185,13,,152142025
11,3379156,21296,ZNF195,13,,3400452
16,3272324,13133,ZNF200,13,,3285457
6,29555682,1063,OR2H2,13,,29556745
4,175563161,187305,GLRA3,13,,175750466
10,70242089,45191,SLC25A16,13,,70287280
X,7866803,28977,PNPLA4,13,,7895780
16,11762288,10727,SNN,13,,11773015
6,26246838,367,HIST1H4G,13,,26247205
11,57252003,30355,SLC43A1,13,,57282358
4,8594386,27102,CPZ,13,,8621488
8,143866297,1711,LY6D,13,,143868008
17,39642387,3729,KRT36,13,,39646116
14,78138748,35608,ALKBH1,13,,78174356
9,139889059,1965,CLIC3,13,,139891024
10,17631957,27416,PTPLA,13,,17659373
1,35451766,45803,ZMYM6,13,,35497569
8,8641998,109133,MFHAS1,13,,8751131
18,29202208,62478,B4GALT6,13,,29264686
X,129305772,13072,RAB33A,13,,129318844
3,38307297,12509,SLC22A13,13,,38319806
15,74275558,9131,STOML1,13,,74284689
19,24216206,96563,ZNF254,13,,24312769
14,96152753,6227,TCL1B,13,,96158980
1,2407753,29216,PLCH2,13,,2436969
8,53023391,299048,ST18,13,,53322439
17,73452544,43989,KIAA0195,13,,73496533
X,100910267,4609,ARMCX2,13,,100914876
17,43513265,54881,PLEKHM1,13,,43568146
22,50247496,36230,ZBED4,13,,50283726
9,37438099,27308,ZBTB5,13,,37465407
3,38537762,30034,EXOG,13,,38567796
X,109437413,123967,AMMECR1,13,,109561380
19,6752172,15351,SH2D3A,13,,6767523
11,2323242,16188,TSPAN32,13,,2339430
6,30119722,8989,TRIM10,13,,30128711
22,39174512,15649,DNAL4,13,,39190161
7,102220092,37113,RASA4,13,,102257205
17,47778295,7018,SLC35B1,13,,47785313
9,127962820,33618,RABEPK,13,,127996438
6,29942891,3286,HCG9,13,,29946177
5,139937852,6337,APBB3,13,,139944189
1,220230823,32372,BPNT1,13,,220263195
8,97657454,498277,CPQ,13,,98155731
8,7308085,13107,SPAG11B,13,,7321192
8,120079423,41271,COLEC10,13,,120120694
16,23701625,23196,ERN2,13,,23724821
17,74561460,20685,ST6GALNAC2,13,,74582145
5,89770680,39689,POLR3G,13,,89810369
22,29702984,5794,GAS2L1,13,,29708778
2,177134122,68631,MTX2,13,,177202753
10,102986732,1985,LBX1,13,,102988717
X,17818168,61289,RAI2,13,,17879457
19,9523101,23153,ZNF266,13,,9546254
2,85811530,8981,VAMP5,13,,85820511
8,42010463,18238,AP3M2,13,,42028701
20,43126080,24677,SERINC3,13,,43150757
17,80614942,41656,RAB40B,13,,80656598
19,59009699,13733,SLC27A5,13,,59023432
11,65657874,1232,CCDC85B,13,,65659106
22,37154245,17932,IFT27,13,,37172177
2,48757307,68347,STON1,13,,48825654
7,49977023,155837,ZPBP,13,,50132860
3,50388125,3371,CYB561D2,13,,50391496
11,130274817,24071,ADAMTS8,13,,130298888
19,47978397,9124,KPTN,13,,47987521
2,101623689,144220,TBC1D8,13,,101767909
14,31494675,70981,AP4S1,13,,31565656
9,136336215,8061,SLC2A6,13,,136344276
8,37620100,17186,PROSC,13,,37637286
12,51745832,39368,GALNT6,13,,51785200
17,56833229,229311,PPM1E,13,,57062540
13,96230455,66505,DZIP1,13,,96296960
1,42642209,159339,FOXJ3,13,,42801548
15,40733349,27092,BAHD1,13,,40760441
17,8214139,11695,ARHGEF15,13,,8225834
19,1107632,24641,SBNO2,13,,1132273
14,55034329,225704,SAMD4A,13,,55260033
15,64791618,186648,ZNF609,13,,64978266
5,179289070,45786,TBC1D9B,13,,179334856
17,2699731,241304,RAP1GAP2,13,,2941035
19,17858526,40851,FCHO1,13,,17899377
3,69217933,217522,FRMD4B,13,,69435455
11,73111522,197712,FAM168A,13,,73309234
1,20208887,30550,OTUD3,13,,20239437
18,9136750,149233,ANKRD12,13,,9285983
5,102455951,84661,PPIP5K2,13,,102540612
9,88161453,195491,AGTPBP1,13,,88356944
5,133861797,57123,JADE2,13,,133918920
10,22605311,3935,COMMD3,13,,22609246
8,29952921,42301,LEPROTL1,13,,29995222
10,71211225,56198,TSPAN15,13,,71267423
1,241756451,47250,OPN3,13,,241803701
8,133582666,105197,LRRC6,13,,133687863
19,46112657,36118,EML2,13,,46148775
22,29655840,8144,RHBDD3,13,,29663984
9,34989637,8793,DNAJB5,13,,34998430
10,103348044,21377,DPCD,13,,103369421
6,99845926,27295,PNISR,13,,99873221
19,36505561,18012,CLIP3,13,,36523573
20,62218946,39508,GMEB2,13,,62258454
8,145579087,3096,FBXL6,13,,145582183
3,142536701,71344,PCOLCE2,13,,142608045
9,131071378,13681,TRUB2,13,,131085059
5,132202318,2218,UQCRQ,13,,132204536
19,49867041,11332,DKKL1,13,,49878373
18,76740274,18695,SALL3,13,,76758969
10,135051407,4027,VENTX,13,,135055434
5,128300819,68516,SLC27A6,13,,128369335
14,25278860,240235,STXBP6,13,,25519095
3,46753605,5768,PRSS50,13,,46759373
2,10091791,50621,GRHL1,13,,10142412
8,105501458,99794,LRP12,13,,105601252
21,34949858,11156,DONSON,13,,34961014
15,76640526,513759,SCAPER,13,,77154285
1,3547330,19341,WRAP73,13,,3566671
19,10070236,50911,COL5A3,13,,10121147
14,74416954,12859,COQ6,13,,74429813
4,84377084,5792,MRPS18C,13,,84382876
1,26496387,977,ZNF593,13,,26497364
2,63348534,467333,WDPCP,13,,63815867
12,16064105,126210,DERA,13,,16190315
13,20977805,122207,CRYL1,13,,21100012
16,21610796,57998,METTL9,13,,21668794
2,3383445,99897,TRAPPC12,13,,3483342
6,112391859,16892,TUBE1,13,,112408751
X,102611379,2018,WBP5,13,,102613397
15,34517197,5169,EMC4,13,,34522366
3,48509196,32486,SHISA5,13,,48541682
X,75392770,5263,PBDC1,13,,75398033
5,133634114,68651,CDKL3,13,,133702765
16,14726667,36426,BFAR,13,,14763093
6,5998232,9606,NRN1,13,,6007838
12,53161938,9191,KRT76,13,,53171129
3,51705190,33149,TEX264,13,,51738339
6,143380499,280981,AIG1,13,,143661480
1,147400505,65248,GPR89B,13,,147465753
20,55043640,50302,RTFDC1,13,,55093942
17,42396992,5246,SLC25A39,13,,42402238
7,95115212,54331,ASB4,13,,95169543
1,54387233,24263,HSPB11,13,,54411496
1,151735444,8362,OAZ3,13,,151743806
16,88923493,5601,TRAPPC2L,13,,88929094
11,7686325,8504,CYB5R2,13,,7694829
3,122628039,118620,SEMA5B,13,,122746659
2,23971533,178451,ATAD2B,13,,24149984
12,53835432,4995,PRR13,13,,53840427
10,86088344,189933,CCSER2,13,,86278277
7,91875547,155151,ANKIB1,13,,92030698
11,19138691,59276,ZDHHC13,13,,19197967
12,122215659,15935,RHOF,13,,122231594
17,66531256,65839,FAM20A,13,,66597095
9,93372113,33274,DIRAS2,13,,93405387
5,175969511,53258,CDHR2,13,,176022769
15,75247442,2333,RPP25,13,,75249775
11,67070918,9160,SSH3,13,,67080078
4,89299890,64359,HERC6,13,,89364249
18,33767479,81206,MOCOS,13,,33848685
17,4935896,2831,SLC52A1,13,,4938727
16,70147528,48912,PDPR,13,,70196440
7,158649268,89615,WDR60,13,,158738883
1,109234931,9491,PRPF38B,13,,109244422
2,164461461,131056,FIGN,13,,164592517
8,66514690,31762,ARMC1,13,,66546452
3,140660661,38124,SLC25A36,13,,140698785
4,25000470,31944,LGI2,13,,25032414
11,18552949,57344,UEVLD,13,,18610293
11,76571916,165925,ACER3,13,,76737841
Y,148060,21962,PLCXD1,13,,170022
4,113460488,97663,ZGRF1,13,,113558151
4,140637545,437688,MAML3,13,,141075233
16,85008066,37075,ZDHHC7,13,,85045141
14,76071804,42708,FLVCR2,13,,76114512
8,95835517,57204,INTS8,13,,95892721
14,21538418,19988,ARHGEF40,13,,21558406
12,29301935,186614,FAR2,13,,29488549
1,210501595,348043,HHAT,13,,210849638
1,150969300,10085,FAM63A,13,,150979385
7,128116782,26196,METTL2B,13,,128142978
3,10004363,48569,EMC3,13,,10052932
3,44596666,16984,ZKSCAN7,13,,44613650
5,140474190,2774,PCDHB2,13,,140476964
5,140165720,226209,PCDHA1,13,,140391929
10,23983674,853103,KIAA1217,13,,24836777
11,122709205,34142,CRTAM,13,,122743347
X,46433121,24810,CHST7,13,,46457931
X,102585113,2138,TCEAL7,13,,102587251
10,98277866,68943,TM9SF3,13,,98346809
11,118415242,21549,IFT46,13,,118436791
3,52467050,12051,SEMA3G,13,,52479101
16,19566736,145749,C16orf62,13,,19712485
8,68334404,324216,CPA6,13,,68658620
1,24104875,9847,PITHD1,13,,24114722
2,27505296,25011,TRIM54,13,,27530307
2,162480844,360942,SLC4A10,13,,162841786
11,117298487,369489,DSCAML1,13,,117667976
10,25464289,426868,GPR158,13,,25891157
4,6911170,123675,TBC1D14,13,,7034845
1,109656584,92819,KIAA1324,13,,109749403
4,7194373,550191,SORCS2,13,,7744564
9,138594030,90963,KCNT1,13,,138684993
10,102732285,13088,SEMA4G,13,,102745373
5,140561264,4532,PCDHB16,13,,140565796
4,2271323,149047,ZFYVE28,13,,2420370
11,73357222,16642,PLEKHB1,13,,73373864
9,115446228,34201,INIP,13,,115480429
6,31638727,1500,LY6G5B,13,,31640227
1,84864214,16477,DNASE2B,13,,84880691
1,202163117,125772,LGR6,13,,202288889
2,20883773,139117,C2orf43,13,,21022890
9,88556056,81161,NAA35,13,,88637217
3,127872299,255190,EEFSEC,13,,128127489
20,61583998,15951,SLC17A9,13,,61599949
20,44577291,23542,ZNF335,13,,44600833
X,118672111,27261,CXorf56,13,,118699372
4,113434671,2657,NEUROG2,13,,113437328
5,64813592,45403,CENPK,13,,64858995
3,184428154,1682,MAGEF1,13,,184429836
16,69362523,1975,PDF,13,,69364498
20,44802371,134766,CDH22,13,,44937137
7,70597522,581064,WBSCR17,13,,71178586
10,114190047,16670,ZDHHC6,13,,114206717
18,29843483,206964,GAREM,13,,30050447
1,231114822,21657,ARV1,13,,231136479
5,107194733,523066,FBXL17,13,,107717799
12,49760687,160520,SPATS2,13,,49921207
1,53152013,12025,COA7,13,,53164038
2,179345198,24584,PLEKHA3,13,,179369782
3,132757131,359488,TMEM108,13,,133116619
8,33448847,8777,DUSP26,13,,33457624
7,99156447,5881,ZNF655,13,,99162328
15,45694518,19098,SPATA5L1,13,,45713616
14,104182080,17925,ZFYVE21,13,,104200005
19,45666185,15316,TRAPPC6A,13,,45681501
17,80400462,8245,C17orf62,13,,80408707
3,46556877,51163,LRRC2,13,,46608040
2,200820039,8808,C2orf47,13,,200828847
6,119280993,189365,FAM184A,13,,119470358
16,4846962,5989,ROGDI,13,,4852951
X,135298973,39668,MAP7D3,13,,135338641
15,60711807,59552,ICE2,13,,60771359
5,153825516,15097,SAP30L,13,,153840613
9,101569980,42383,GALNT12,13,,101612363
22,37447775,11655,KCTD17,13,,37459430
10,32735009,128483,CCDC7,13,,32863492
15,75105193,12906,LMAN1L,13,,75118099
19,55964345,8704,ISOC2,13,,55973049
15,34432874,69423,KATNBL1,13,,34502297
14,95648275,137970,CLMN,13,,95786245
8,144635556,9675,GSDMD,13,,144645231
1,213123861,41066,VASH2,13,,213164927
4,106631969,136913,GSTCD,13,,106768882
10,5435060,11733,TUBAL3,13,,5446793
17,34958024,7383,MRM1,13,,34965407
19,41197433,23578,ADCK4,13,,41221011
1,111728590,18570,DENND2D,13,,111747160
12,113736570,36403,SLC8B1,13,,113772973
2,130939494,8808,MZT2B,13,,130948302
13,46916134,48043,KIAA0226L,13,,46964177
12,124420955,36577,CCDC92,13,,124457532
1,117653676,10735,TRIM45,13,,117664411
X,24001832,43471,KLHL15,13,,24045303
4,105389462,26596,CXXC4,13,,105416058
9,117098406,58279,AKNA,13,,117156685
X,103494718,4881,ESX1,13,,103499599
8,104410865,16698,SLC25A32,13,,104427563
2,16730729,116405,FAM49A,13,,16847134
1,70724684,95733,ANKRD13C,13,,70820417
10,102820998,4353,KAZALD1,13,,102825351
20,123193,3199,DEFB126,13,,126392
5,180630121,2172,TRIM7,13,,180632293
16,72152995,53354,PMFBP1,13,,72206349
17,17876126,44063,LRRC48,13,,17920189
18,24495594,269708,CHST9,13,,24765302
9,134399182,7480,UCK1,13,,134406662
19,43919034,3733,TEX101,13,,43922767
11,63991270,2456,TRPT1,13,,63993726
12,2934513,9708,NRIP2,13,,2944221
22,18043138,30518,SLC25A18,13,,18073656
11,65154040,26955,FRMD8,13,,65180995
7,102715327,24883,ARMC10,13,,102740210
1,110082493,5962,GPR61,13,,110088455
1,207131311,12659,FCAMR,13,,207143970
1,178482211,10424,TEX35,13,,178492635
11,6232563,23378,FAM160A2,13,,6255941
4,147175139,267984,SLC10A7,13,,147443123
6,109169618,126057,ARMC2,13,,109295675
1,90098643,86451,LRRC8C,13,,90185094
11,65764015,5622,EIF1AD,13,,65769637
3,126423062,256201,CHCHD6,13,,126679263
19,11663857,6194,ELOF1,13,,11670051
10,134901507,43672,GPR123,13,,134945179
18,77915116,90281,PARD6G,13,,78005397
5,79615789,1871,SPZ1,13,,79617660
9,35812956,2086,HINT2,13,,35815042
4,80238271,8900,NAA11,13,,80247171
11,126071988,9599,RPUSD4,13,,126081587
13,101256089,71100,TMTC4,13,,101327189
9,97521930,327570,C9orf3,13,,97849500
12,34175215,6021,ALG10,13,,34181236
15,41099273,7494,ZFYVE19,13,,41106767
20,42544781,153473,TOX2,13,,42698254
12,53645369,2821,MFSD5,13,,53648190
1,222988430,190907,DISP1,13,,223179337
8,145703364,24140,PPP1R16A,13,,145727504
8,98285713,4463,TSPYL5,13,,98290176
2,163227916,467341,KCNH7,13,,163695257
15,91498105,8250,RCCD1,13,,91506355
2,42275160,10508,PKDCC,13,,42285668
17,33288548,1657,ZNF830,13,,33290205
14,74551655,115462,LIN52,13,,74667117
16,46736193,46028,MYLK3,13,,46782221
14,20757300,16853,TTC5,13,,20774153
X,148622518,7358,CXorf40A,13,,148629876
2,231191893,76552,SP140L,13,,231268445
10,98102974,16148,OPALIN,13,,98119122
1,247197939,44176,ZNF670,13,,247242115
13,19997018,113885,TPTE2,13,,20110903
16,48116883,63798,ABCC12,13,,48180681
5,130977406,155350,FNIP1,13,,131132756
14,76452095,97997,IFT43,13,,76550092
16,31000576,21383,STX1B,13,,31021959
14,64063756,44885,WDR89,13,,64108641
19,49925670,1028,PTH2,13,,49926698
12,7052979,2187,C12orf57,13,,7055166
12,40148822,350839,SLC2A13,13,,40499661
17,30348154,32365,LRRC37B,13,,30380519
1,153270337,12857,PGLYRP3,13,,153283194
2,220462572,18601,STK11IP,13,,220481173
11,47586981,8032,PTPMT1,13,,47595013
16,4421848,11681,VASN,13,,4433529
8,52730134,81612,PCMTD1,13,,52811746
15,66585912,40324,DIS3L,13,,66626236
3,26664296,87969,LRRC3B,13,,26752265
20,29956420,5285,DEFB118,13,,29961705
10,105881928,4215,SFR1,13,,105886143
11,45943171,7476,GYLTL1B,13,,45950647
14,92246095,56775,TC2N,13,,92302870
16,80631795,206380,CDYL2,13,,80838175
19,39514662,8574,FBXO27,13,,39523236
19,17392453,6002,ANKLE1,13,,17398455
2,99785725,11799,MITD1,13,,99797524
2,38893051,68858,GALM,13,,38961909
3,131100514,7160,NUDT16,13,,131107674
3,141497042,38850,GRK7,13,,141535892
3,63263913,338684,SYNPR,13,,63602597
4,83845756,88338,LIN54,13,,83934094
5,10277706,30462,CMBL,13,,10308168
8,59323822,40238,UBXN2B,13,,59364060
12,48541570,9808,ASB8,13,,48551378
20,31755882,13341,BPIFA2,13,,31769223
20,43380444,58535,RIMS4,13,,43438979
10,72432261,89934,ADAMTS14,13,,72522195
20,2082527,46671,STK35,13,,2129198
10,116697951,39488,TRUB1,13,,116737439
11,111411232,21238,LAYN,13,,111432470
11,63580845,14345,C11orf84,13,,63595190
12,8997599,31778,A2ML1,13,,9029377
17,77085426,426804,RBFOX3,13,,77512230
17,8706040,64954,PIK3R6,13,,8770994
18,10454624,34074,APCDD1,13,,10488698
21,15646119,27573,ABCC13,13,,15673692
2,175296299,55517,GPR155,13,,175351816
3,46963219,55038,CCDC12,13,,47018257
4,79839093,21489,PAQR3,13,,79860582
6,154726432,105321,CNKSR3,13,,154831753
8,9182560,10030,LOC157273,13,,9192590
X,14903412,36047,MOSPD2,13,,14939459
X,119243010,6837,RHOXF1,13,,119249847
10,75257295,78138,USP54,13,,75335433
12,105413561,64780,ALDH1L2,13,,105478341
14,23352431,4458,REM2,13,,23356889
16,75182338,23794,ZFP1,13,,75206132
17,60778674,105340,10-Mar,13,,60884014
4,150999425,179183,DCLK2,13,,151178608
X,23018077,2129,DDX53,13,,23020206
19,18530145,15227,SSBP4,13,,18545372
X,51075082,5295,NUDT10,13,,51080377
19,44126521,17470,CADM4,13,,44143991
3,58477822,10265,KCTD6,13,,58488087
3,183749529,7628,HTR3D,13,,183757157
17,73885040,8044,TRIM65,13,,73893084
4,184560787,19585,RWDD4,13,,184580372
7,88388681,577690,ZNF804B,13,,88966371
11,125756954,13587,HYLS1,13,,125770541
9,70432003,58208,CBWD5,13,,70490211
6,33422355,2965,ZBTB9,13,,33425320
7,30174551,27830,MTURN,13,,30202381
6,117198375,54951,RFX6,13,,117253326
6,35181838,39018,SCUBE3,13,,35220856
20,29976770,1682,DEFB119,13,,29978452
22,32077333,68787,PRR14L,13,,32146120
2,37311593,14794,GPATCH11,13,,37326387
3,174577110,946318,NAALADL2,13,,175523428
4,106816596,76232,NPNT,13,,106892828
17,6926368,6593,BCL6B,13,,6932961
15,75941347,9621,SNX33,13,,75950968
10,118430702,71383,HSPA12A,13,,118502085
12,11182985,1021,TAS2R31,13,,11184006
11,118766850,14763,BCL9L,13,,118781613
13,50589389,5669,KCNRG,13,,50595058
17,80059345,111344,CCDC57,13,,80170689
2,210636716,227308,UNC80,13,,210864024
5,63461669,207027,RNF180,13,,63668696
6,109416355,68760,CEP57L1,13,,109485115
8,10753656,305219,XKR6,13,,11058875
X,67718623,38504,YIPF6,13,,67757127
X,1581465,74572,P2RY8,13,,1656037
14,94929057,13613,SERPINA9,13,,94942670
17,60501245,26209,METTL2A,13,,60527454
4,68776018,53214,TMPRSS11A,13,,68829232
9,14611068,82412,ZDHHC21,13,,14693480
9,34252377,76821,KIF24,13,,34329198
11,17373308,25560,NCR3LG1,13,,17398868
7,130628918,165757,LINC-PINT,13,,130794675
11,58346586,46619,ZFP91-CNTF,13,,58393205
19,45682002,3057,BLOC1S3,13,,45685059
1,93307716,119363,FAM69A,13,,93427079
21,17442841,540253,MIR99AHG,13,,17983094
3,86987118,53155,VGLL3,13,,87040273
X,142967172,1185,UBE2NL,13,,142968357
15,49115933,139708,SHC4,13,,49255641
15,45406522,3779,DUOXA2,13,,45410301
9,96938628,87,MIRLET7F1,13,,96938715
18,19408964,85,MIR1-2,13,,19409049
14,101349315,97,MIR127,13,,101349412
3,35785967,84,MIR128-2,13,,35786051
7,127847924,72,MIR129-1,13,,127847996
1,220291498,85,MIR194-1,13,,220291583
2,56210101,110,MIR217,13,,56210211
1,19923470,32845,MINOS1,13,,19956315
4,113569029,68,MIR367,13,,113569097
X,48261523,9832,SSX4B,13,,48271355
8,41517958,68,MIR486-1,13,,41518026
2,132241532,8532,MZT2A,13,,132250064
8,145202918,65450,MROH1,13,,145268368
22,24309025,5723,DDTL,13,,24314748
X,154289899,9648,CMC4,13,,154299547
11,30885149,129084,DCDC5,13,,31014233
8,128412643,1752,CCAT2,13,,128414395
11,125542228,8565,ACRV1,12,,125550793
X,2822010,25406,ARSD,12,,2847416
4,13542453,3661,NKX3-2,12,,13546114
21,45748826,10459,C21orf2,12,,45759285
22,43808019,94781,MPPED1,12,,43902800
3,40428646,41471,ENTPD3,12,,40470117
16,31439051,698,COX6A2,12,,31439749
5,118406781,178043,DMXL1,12,,118584824
X,100474932,44553,DRP2,12,,100519485
19,42829760,53161,MEGF8,12,,42882921
19,6887559,52905,EMR1,12,,6940464
17,29630787,10343,EVI2B,12,,29641130
1,26348270,14684,EXTL1,12,,26362954
16,90089007,22372,GAS8,12,,90111379
2,237073878,2774,GBX2,12,,237076652
1,6640050,9290,ZBTB48,12,,6649340
11,63997752,4001,DNAJC4,12,,64001753
19,48958963,10404,KCNJ14,12,,48969367
12,52708084,7098,KRT83,12,,52715182
17,42836546,22668,ADAM11,12,,42859214
5,153418518,18496,MFAP3,12,,153437014
1,203136938,8004,MYBPH,12,,203144942
14,92582467,5686,NDUFB1,12,,92588153
7,140396480,9966,NDUFB2,12,,140406446
4,152591808,90367,GATB,12,,152682175
X,18709044,136990,PPEF1,12,,18846034
3,141205888,128317,RASA2,12,,141334205
14,21249209,1417,RNASE6,12,,21250626
2,167260082,83399,SCN7A,12,,167343481
21,40817796,69637,SH3BGR,12,,40887433
19,47931278,44029,SLC8A2,12,,47975307
4,57676025,11883,SPINK2,12,,57687908
1,153042703,1381,SPRR2B,12,,153044084
1,153065610,1394,SPRR2E,12,,153067004
16,30097114,6091,TBX6,12,,30103205
1,119425665,106514,TBX15,12,,119532179
3,149192367,28814,TM4SF4,12,,149221181
10,102222811,20588,WNT8B,12,,102243399
8,146052902,15705,ZNF7,12,,146068607
16,71481502,14624,ZNF23,12,,71496126
19,44416775,22636,ZNF45,12,,44439411
19,12273871,26193,ZNF136,12,,12300064
2,219502639,21624,ZNF142,12,,219524263
X,119004494,1297,RNF113A,12,,119005791
9,104161135,11807,ZNF189,12,,104172942
2,110841446,32697,MALL,12,,110874143
17,10204182,72140,MYH13,12,,10276322
13,78109808,109590,SCEL,12,,78219398
13,20411592,26184,ZMYM5,12,,20437776
8,72753776,2955,MSC,12,,72756731
6,33282181,3538,ZBTB22,12,,33285719
17,34842470,12684,ZNHIT3,12,,34855154
19,57702867,31347,ZNF264,12,,57734214
15,55611132,36714,PIGB,12,,55647846
17,76374698,46042,PGS1,12,,76420740
2,27994583,8025,MRPL33,12,,28002608
19,13261281,4437,IER2,12,,13265718
22,23487512,20318,RAB36,12,,23507830
1,87380334,183791,HS2ST1,12,,87564125
1,156163722,18865,SLC25A44,12,,156182587
17,26941457,30720,KIAA0100,12,,26972177
6,127759550,20985,KIAA0408,12,,127780535
5,140227356,6388,PCDHA9,12,,140233744
4,6784458,101441,KIAA0232,12,,6885899
1,41086351,44973,RIMS3,12,,41131324
15,32907344,24794,ARHGAP11A,12,,32932138
1,178995073,50629,FAM20B,12,,179045702
14,24641233,8230,REC8,12,,24649463
20,50213313,171637,ATP9A,12,,50384950
4,99391517,188295,TSPAN5,12,,99579812
1,115590632,41489,TSPAN2,12,,115632121
7,12726451,4107,ARL4A,12,,12730558
17,41277573,19672,NBR2,12,,41297245
Y,59100402,14723,SPRY3,12,,59115125
6,27215501,8898,PRSS16,12,,27224399
2,232387870,7312,NMUR1,12,,232395182
6,26383438,11662,BTN2A2,12,,26395100
1,45809554,147286,TESK2,12,,45956840
13,33006624,106398,N4BP2L2,12,,33113022
1,204586302,68179,LRRN2,12,,204654481
17,6977855,5771,CLEC10A,12,,6983626
6,17393735,164288,CAP2,12,,17558023
19,57874878,1843,TRAPPC2B,12,,57876721
14,54976586,28748,CGRRF1,12,,55005334
7,99775346,36664,STAG3,12,,99812010
1,230883129,54389,CAPN9,12,,230937518
19,57791852,13584,ZNF460,12,,57805436
6,4995279,9018,RPP40,12,,5004297
5,153369690,48808,FAM114A2,12,,153418498
10,88728187,2479,ADIRF,12,,88730666
19,10942742,4241,TMED1,12,,10946983
9,135754277,11142,C9orf9,12,,135765419
20,43160421,87257,PKIG,12,,43247678
7,30791750,5468,INMT,12,,30797218
1,151672533,16259,CELF3,12,,151688792
X,48928812,2892,PRAF2,12,,48931704
17,47653297,7874,NXPH3,12,,47661171
20,32290549,17587,PXMP4,12,,32308136
12,10998447,3628,PRR4,12,,11002075
7,39017608,486782,POU6F2,12,,39504390
1,87012758,33674,CLCA4,12,,87046432
18,77866914,31314,ADNP2,12,,77898228
8,142138719,67181,DENND3,12,,142205900
6,87865268,108138,ZNF292,12,,87973406
11,94822973,42842,ENDOD1,12,,94865815
13,42293472,241749,VWA8,12,,42535221
12,49388932,4156,DDN,12,,49393088
22,47016298,59390,GRAMD4,12,,47075688
8,132916334,109552,EFR3A,12,,133025886
3,47324329,63977,KLHL18,12,,47388306
5,5422785,67562,ICE1,12,,5490347
5,64859065,24305,PPWD1,12,,64883370
10,99092253,2205,FRAT2,12,,99094458
19,46213886,20265,FBXO46,12,,46234151
16,1306272,2222,TPSD1,12,,1308494
15,51200868,97229,AP4E1,12,,51298097
1,168048779,58126,GPR161,12,,168106905
22,38203911,9272,GCAT,12,,38213183
22,39214455,25562,NPTXR,12,,39240017
12,130880680,121730,RIMBP2,12,,131002410
17,73043278,18706,KCTD2,12,,73061984
2,136343892,138948,R3HDM1,12,,136482840
4,165118158,705,ANP32C,12,,165118863
2,74685526,2492,WBP1,12,,74688018
9,74298281,85519,TMEM2,12,,74383800
15,24920540,8053,NPAP1,12,,24928593
20,14304638,13675,FLRT3,12,,14318313
3,50333832,3020,NAT6,12,,50336852
19,17622431,9666,PGLS,12,,17632097
6,41757633,81742,USP49,12,,41839375
3,112721291,17264,C3orf17,12,,112738555
19,50529149,22882,ZNF473,12,,50552031
1,154179176,14097,C1orf43,12,,154193273
20,3229947,158362,C20orf194,12,,3388309
10,102246402,33193,SEC31B,12,,102279595
15,42549094,16688,TMEM87A,12,,42565782
1,55222570,7656,PARS2,12,,55230226
X,13587693,64001,EGFL6,12,,13651694
11,73723758,158306,C2CD3,12,,73882064
3,153838791,136825,ARHGEF26,12,,153975616
22,45809571,18731,RIBC2,12,,45828302
2,218135,45962,SH3YL1,12,,264097
3,122920773,72209,SEC22A,12,,122992982
19,639925,3679,FGF22,12,,643604
17,19246369,19682,B9D1,12,,19266051
22,45739944,69556,SMC1B,12,,45809500
19,17003761,133864,CPAMD8,12,,17137625
19,49436938,11288,DHDH,12,,49448226
22,17618409,27768,CECR5,12,,17646177
17,40169593,8063,NKIRAS2,12,,40177656
17,40949635,1108,COA3,12,,40950743
12,110562139,94461,IFT81,12,,110656600
8,146075550,3413,COMMD5,12,,146078963
X,52976463,48188,FAM156A,12,,53024651
2,64681326,7191,LGALSL,12,,64688517
15,52043757,64801,TMOD2,12,,52108558
3,8613467,2887,LINC00312,12,,8616354
12,72666528,392894,TRHDE,12,,73059422
8,145689199,1832,CYHR1,12,,145691031
5,1877540,9753,IRX4,12,,1887293
12,10961692,1075,TAS2R9,12,,10962767
12,10954130,1096,TAS2R7,12,,10955226
6,31802691,4852,C6orf48,12,,31807543
4,39046450,81403,KLHL5,12,,39127853
12,94702055,151709,CEP83,12,,94853764
7,56169254,5069,CHCHD2,12,,56174323
19,56153462,1374,ZNF580,12,,56154836
12,6601315,1156,MRPL51,12,,6602471
1,181057637,2342,IER5,12,,181059979
5,141323149,15478,PCDH12,12,,141338627
X,100805513,4162,ARMCX1,12,,100809675
14,23815519,6141,SLC22A17,12,,23821660
4,84015306,20605,PLAC8,12,,84035911
12,51674821,43161,BIN2,12,,51717982
9,132427919,57032,PRRX2,12,,132484951
14,102814618,14635,CINP,12,,102829253
6,63985855,44027,LGSN,12,,64029882
X,129535942,11375,RBMX2,12,,129547317
7,140705960,8519,MRPS33,12,,140714479
6,166778407,18094,MPC1,12,,166796501
2,179328390,14965,FKBP7,12,,179343355
16,67423709,3729,TPPP3,12,,67427438
19,12382624,23090,ZNF44,12,,12405714
14,61176255,14597,SIX4,12,,61190852
13,21277481,19756,IL17D,12,,21297237
3,151044095,3242,P2RY13,12,,151047337
19,41284123,18726,RAB4B,12,,41302849
21,15588450,12243,RBM11,12,,15600693
21,35747748,13704,SMIM11,12,,35761452
4,138440072,13580,PCDH18,12,,138453652
1,20140521,1250,RNF186,12,,20141771
17,71330522,309705,SDK2,12,,71640227
16,30935895,24209,FBXL19,12,,30960104
6,43588217,6873,GTPBP2,12,,43595090
11,107661716,68198,SLC35F2,12,,107729914
8,143781528,4056,LY6K,12,,143785584
7,102096666,8655,ALKBH4,12,,102105321
4,155243805,169072,DCHS2,12,,155412877
3,183353410,48894,KLHL24,12,,183402304
1,118419333,52969,GDAP2,12,,118472302
1,118148603,22408,FAM46C,12,,118171011
19,18451396,29367,PGPEP1,12,,18480763
2,27255773,8792,TMEM214,12,,27264565
6,34759793,85498,UHRF1BP1,12,,34845291
8,57870487,35943,IMPAD1,12,,57906430
1,39351477,56025,RHBDL2,12,,39407502
13,36756128,32624,SOHLH2,12,,36788752
1,28879528,25529,TRNAU1AP,12,,28905057
11,60691912,12719,TMEM132A,12,,60704631
3,39424814,14005,SLC25A38,12,,39438819
6,151725896,47420,RMND1,12,,151773316
4,110481354,127518,CCDC109B,12,,110608872
14,55738020,82309,FBXO34,12,,55820329
17,66417421,36244,WIPI1,12,,66453665
15,89055710,34224,DET1,12,,89089934
1,178694281,196696,RALGPS2,12,,178890977
7,6617064,11546,ZDHHC4,12,,6628610
3,72798427,99171,SHQ1,12,,72897598
13,114110133,34890,DCUN1D2,12,,114145023
20,62887047,20532,PCMTD2,12,,62907579
10,12110915,54312,DHTKD1,12,,12165227
11,107461816,75689,ELMOD1,12,,107537505
1,104068577,29282,RNPC3,12,,104097859
18,72342918,290095,ZNF407,12,,72633013
6,37225479,75267,TBC1D22B,12,,37300746
12,48166966,9570,SLC48A1,12,,48176536
9,4679552,28846,CDC37L1,12,,4708398
10,70136949,30102,RUFY2,12,,70167051
10,102672325,47022,FAM178A,12,,102719347
3,99979660,64436,TBC1D23,12,,100044096
8,22477946,48715,BIN3,12,,22526661
X,108780058,7869,NXT2,12,,108787927
X,86772714,152336,KLHL4,12,,86925050
5,140800536,92010,PCDHGA11,12,,140892546
5,140601897,3963,PCDHB14,12,,140605860
5,140579347,3271,PCDHB11,12,,140582618
5,140501331,3872,PCDHB4,12,,140505203
5,140254886,137043,PCDHA12,12,,140391929
5,140247097,144832,PCDHA11,12,,140391929
5,140180782,211147,PCDHA3,12,,140391929
10,115939028,53035,TDRD1,12,,115992063
8,130760441,38693,GSDMC,12,,130799134
3,151591430,10977,SUCNR1,12,,151602407
1,151023446,8679,CDC42SE1,12,,151032125
6,161551056,144051,AGPAT4,12,,161695107
5,114856607,23984,FEM1C,12,,114880591
3,100053561,20917,NIT2,12,,100074478
17,42269172,6357,ATXN7L3,12,,42275529
6,158733691,199165,TULP4,12,,158932856
3,101292937,20373,PCNP,12,,101313310
16,21169697,22240,TMEM159,12,,21191937
16,20911987,24344,LYRM1,12,,20936331
20,20370271,322995,RALGAPA2,12,,20693266
19,57966541,1566,VN1R1,12,,57968107
1,154298035,12287,ATP8B2,12,,154310322
2,158175124,9101,ERMN,12,,158184225
11,123396343,102136,GRAMD1B,12,,123498479
17,73496340,9629,CASKIN2,12,,73505969
11,110447758,135015,ARHGAP20,12,,110582773
19,57019211,22372,ZNF471,12,,57041583
X,114345182,123453,LRCH2,12,,114468635
17,36584719,83909,ARHGAP23,12,,36668628
12,125431369,42298,DHX37,12,,125473667
4,1341103,40734,UVSSA,12,,1381837
2,120770603,166094,EPB41L5,12,,120936697
X,75648045,3701,MAGEE1,12,,75651746
18,43427573,119732,EPG5,12,,43547305
16,23765947,4325,CHP2,12,,23770272
11,26353677,331159,ANO3,12,,26684836
19,38794800,846,C19orf33,12,,38795646
10,126150340,152370,LHPP,12,,126302710
2,242716239,27463,GAL3ST2,12,,242743702
2,70056737,51790,GMCL1,12,,70108527
5,177557961,17610,RMND5B,12,,177575571
2,192542860,10388,NABP1,12,,192553248
X,101854425,4660,ARMCX5,12,,101859085
5,170288885,438134,RANBP17,12,,170727019
12,125549912,77967,AACS,12,,125627879
19,12841453,4136,C19orf43,12,,12845589
19,18668571,11626,KXD1,12,,18680197
19,9633899,15422,ZNF426,12,,9649321
8,57124196,7161,CHCHD7,12,,57131357
10,104179570,3323,FBXL15,12,,104182893
6,151773392,17842,C6orf211,12,,151791234
4,56212387,26879,SRD5A3,12,,56239266
4,148653452,340475,ARHGAP10,12,,148993927
3,156977531,243605,VEPH1,12,,157221136
1,53192130,100883,ZYG11B,12,,53293013
16,30535321,2589,ZNF768,12,,30537910
17,80787309,10622,ZNF750,12,,80797931
16,31470316,8172,ARMC5,12,,31478488
11,119056165,4767,PDZD3,12,,119060932
4,156263811,34311,MAP9,12,,156298122
6,30312905,1730,RPP21,12,,30314635
12,21590537,33645,PYROXD1,12,,21624182
16,58549382,5054,SETD6,12,,58554436
10,102767439,23475,PDZD7,12,,102790914
9,5784571,48510,ERMP1,12,,5833081
9,26947309,115622,IFT74,12,,27062931
15,44064797,4705,ELL3,12,,44069502
X,44007127,195796,EFHC2,12,,44202923
6,160888217,43939,LPAL2,12,,160932156
2,99613723,157464,TSGA10,12,,99771187
3,136537860,36874,SLC35G2,12,,136574734
7,76139739,17460,UPK3B,12,,76157199
12,21679190,6691,SPX,12,,21685881
8,145997608,15122,ZNF34,12,,146012730
1,23685940,10417,ZNF436,12,,23696357
X,101975641,31728,BHLHB9,12,,102007369
6,97241997,43356,GPR63,12,,97285353
19,46298967,19638,RSPH6A,12,,46318605
16,47115430,62506,NETO2,12,,47177936
1,77333092,200131,ST6GALNAC5,12,,77533223
1,43916673,2987,HYI,12,,43919660
19,20011721,34661,ZNF93,12,,20046382
X,149934808,132481,CD99L2,12,,150067289
12,2986364,12327,RHNO1,12,,2998691
16,48278077,109813,LONP2,12,,48387890
12,29653745,282998,TMTC1,12,,29936743
5,140682195,1435,SLC25A2,12,,140683630
3,172607146,251912,SPATA16,12,,172859058
10,77542518,774615,C10orf11,12,,78317133
4,154265800,70447,MND1,12,,154336247
1,161195728,4808,TOMM40L,12,,161200536
13,86366921,6562,SLITRK6,12,,86373483
8,42948648,29675,POMK,12,,42978323
18,9885722,2434,TXNDC2,12,,9888156
12,44229663,553882,TMEM117,12,,44783545
16,2961979,28179,FLYWCH1,12,,2990158
8,41386724,15841,GINS4,12,,41402565
18,32820993,6160,ZNF397,12,,32827153
14,104029293,29217,APOPT1,12,,104058510
11,105878647,14367,MSANTD4,12,,105893014
6,28249313,21013,PGBD1,12,,28270326
2,107418055,84555,ST6GAL2,12,,107502610
X,144899346,8014,SLITRK2,12,,144907360
10,100143321,31657,PYROXD2,12,,100174978
6,11713887,65393,ADTRP,12,,11779280
1,247460714,34528,ZNF496,12,,247495242
11,118401802,4748,TMEM25,12,,118406550
4,169908741,22727,CBR4,12,,169931468
11,124492741,13081,TBRG1,12,,124505822
19,33369903,93032,CEP89,12,,33462935
7,133974089,27738,SLC35B4,12,,134001827
8,110253147,89015,NUDCD1,12,,110342162
15,44162958,323686,FRMD5,12,,44486644
21,43491425,71680,UMODL1,12,,43563105
18,61223392,13168,SERPINB12,12,,61236560
19,51913274,7783,SIGLEC10,12,,51921057
14,37147125,494740,SLC25A21,12,,37641865
11,44785975,168002,TSPAN18,12,,44953977
19,53569866,36821,ZNF160,12,,53606687
14,20926011,3760,TMEM55B,12,,20929771
16,1826712,5869,SPSB3,12,,1832581
8,145691719,7780,KIFC2,12,,145699499
11,65541368,6694,AP5B1,12,,65548062
5,173034147,9519,BOD1,12,,173043666
17,48770550,14720,ANKRD40,12,,48785270
15,98503932,13136,ARRDC4,12,,98517068
19,507496,12158,TPGS1,12,,519654
5,171636649,74146,UBTD2,12,,171710795
15,59499014,1771,LDHAL6B,12,,59500785
10,127585107,113054,FANK1,12,,127698161
20,17949533,22232,MGME1,12,,17971765
9,140500091,9721,ARRDC1,12,,140509812
9,140448895,24492,DPH7,12,,140473387
12,56661066,3684,COQ10A,12,,56664750
19,9964393,82835,OLFM2,12,,10047228
14,55518361,18551,MAPK1IP1L,12,,55536912
4,7045155,14522,TADA2B,12,,7059677
17,72209695,48462,TTYH2,12,,72258157
19,47137332,607,GNG8,12,,47137939
1,156262477,3003,C1orf85,12,,156265480
4,108852716,21897,CYP2U1,12,,108874613
11,104912052,3999,CARD16,12,,104916051
16,81203894,50081,PKD1L2,12,,81253975
19,48988527,27919,LMTK3,12,,49016446
12,57916658,7273,MBD6,12,,57923931
6,28539406,15706,ZBED9,12,,28555112
17,1682828,50347,SMYD4,12,,1733175
19,18043823,10971,CCDC124,12,,18054794
19,7911385,18477,EVI5L,12,,7929862
14,103995508,7902,TRMT61A,12,,104003410
6,117996616,35270,NUS1,12,,118031886
9,71394921,3874,FAM122A,12,,71398795
2,74699084,858,MRPL53,12,,74699942
14,39703124,19451,MIA2,12,,39722575
X,85403454,684151,DACH2,12,,86087605
3,16216183,55070,GALNT15,12,,16271253
20,2517252,105178,TMC2,12,,2622430
1,102268122,44514,OLFM3,12,,102312636
10,75541807,1599,CHCHD1,12,,75543406
10,95427639,34690,FRA10AC1,12,,95462329
11,36616042,64799,C11orf74,12,,36680841
11,111169975,9485,COLCA2,12,,111179460
11,118064441,31368,AMICA1,12,,118095809
16,84178864,32662,DNAAF1,12,,84211526
16,66638227,9568,CMTM3,12,,66647795
17,48912604,7105,WFIKKN2,12,,48919709
17,47210130,37221,B4GALNT2,12,,47247351
17,31318881,6014,SPACA3,12,,31324895
17,1472547,59122,SLC43A2,12,,1531669
19,7745706,2042,TRAPPC5,12,,7747748
19,51009253,5359,JOSD2,12,,51014612
19,5891286,12738,NDUFA11,12,,5904024
19,751112,13207,MISP,12,,764319
19,34972879,19206,WTIP,12,,34992085
19,15619335,43793,CYP4F22,12,,15663128
1,1167628,2792,B3GALT6,12,,1170420
1,95285897,74906,SLC44A3,12,,95360803
1,111659953,22885,DRAM2,12,,111682838
20,30448869,9175,DUSP15,12,,30458044
3,127291906,17696,TPRA1,12,,127309602
4,177105724,11098,SPATA4,12,,177116822
5,126853300,37480,PRRC1,12,,126890780
5,36192690,49210,NADK2,12,,36241900
5,74970023,43290,POC5,12,,75013313
6,89855768,19520,PM20D2,12,,89875288
8,13942343,1153449,SGCZ,12,,15095792
8,52232136,489869,PXDNL,12,,52722005
8,41435706,46814,AGPAT6,12,,41482520
20,62375020,61836,ZBTB46,12,,62436856
20,31030861,142014,NOL4L,12,,31172875
20,35729628,78363,MROH8,12,,35807991
20,31571580,20659,SUN5,12,,31592239
X,102754680,19737,RAB40A,12,,102774417
12,50229825,7087,BCDIN3D,12,,50236912
19,2714564,6826,DIRAS1,12,,2721390
1,53971905,227972,GLIS1,12,,54199877
1,26437655,14384,PDIK1L,12,,26452039
20,31290492,41322,COMMD7,12,,31331814
22,29138019,15487,HSCB,12,,29153506
22,29168661,16628,CCDC117,12,,29185289
2,88367298,45604,SMYD1,12,,88412902
2,180306710,304059,ZNF385B,12,,180610769
2,38152461,92429,RMDN2,12,,38244890
2,20866423,12578,GDF7,12,,20879001
3,9745509,26083,CPNE9,12,,9771592
3,118619478,134198,IGSF11,12,,118753676
5,121297655,66640,SRFBP1,12,,121364295
5,140079944,6322,ZMAT2,12,,140086266
7,48211056,476035,ABCA13,12,,48687091
8,124780678,47012,FAM91A1,12,,124827690
9,114287438,52686,ZNF483,12,,114340124
12,52404275,5398,GRASP,12,,52409673
14,95883830,58343,SYNE3,12,,95942173
14,38723204,2371,CLEC14A,12,,38725575
1,89829435,24284,GBP6,12,,89853719
4,22388996,128681,GPR125,12,,22517677
6,168707583,12851,DACT2,12,,168720434
7,108202587,7625,THAP5,12,,108210212
X,13671309,12218,TCEANC,12,,13683527
7,150413644,7724,GIMAP1,12,,150421368
6,31105310,1817,PSORS1C2,12,,31107127
15,41164411,2076,RHOV,12,,41166487
16,5134300,13521,EEF2KMT,12,,5147821
1,52816264,15613,CC2D1B,12,,52831877
1,242251688,361096,PLD5,12,,242612784
1,228353508,16450,IBA57,12,,228369958
3,196295724,20206,FBXO45,12,,196315930
3,49209017,4902,KLHDC8B,12,,49213919
3,114012832,16303,TIGIT,12,,114029135
9,34398181,60387,FAM219A,12,,34458568
Y,20137667,1960,CDY2B,12,,20139627
5,115298150,65149,AQPEP,12,,115363299
10,63422718,103373,C10orf107,12,,63526091
10,71897736,8760,TYSND1,12,,71906496
11,71791376,16562,LRTOMT,12,,71807938
6,36973422,23423,FGD2,12,,36996845
7,19735084,13576,TWISTNB,12,,19748660
7,20821893,4615,SP8,12,,20826508
7,4945619,53225,MMD2,12,,4998844
7,102453307,261981,FBXL13,12,,102715288
7,105245220,271811,ATXN7L1,12,,105517031
7,84624871,126376,SEMA3D,12,,84751247
8,7682693,3882,DEFB106A,12,,7686575
X,79924986,140247,BRWD3,12,,80065233
11,66045671,6014,CNIH2,12,,66051685
15,34651088,8307,LPCAT4,12,,34659395
1,85391265,71540,MCOLN2,12,,85462805
3,190984943,63382,UTS2B,12,,191048325
7,92190071,29637,FAM133B,12,,92219708
11,22841808,9600,SVIP,12,,22851408
7,142880511,1017,TAS2R39,12,,142881528
13,96743092,748724,HS6ST3,12,,97491816
6,46987621,22478,GPR110,12,,47010099
11,57508721,2305,C11orf31,12,,57511026
12,63952692,109662,DPY19L2,12,,64062354
12,10183275,35354,CLEC9A,12,,10218629
18,72907064,14239,ZADH2,12,,72921303
5,93486555,467754,KIAA0825,12,,93954309
5,98104998,27200,RGMB,12,,98132198
9,140086068,9095,TPRN,12,,140095163
9,25676386,2470,TUSC1,12,,25678856
12,53001353,10990,KRT73,12,,53012343
1,153388999,6702,S100A7A,12,,153395701
10,115999012,55247,VWA2,12,,116054259
3,15206868,40598,COL6A4P1,12,,15247466
9,133768814,3385,QRFP,12,,133772199
10,68685791,175518,LRRTM3,12,,68861309
1,31883020,24507,SERINC2,12,,31907527
15,90439763,16156,ARPIN,12,,90455919
7,99520891,6352,GJC3,12,,99527243
11,57228009,17003,RTN4RL2,12,,57245012
11,58874657,20231,FAM111B,12,,58894888
12,80838125,235843,PTPRQ,12,,81073968
15,102501015,15793,WASH3P,12,,102516808
2,114341229,15384,WASH2P,12,,114356613
19,33182866,21836,NUDT19,12,,33204702
4,91048683,1474687,CCSER1,12,,92523370
9,37588411,4225,TOMM5,12,,37592636
9,96941115,87,MIRLET7D,12,,96941202
9,4850296,79,MIR101-2,12,,4850375
8,65291705,109,MIR124-2,12,,65291814
9,127455988,89,MIR181B2,12,,127456077
1,172113674,110,MIR199A2,12,,172113784
17,57228496,86,MIR301A,12,,57228582
22,50968837,2171,ODF3B,12,,50971008
2,132354346,12628,POTEKP,12,,132366974
5,131746464,65272,C5orf56,12,,131811736
6,29079586,1075,OR2J3,12,,29080661
7,150322463,7273,GIMAP6,12,,150329736
16,30205163,3724,SLX1A,12,,30208887
8,29989186,13014,MBOAT4,12,,30002200
17,18874380,33680,FAM83G,12,,18908060
X,73438211,85,MIR421,12,,73438296
X,52780280,10337,SSX2B,12,,52790617
2,113125945,65277,RGPD8,12,,113191222
13,107820878,698582,FAM155A,12,,108519460
1,145293370,1172751,NBPF10,12,,146466121
15,42120282,9503,JMJD7,12,,42129785
2,122288455,130,RNU4ATAC,12,,122288585
17,22022436,1555,MTRNR2L1,12,,22023991
8,67579786,194471,C8orf44-SGK3,12,,67774257
1,110602996,10326,ALX3,11,,110613322
9,33624222,1310,ANXA2P2,11,,33625532
X,11155662,290243,ARHGAP6,11,,11445905
X,2958274,72496,ARSF,11,,3030770
11,61447904,66570,DAGLA,11,,61514474
21,34821447,30869,TMEM50B,11,,34852316
16,66878840,9209,CA7,11,,66888049
19,52021072,14038,SIGLEC6,11,,52035110
16,67963472,2306,CTRL,11,,67965778
11,1575280,17870,DUSP8,11,,1593150
2,73518056,2773,EGR4,11,,73520829
10,48425778,13360,GDF10,11,,48439138
20,62737182,1002,NPBWR2,11,,62738184
7,107110501,5624,GPR22,11,,107116125
10,125425870,31043,GPR26,11,,125456913
4,144796467,30249,GYPE,11,,144826716
12,96366439,23704,HAL,11,,96390143
16,230332,846,HBQ1,11,,231178
6,33080292,16598,HLA-DPB2,11,,33096890
20,43719854,9899,KCNS1,11,,43729753
X,49031150,11703,PRICKLE3,11,,49042853
6,42979750,1902,MEA1,11,,42981652
16,56666533,1365,MT1M,11,,56667898
11,76813885,492,OMP,11,,76814377
9,70971814,174163,PGM5,11,,71145977
18,61575223,28122,SERPINB10,11,,61603345
12,54973023,9420,PPP1R1A,11,,54982443
12,11418846,3795,PRB3,11,,11422641
Y,7142012,107576,PRKY,11,,7249588
X,37208527,108021,PRRG1,11,,37316548
19,55692614,28260,PTPRH,11,,55720874
11,61664767,22974,RAB3IL1,11,,61687741
22,32614462,36856,SLC5A4,11,,32651318
7,122753587,86438,SLC13A1,11,,122840025
1,153122057,1370,SPRR2G,11,,153123427
3,36421978,167520,STAC,11,,36589498
14,53196882,44823,STYX,11,,53241705
1,168510002,3233,XCL2,11,,168513235
11,3647689,11100,TRPC2,11,,3658789
11,64851693,4181,ZFPL1,11,,64855874
10,38299577,49418,ZNF33A,11,,38348995
3,44690232,12051,ZNF35,11,,44702283
X,47304576,37769,ZNF41,11,,47342345
14,64953554,17009,ZBTB25,11,,64970563
12,133613871,26019,ZNF84,11,,133639890
19,58570606,4698,ZNF135,11,,58575304
6,27418520,22377,ZNF184,11,,27440897
16,3162562,7956,ZNF205,11,,3170518
X,57931863,5204,ZXDA,11,,57937067
X,6966960,99271,HDHD1,11,,7066231
3,58490862,32067,ACOX2,11,,58522929
3,137483133,2039,SOX14,11,,137485172
1,1567559,2471,MMP23B,11,,1570030
11,129245880,76294,BARX2,11,,129322174
19,13254871,6317,STX10,11,,13261188
X,49452053,8543,PAGE1,11,,49460596
9,130697373,3390,DPM2,11,,130700763
4,76501703,54021,CDKL2,11,,76555724
Y,15815446,2456,TMSB4Y,11,,15817902
7,137072395,459215,DGKI,11,,137531610
2,129023053,53118,HS6ST1,11,,129076171
17,16120508,109065,PIGL,11,,16229573
X,49593905,4962,PAGE4,11,,49598867
17,4862520,8612,SPAG7,11,,4871132
14,104378624,9279,C14orf2,11,,104387903
13,41790515,47198,MTRF1,11,,41837713
16,85096817,31011,KIAA0513,11,,85127828
9,35749276,3988,RGP1,11,,35753264
10,97889471,34046,ZNF518A,11,,97923517
3,36868307,118241,TRANK1,11,,36986548
14,54893646,14502,CNIH1,11,,54908148
5,77781037,163611,LHFPL2,11,,77944648
12,7013896,9510,LRRC23,11,,7023406
4,41992522,97029,SLC30A9,11,,42089551
12,6937537,11481,LEPREL2,11,,6949018
1,155216995,8279,FAM189B,11,,155225274
7,31726630,21439,PPP1R17,11,,31748069
4,981444,5784,SLC26A1,11,,987228
5,157052686,26742,SOX30,11,,157079428
12,123942650,8291,SNRNP35,11,,123950941
2,114384805,16170,RABL2A,11,,114400975
12,93771698,25326,NUDT4,11,,93797024
13,95361878,2919,SOX21,11,,95364797
20,3907955,88283,RNF24,11,,3996238
X,15756411,49337,CA5B,11,,15805748
7,32997015,49528,FKBP9,11,,33046543
7,115575201,95666,TFEC,11,,115670867
9,131707808,2204,DOLK,11,,131710012
10,121578768,9894,INPP5F,11,,121588662
4,71587558,86781,RUFY3,11,,71674339
1,19609056,6224,AKR7A3,11,,19615280
5,149380168,52538,HMGXB3,11,,149432706
3,129366634,232768,TMCC1,11,,129599402
9,129567284,33203,ZBTB43,11,,129600487
15,78287326,82668,TBC1D2B,11,,78369994
5,132532151,416072,FSTL4,11,,132948223
8,144519824,103796,ZC3H3,11,,144623620
16,87439851,85609,ZCCHC14,11,,87525460
1,183605181,292504,RGL1,11,,183897685
4,154387497,170365,KIAA0922,11,,154557862
7,2598605,48591,IQCE,11,,2647196
13,95226307,22222,TGDS,11,,95248529
2,98372800,239554,TMEM131,11,,98612354
8,48173469,475094,SPIDR,11,,48648563
20,55904830,14219,SPO11,11,,55919049
X,21724089,52189,SMPX,11,,21776278
9,111777414,104811,TMEM245,11,,111882225
22,48885271,262476,FAM19A5,11,,49147747
18,67671042,201920,RTTN,11,,67872962
3,9404716,23759,THUMPD3,11,,9428475
18,34374068,35111,TPGS2,11,,34409179
12,54762912,22177,ZNF385A,11,,54785089
7,32907777,23691,KBTBD2,11,,32931468
3,52350334,84179,DNAH1,11,,52434513
11,76493356,15842,TSKU,11,,76509198
17,31254927,13740,TMEM98,11,,31268667
20,37434335,117332,PPP1R16B,11,,37551667
19,47759730,15480,CCDC9,11,,47775210
1,77748286,277368,AK5,11,,78025654
11,6502676,3235,TIMM10B,11,,6505911
X,70521597,3624,ITGB1BP2,11,,70525221
16,89642175,21479,CPNE7,11,,89663654
10,72238563,89643,PALD1,11,,72328206
19,3933100,9314,NMRK2,11,,3942414
2,108994366,11060,SULT1C4,11,,109005426
1,27860755,69250,AHDC1,11,,27930005
10,99894380,110274,R3HCC1L,11,,100004654
X,78200828,18396,P2RY10,11,,78219224
7,134868589,27727,WDR91,11,,134896316
16,58283839,33895,CCDC113,11,,58317734
11,36293841,17158,COMMD9,11,,36310999
3,111717585,15150,TAGLN3,11,,111732735
11,125774260,18746,DDX25,11,,125793006
22,24094929,1701,VPREB3,11,,24096630
17,40724327,5407,PSMC3IP,11,,40729734
17,900132,5291,TIMM22,11,,905423
19,40946747,1758,SERTAD3,11,,40948505
12,41582249,386143,PDZRN4,11,,41968392
1,20246799,3311,PLA2G2E,11,,20250110
10,124591670,14021,CUZD1,11,,124605691
19,10123924,9030,RDH8,11,,10132954
4,167654535,501206,SPOCK3,11,,168155741
6,8413299,22501,SLC35B3,11,,8435800
2,96068447,10432,FAHD2A,11,,96078879
10,105206542,5620,CALHM2,11,,105212162
11,117049938,18223,SIDT2,11,,117068161
8,102209265,8695,ZNF706,11,,102217960
3,137842559,8670,A4GNT,11,,137851229
19,49316273,23661,HSD17B14,11,,49339934
1,119911398,25355,HAO2,11,,119936753
10,76854189,14781,DUSP13,11,,76868970
21,38437663,7440,PIGP,11,,38445103
19,50479723,49082,VRK3,11,,50528805
2,97513723,10033,ANKRD39,11,,97523756
12,10222152,29512,CLEC1A,11,,10251664
17,27369917,14319,PIPOX,11,,27384236
X,132350696,1680,TFDP3,11,,132352376
19,38055154,30539,ZNF571,11,,38085693
2,25166504,28459,DNAJC27,11,,25194963
5,137673223,12195,FAM53C,11,,137685418
2,86426555,13922,MRPL35,11,,86440477
17,66244144,9161,AMZ2,11,,66253305
6,116892529,22235,RWDD1,11,,116914764
11,86013252,43733,C11orf73,11,,86056985
6,10723147,8215,TMEM14C,11,,10731362
20,42824580,14966,OSER1,11,,42839546
9,100666770,18082,C9orf156,11,,100684852
2,44001177,35972,DYNC2LI1,11,,44037149
3,121312169,36970,FBXO40,11,,121349139
19,19375173,8901,TM6SF2,11,,19384074
3,151011875,22761,GPR87,11,,151034636
21,37415981,16681,SETD4,11,,37432662
21,36041461,49064,CLIC6,11,,36090525
4,5016313,4884,CYTL1,11,,5021197
6,13363586,122829,GFOD1,11,,13486415
X,100523240,23085,TAF7L,11,,100546325
5,14581890,34397,FAM105A,11,,14616287
2,37208143,103345,HEATR5B,11,,37311488
6,55299170,144842,HMGCLL1,11,,55444012
9,125611731,55831,RC3H2,11,,125667562
5,64961754,56187,SGTB,11,,65017941
9,112002006,81238,EPB41L4B,11,,112083244
1,62660473,17528,L1TD1,11,,62678001
3,45796940,41095,SLC6A20,11,,45838035
11,107799200,35008,RAB39A,11,,107834208
3,123687862,22337,ROPN1,11,,123710199
1,78511588,92545,GIPC2,11,,78604133
1,185126191,134722,SWT1,11,,185260913
X,106366656,83014,NUP62CL,11,,106449670
17,72772621,63301,TMEM104,11,,72835922
19,55591759,7532,EPS8L1,11,,55599291
1,100111430,48667,PALMD,11,,100160097
3,32522803,21600,CMTM6,11,,32544403
19,19230424,18886,TMEM161A,11,,19249310
3,196439244,23632,PIGX,11,,196462876
3,25831562,4463,OXSM,11,,25836025
22,45705080,32756,FAM118A,11,,45737836
14,45553301,31503,PRPF39,11,,45584804
17,78010430,54190,CCDC40,11,,78064620
15,66797420,44402,ZWILCH,11,,66841822
7,66386202,37336,TMEM248,11,,66423538
3,100211462,84834,TMEM45A,11,,100296296
3,62355346,3844,FEZF2,11,,62359190
1,217600334,204110,GPATCH2,11,,217804444
19,2233148,3204,PLEKHJ1,11,,2236352
3,49052920,3121,DALRD3,11,,49056041
14,50091891,10057,DNAAF2,11,,50101948
15,101109427,33018,LINS,11,,101142445
12,107168333,114762,RIC8B,11,,107283095
12,6420098,17574,PLEKHG6,11,,6437672
1,204100188,21122,ETNK2,11,,204121310
8,27590832,39338,CCDC25,11,,27630170
2,88469813,16343,THNSL2,11,,88486156
12,25261222,86874,CASC1,11,,25348096
7,99752042,4302,C7orf43,11,,99756344
17,53796987,12495,TMEM100,11,,53809482
16,12753655,144089,CPPED1,11,,12897744
4,164415672,26019,TMA16,11,,164441691
4,186320693,26446,UFSP2,11,,186347139
14,69865384,63723,SLC39A9,11,,69929107
16,67193890,4187,FBXL8,11,,67198077
18,22006608,26886,IMPACT,11,,22033494
10,43633892,46862,CSGALNACT2,11,,43680754
18,48494386,20104,ELAC1,11,,48514490
5,153570294,230249,GALNT10,11,,153800543
1,68939834,23070,DEPDC1,11,,68962904
13,111175412,38672,RAB20,11,,111214084
11,47593748,6819,KBTBD4,11,,47600567
14,57735605,21192,AP5M1,11,,57756797
19,53115617,26027,ZNF83,11,,53141644
12,95470524,140716,FGD6,11,,95611240
11,85339616,7967,TMEM126B,11,,85347583
13,52951302,29327,THSD1,11,,52980629
X,102330749,17273,NXF3,11,,102348022
5,140593490,3503,PCDHB13,11,,140596993
5,140235467,156462,PCDHA10,11,,140391929
5,140201360,190569,PCDHA5,11,,140391929
5,140186658,205271,PCDHA4,11,,140391929
7,23749944,122186,STK31,11,,23872130
3,69157822,13924,LMOD3,11,,69171746
22,24577443,7631,SUSD2,11,,24585074
19,33699569,17187,SLC7A10,11,,33716756
2,75185774,11085,POLE4,11,,75196859
14,90528108,124093,KCNK13,11,,90652201
20,16728997,3812,OTOR,11,,16732809
7,16639400,46042,ANKMY2,11,,16685442
3,179306254,16180,MRPL47,11,,179322434
6,138483052,182748,KIAA1244,11,,138665800
2,204103163,67400,CYP20A1,11,,204170563
17,73262309,5002,MIF4GD,11,,73267311
19,1815244,33208,REXO1,11,,1848452
6,40359372,195831,LRFN2,11,,40555203
15,42867856,145340,STARD9,11,,43013196
14,24867991,20503,NYNRIN,11,,24888494
11,77899857,25900,USP35,11,,77925757
6,71123106,147771,FAM135A,11,,71270877
8,12869772,17512,KIAA1456,11,,12887284
18,59854523,119832,KIAA1468,11,,59974355
16,84509965,28323,TLDC1,11,,84538288
5,72848024,13487,ANKRA2,11,,72861511
1,934343,1209,HES4,11,,935552
14,74353317,45674,ZNF410,11,,74398991
11,60145957,17469,MS4A7,11,,60163426
7,44178462,2454,MYL7,11,,44180916
4,109571740,17238,OSTC,11,,109588978
10,99437180,9835,AVPI1,11,,99447015
1,156589085,6432,HAPLN2,11,,156595517
15,75315895,27172,PPCDC,11,,75343067
2,27274490,7913,AGBL5,11,,27282403
14,23456109,23301,C14orf93,11,,23479410
14,23067146,14119,ABHD4,11,,23081265
19,56950692,38078,ZNF667,11,,56988770
5,111498314,256696,EPB41L4A,11,,111755010
16,50186828,82391,PAPD5,11,,50269219
2,20817563,33301,HS1BP3,11,,20850864
3,39183341,11761,CSRNP1,11,,39195102
X,48456223,7359,WDR13,11,,48463582
7,128431463,30724,CCDC136,11,,128462187
1,47100710,33389,ATPAF1,11,,47134099
9,95375465,57082,IPPK,11,,95432547
22,43924623,283594,EFCAB6,11,,44208217
14,53241910,16476,GNPNAT1,11,,53258386
15,76629064,5752,ISL2,11,,76634816
1,1370902,7360,VWA1,11,,1378262
1,227918889,4223,JMJD4,11,,227923112
2,110371910,4654,SOWAHC,11,,110376564
5,125695787,134066,GRAMD3,11,,125829853
13,21750371,2849,MRPL57,11,,21753220
1,151138497,4276,SCNM1,11,,151142773
17,2319347,95853,METTL16,11,,2415200
2,105953815,11456,C2orf49,11,,105965271
11,93469095,5608,TAF1D,11,,93474703
20,13765671,33396,NDUFAF5,11,,13799067
2,220042911,7286,FAM134A,11,,220050197
19,4304590,19253,FSD1,11,,4323843
11,126081618,51261,FAM118B,11,,126132879
2,175260456,33847,SCRN3,11,,175294303
7,99756864,9509,GAL3ST4,11,,99766373
3,48473579,7950,CCDC51,11,,48481529
11,78147006,138903,NARS2,11,,78285909
1,84335056,129777,TTLL7,11,,84464833
X,45021554,38592,CXorf36,11,,45060146
17,43213013,8535,ACBD4,11,,43221548
7,1473994,25115,MICALL2,11,,1499109
16,19422056,88378,TMC5,11,,19510434
17,635785,10423,FAM57A,11,,646208
6,41157486,11439,TREML2,11,,41168925
12,124155659,37291,TCTN2,11,,124192950
1,92764521,89211,RPAP2,11,,92853732
15,50150434,260985,ATP8B4,11,,50411419
1,156213111,4797,PAQR6,11,,156217908
4,100817406,50477,DNAJB14,11,,100867883
5,64920557,41397,TRAPPC13,11,,64961954
4,184020462,221467,WWC2,11,,184241929
15,83140198,42779,GOLGA2P10,11,,83182977
11,75428863,15140,MOGAT2,11,,75444003
10,70980058,47257,HKDC1,11,,71027315
12,107371068,9876,MTERF2,11,,107380944
6,31733370,11738,VWA7,11,,31745108
4,175204827,36655,CEP44,11,,175241482
7,139784545,92196,KDM7A,11,,139876741
16,47188298,306887,ITFG1,11,,47495185
11,75145684,90915,GDPD5,11,,75236599
16,67714618,38655,GFOD2,11,,67753273
6,55921387,190991,COL21A1,11,,56112378
16,20817766,43224,LOC81691,11,,20860990
20,814339,12583,FAM110A,11,,826922
10,4868368,21883,AKR1E2,11,,4890251
11,65684282,2249,C11orf68,11,,65686531
10,12938624,203149,CCDC3,11,,13141773
16,30103636,3901,YPEL3,11,,30107537
16,30035743,6443,FAM57B,11,,30042186
4,15961862,2997,FGFBP2,11,,15964859
1,27648635,14256,TMEM222,11,,27662891
4,100432160,31300,C4orf17,11,,100463460
2,85581842,37033,ELMOD3,11,,85618875
2,27799388,6201,C2orf16,11,,27805589
19,12799729,7726,FBXW9,11,,12807455
9,86553226,18431,C9orf64,11,,86571657
1,156254069,8165,TMEM79,11,,156262234
10,99205887,11240,ZDHHC16,11,,99217127
11,63993729,3759,NUDT22,11,,63997488
12,510740,41066,CCDC77,11,,551806
5,74017028,46168,GFM2,11,,74063196
X,46458685,159922,SLC9A7,11,,46618607
2,71336805,20589,MCEE,11,,71357394
12,121148237,13206,UNC119B,11,,121161443
12,109490374,35457,USP30,11,,109525831
3,52002525,6121,ABHD14B,11,,52008646
3,197518096,80360,LRCH3,11,,197598456
12,56512003,4277,ZC3H10,11,,56516280
12,53458099,15105,SPRYD3,11,,53473204
12,113623330,6843,RITA1,11,,113630173
11,73087712,20807,RELT,11,,73108519
1,18434239,270738,IGSF21,11,,18704977
1,34642552,42179,C1orf94,11,,34684731
19,10654569,9530,ATG4D,11,,10664099
12,15260715,113696,RERG,11,,15374411
6,99880183,83069,USP45,11,,99963252
22,20301760,5868,DGCR6L,11,,20307628
21,46359911,36993,FAM207A,11,,46396904
16,50582240,92531,NKD1,11,,50674771
14,77564577,19053,CIPC,11,,77583630
7,89975978,44791,GTPBP10,11,,90020769
Y,20933699,1905,HSFY1,11,,20935604
3,183205318,68181,KLHL6,11,,183273499
16,15596122,85994,C16orf45,11,,15682116
16,57220195,54192,RSPRY1,11,,57274387
19,1248551,10591,MIDN,11,,1259142
11,1855539,3212,SYT8,11,,1858751
X,131760037,335386,HS6ST2,11,,132095423
5,102594402,19959,C5orf30,11,,102614361
19,38794199,12246,YIF1B,11,,38806445
5,130506606,34513,LYRM7,11,,130541119
17,62502853,31216,CEP95,11,,62534069
1,213165523,23694,ANGEL2,11,,213189217
8,145946293,34677,ZNF251,11,,145980970
12,50523088,38228,CERS5,11,,50561316
18,5954704,460206,L3MBTL4,11,,6414910
12,88429267,14670,C12orf29,11,,88443937
19,1009649,11492,TMEM259,11,,1021141
2,197851385,324136,ANKRD44,11,,198175521
17,34058678,11862,RASL10B,11,,34070540
10,1064846,6953,IDI2,11,,1071799
11,107373452,63009,ALKBH8,11,,107436461
7,138710451,10324,ZC3HAV1L,11,,138720775
5,68513572,12413,MRPS36,11,,68525985
1,169761669,2448,METTL18,11,,169764117
1,202976533,16664,TMEM183A,11,,202993197
1,159997461,4322,PIGM,11,,160001783
12,18891044,1078,CAPZA3,11,,18892122
19,19779596,14719,ZNF101,11,,19794315
19,49550894,1474,CGB8,11,,49552368
19,53792853,2022,BIRC8,11,,53794875
6,136552167,19306,MTFR2,11,,136571473
14,105403590,41104,AHNAK2,11,,105444694
15,44580908,127051,CASC4,11,,44707959
19,49535129,1366,CGB2,11,,49536495
4,101107026,4629,DDIT4L,11,,101111655
3,66271167,158184,SLC25A26,11,,66429351
19,38899697,17248,RASGRP4,11,,38916945
19,17566233,5492,NXNL1,11,,17571725
16,88762902,9898,RNF166,11,,88772800
6,149887527,24540,GINM1,11,,149912067
16,681011,3105,WFIKKN1,11,,684116
11,19076002,6226,MRGPRX2,11,,19082228
10,128113573,96437,C10orf90,11,,128210010
10,104613966,10752,C10orf32,11,,104624718
10,129676113,15098,CLRN3,11,,129691211
11,30344645,15125,ARL14EP,11,,30359770
12,49458458,5350,RHEBL1,11,,49463808
14,96858447,97317,AK7,11,,96955764
14,39617014,22620,TRAPPC6B,11,,39639634
14,74058409,4061,ACOT4,11,,74062470
15,83676701,3692,C15orf40,11,,83680393
16,15131709,18227,NTAN1,11,,15149936
16,15959575,22931,FOPNL,11,,15982506
17,72517312,10301,CD300LB,11,,72527613
17,42754804,12361,CCDC43,11,,42767165
17,16342300,3040,LRRC75A-AS1,11,,16345340
19,56511091,62083,NLRP5,11,,56573174
19,19312219,2019,NR2C2AP,11,,19314238
1,151043079,47928,GABPB2,11,,151091007
2,85825669,4153,TMEM150A,11,,85829822
2,178977150,17232,RBM45,11,,178994382
3,131252403,504245,CPNE4,11,,131756648
3,122078437,23641,CCDC58,11,,122102078
3,194075975,14497,LRRC15,11,,194090472
3,9944511,13573,IL17RE,11,,9958084
4,48887396,21449,OCIAD2,11,,48908845
5,38258510,207072,EGFLAM,11,,38465582
6,30908776,13222,DPCR1,11,,30921998
7,142981991,3151,TMEM139,11,,142985142
7,101006100,196204,COL26A1,11,,101202304
7,40172341,1910,MPLKIP,11,,40174251
7,117003275,64302,ASZ1,11,,117067577
8,67344717,36327,ADHFE1,11,,67381044
12,125478193,32156,BRI3BP,11,,125510349
6,24126413,21344,NRSN1,11,,24147757
20,23431040,2442,CST11,11,,23433482
22,22838770,24735,ZNF280B,11,,22863505
5,134779903,3135,DCANP1,11,,134783038
X,63444071,6440,ASB12,11,,63450511
11,4665155,11561,OR51E1,11,,4676716
12,7965107,60528,SLC2A14,11,,8025635
12,70047388,45808,BEST3,11,,70093196
12,52562779,23005,KRT80,11,,52585784
14,94184643,70123,PRIMA1,11,,94254766
14,37667117,353347,MIPOL1,11,,38020464
14,80962820,443064,CEP128,11,,81405884
15,90319588,2394,MESP2,11,,90321982
16,66613350,8827,CMTM2,11,,66622177
19,37569123,52145,ZNF420,11,,37621268
1,235628212,39569,B3GALNT2,11,,235667781
1,228675067,8822,RNF187,11,,228683889
2,95940195,16860,PROM2,11,,95957055
2,70187223,2174,ASPRV1,11,,70189397
2,158851690,140976,UPP2,11,,158992666
3,180319917,9001,TTC14,11,,180328918
3,194789012,202883,XXYLT1,11,,194991895
3,27257096,153855,NEK10,11,,27410951
4,53739150,493092,SCFD2,11,,54232242
4,76439642,15594,THAP6,11,,76455236
6,74072399,1499,KHDC3L,11,,74073898
7,87257728,203885,RUNDC3B,11,,87461613
7,139025877,5188,C7orf55,11,,139031065
7,150147717,28766,GIMAP8,11,,150176483
8,8175257,64087,SGK223,11,,8239344
9,135600964,153234,AK8,11,,135754198
X,55511048,4583,USP51,11,,55515631
12,88536072,57592,TMTC3,11,,88593664
13,95254103,32796,GPR180,11,,95286899
15,43891760,19238,STRC,11,,43910998
17,40731525,29920,FAM134C,11,,40761445
17,47300731,7397,PHOSPHO1,11,,47308128
2,228736091,52968,DAW1,11,,228789059
2,109403205,89842,CCDC138,11,,109493047
2,26532811,9106,GPR113,11,,26541917
3,122296448,61446,PARP15,11,,122357894
3,128181274,4817,DNAJB8,11,,128186091
4,123653856,12242,BBS12,11,,123666098
5,56215428,32529,MIER3,11,,56247957
7,122337765,1443,RNF133,11,,122339208
18,19230857,53909,ABHD3,11,,19284766
12,57998404,5183,DTX3,11,,58003587
16,75145757,4913,LDHD,11,,75150670
1,95448278,90229,ALG14,11,,95538507
1,147574322,33770,NBPF11,11,,147608092
17,48188672,18574,SAMD14,11,,48207246
4,159587826,5376,C4orf46,11,,159593202
4,185570766,45347,PRIMPOL,11,,185616113
5,138745891,29323,DNAJC18,11,,138775214
9,117373705,34998,C9orf91,11,,117408703
9,130823511,6088,NAIF1,11,,130829599
X,118533257,55180,SLC25A43,11,,118588437
3,143692166,19044,C3orf58,11,,143711210
13,25735816,10605,AMER2,11,,25746421
10,23728197,3113,OTUD1,11,,23731310
10,31133564,187302,ZNF438,11,,31320866
10,18834135,106431,NSUN6,11,,18940566
6,121400639,255007,TBC1D32,11,,121655646
6,41034526,5827,OARD1,11,,41040353
6,34214156,2729,C6orf1,11,,34216885
6,31867393,2376,ZBTB12,11,,31869769
6,30614815,6172,C6orf136,11,,30620987
7,18066399,1087,PRPS1L1,11,,18067486
7,77325742,83378,RSBN1L,11,,77409120
7,98444110,23563,TMEM130,11,,98467673
12,100750856,64981,SLC17A8,11,,100815837
6,108616077,230910,LACE1,11,,108846987
7,102277194,34982,POLR2J2,11,,102312176
11,65343508,16608,EHBP1L1,11,,65360116
19,13009893,20193,SYCE2,11,,13030086
10,132890654,219330,TCERG1L,11,,133109984
7,142919171,972,TAS2R40,11,,142920143
12,11174217,1002,TAS2R19,11,,11175219
6,37600283,65483,MDGA1,11,,37665766
11,77300679,20722,AQP11,11,,77321401
10,112404154,195075,RBM20,11,,112599229
12,7507555,89226,CD163L1,11,,7596781
12,42475647,63026,GXYLT1,11,,42538673
15,63889551,5069,FBXL22,11,,63894620
17,57297827,55503,GDPD1,11,,57353330
19,42932689,14511,CXCL17,11,,42947200
1,38181645,49179,EPHA10,11,,38230824
22,30884897,16801,SEC14L4,11,,30901698
2,108443387,65613,RGPD4,11,,108509000
3,16298567,7929,DPH3,11,,16306496
9,126118445,22589,CRB2,11,,126141034
9,127704887,200951,SCAI,11,,127905838
3,121706169,34958,ILDR1,11,,121741127
2,48757063,246593,STON1-GTF2A1L,11,,49003656
7,143140545,957,TAS2R60,11,,143141502
11,417929,24082,ANO9,11,,442011
12,62102028,484592,FAM19A2,11,,62586620
6,149768765,37383,ZC3H12D,11,,149806148
1,211649863,16396,RD3,11,,211666259
2,71004441,13334,FIGLA,11,,71017775
2,176944834,3856,EVX2,11,,176948690
7,134916730,26514,STRA8,11,,134943244
X,47696300,85355,ZNF81,11,,47781655
11,67398773,8258,TBX10,11,,67407031
12,47470382,3352,AMIGO2,11,,47473734
16,20548082,39613,ACSM2B,11,,20587695
1,16384263,15864,FAM131C,11,,16400127
5,1225469,20835,SLC6A18,11,,1246304
11,67171383,6178,TBC1D10C,11,,67177561
15,91474147,1652,HDDC3,11,,91475799
18,76829274,309008,ATP9B,11,,77138282
19,36014268,4985,SBSN,11,,36019253
1,11751780,28556,DRAXIN,11,,11780336
5,175665361,107633,SIMC1,11,,175772994
7,103969103,579900,LHFPL3,11,,104549003
9,34521039,1998,ENHO,11,,34523037
11,15133969,134787,INSC,11,,15268756
17,4891424,9481,INCA1,11,,4900905
7,15239942,361698,AGMO,11,,15601640
7,100486343,996,UFSP1,11,,100487339
9,4662293,2979,PPAPDC2,11,,4665272
17,55938603,94081,CUEDC1,11,,56032684
5,147582356,12344,SPINK6,11,,147594700
5,139781398,147765,ANKHD1-EIF4EBP3,11,,139929163
20,61162118,102,MIR133A2,11,,61162220
16,56892429,84,MIR138-2,11,,56892513
14,101526091,84,MIR154,11,,101526175
1,110141514,75,MIR197,11,,110141589
X,133303700,96,MIR19B2,11,,133303796
5,168195150,110,MIR218-2,11,,168195260
3,188406568,86,MIR28,11,,188406654
9,111808508,70,MIR32,11,,111808578
19,4770681,110,MIR7-3,11,,4770791
19,52195864,70,MIR99B,11,,52195934
11,121986061,862,BLID,11,,121986923
11,9316638,19677,TMEM41B,11,,9336315
7,72039491,259322,TYW1B,11,,72298813
1,159283459,990,OR10J3,11,,159284449
19,46142251,94,MIR330,11,,46142345
14,101506026,66,MIR376C,11,,101506092
19,54290928,67,MIR371A,11,,54290995
X,73507120,72,MIR374A,11,,73507192
16,30210548,5102,SULT1A4,11,,30215650
14,101512256,75,MIR381,11,,101512331
8,14710946,73,MIR383,11,,14711019
10,135234169,3952,SPRN,11,,135238121
7,102178365,34703,POLR2J3,11,,102213068
22,45098077,160587,PRR5-ARHGAP8,11,,45258664
X,151128099,85,MIR452,11,,151128184
14,101531636,79,MIR409,11,,101531715
9,20716103,84,MIR491,11,,20716187
11,60970984,9357,PGA3,11,,60980341
2,131220388,46420,POTEI,11,,131266808
1,149784779,457,HIST2H3D,11,,149785236
16,29789560,3409,ZG16,11,,29792969
7,5920428,5566,OCM,11,,5925994
19,10216898,9166,PPAN-P2RY11,11,,10226064
1,155164967,96,MIR92B,11,,155165063
1,149813784,534,HIST2H2AA4,11,,149814318
X,153485202,13553,OPN1MW2,11,,153498755
X,140677834,1065,SPANXA2,11,,140678899
19,4502191,15525,PLIN4,11,,4517716
19,19292684,10716,MEF2BNB,11,,19303400
11,79113065,88,MIR708,11,,79113153
9,100069909,69668,CCDC180,11,,100139577
15,90373830,82392,C15orf38-AP3S2,11,,90456222
6,34254972,138930,RPS10-NUDT3,11,,34393902
20,62289162,40889,RTEL1-TNFRSF6B,11,,62330051
12,124457761,342809,ZNF664-FAM101A,11,,124800570
19,39736953,2543,IFNL4,11,,39739496
3,119298279,10513,ADPRH,10,,119308792
16,87921624,48488,CA5A,10,,87970112
X,150903217,10819,CNGA2,10,,150914036
11,63742078,1937,COX8A,10,,63744015
2,219854911,3216,CRYBA2,10,,219858127
4,156845269,29779,CTSO,10,,156875048
9,105757592,23178,CYLC2,10,,105780770
2,84743578,303135,DNAH6,10,,85046713
6,38683116,315458,DNAH8,10,,38998574
12,91357455,41348,EPYC,10,,91398803
9,95257593,40781,ECM2,10,,95298374
11,71846755,4181,FOLR3,10,,71850936
1,89472359,16190,GBP3,10,,89488549
13,27329338,5584,GPR12,10,,27334922
13,99906966,3716,GPR18,10,,99910682
12,12813994,35127,GPR19,10,,12849121
X,108616134,109151,GUCY2F,10,,108725285
12,4918341,41937,KCNA6,10,,4960278
17,39615764,7874,KRT32,10,,39623638
16,56685810,1306,MT1B,10,,56687116
1,160336860,5778,NHLH1,10,,160342638
9,95176526,10310,OMD,10,,95186836
17,3194928,948,OR3A1,10,,3195876
1,26286257,38391,PAFAH2,10,,26324648
7,99918262,15668,PMS2P1,10,,99933930
19,6375158,769,PSPN,10,,6375927
19,50084586,9679,PRRG2,10,,50094265
17,26975373,13817,SDF2,10,,26989190
12,132195631,88652,SFSWAP,10,,132284283
5,149569423,21212,SLC6A7,10,,149590635
2,234959345,26431,SPP2,10,,234985776
6,42712233,1651,TBCC,10,,42713884
1,23707401,43871,TCEA3,10,,23751272
5,137419580,7650,WNT8A,10,,137427230
7,6728063,18503,ZNF12,10,,6746566
16,71507975,15279,ZNF19,10,,71523254
X,47834249,29128,ZNF182,10,,47863377
19,53300660,24262,ZNF28,10,,53324922
19,21106058,27445,ZNF85,10,,21133503
19,44488321,14156,ZNF155,10,,44502477
6,28048481,8859,ZNF165,10,,28057340
6,28109687,17563,ZKSCAN8,10,,28127250
7,148936741,15959,ZNF212,10,,148952700
8,30601681,22839,UBXN8,10,,30624520
17,3029903,942,OR1G1,10,,3030845
10,75561668,9921,NDST2,10,,75571589
1,145524890,18978,ITGA10,10,,145543868
8,143738873,12539,JRK,10,,143751412
8,39442086,27008,ADAM18,10,,39469094
1,74663895,10491,FPGT,10,,74674386
12,48103517,15838,ENDOU,10,,48119355
4,77227178,5105,STBD1,10,,77232283
17,66263166,24239,SLC16A6,10,,66287405
17,73083821,18434,SLC16A5,10,,73102255
17,76164625,4384,SYNGR2,10,,76169009
15,55647420,53288,CCPG1,10,,55700708
17,56378587,27565,BZRAP1,10,,56406152
3,120627049,516559,STXBP5L,10,,121143608
1,175126122,36107,KIAA0040,10,,175162229
9,136397285,43356,ADAMTSL2,10,,136440641
20,1246934,43037,SNPH,10,,1289971
X,67867510,78174,STARD8,10,,67945684
14,70078309,103552,KIAA0247,10,,70181861
3,150126121,51784,TSC22D2,10,,150177905
11,8633583,46800,TRIM66,10,,8680383
X,19007424,133331,GPR64,10,,19140755
13,39917028,260328,LHFP,10,,40177356
11,118124130,11121,MPZL2,10,,118135251
13,31191829,41857,USPL1,10,,31233686
X,48205862,10326,SSX3,10,,48216188
11,67273960,1698,CDK2AP2,10,,67275658
1,111682004,45722,CEPT1,10,,111727726
11,57144241,4382,PRG3,10,,57148623
19,36036501,1928,TMEM147,10,,36038429
6,26538571,8593,HMGN4,10,,26547164
1,151104162,14978,SEMA6C,10,,151119140
7,64363619,28336,ZNF273,10,,64391955
9,111616868,1407,ACTL7B,10,,111618275
19,1597153,8330,UQCR11,10,,1605483
4,39460643,18628,LIAS,10,,39479271
1,151745954,17056,TDRKH,10,,151763010
21,44949071,130303,HSF2BP,10,,45079374
9,136325086,10823,CACFD1,10,,136335909
22,51205919,16168,RABL2B,10,,51222087
7,107663995,106806,LAMB4,10,,107770801
12,57647546,177242,R3HDM2,10,,57824788
17,66287635,129365,ARSG,10,,66417000
15,42066631,53422,MAPKBP1,10,,42120053
4,25749048,115605,SEL1L3,10,,25864653
18,54318615,378421,WDR7,10,,54697036
1,15853307,44921,DNAJC16,10,,15898228
15,79603403,11786,TMED3,10,,79615189
1,89990396,73024,LRRC8B,10,,90063420
12,48866447,396,ANP32D,10,,48866843
22,38474143,5027,SLC16A8,10,,38479170
2,113931559,29118,PSD4,10,,113960677
1,159842153,27753,CFAP45,10,,159869906
22,38615297,53373,TMEM184B,10,,38668670
11,34172533,207022,ABTB2,10,,34379555
5,140810157,82389,PCDHGA12,10,,140892546
2,152657479,27530,ARL5A,10,,152685009
6,3849599,1955,FAM50B,10,,3851554
X,103810995,1200827,IL1RAPL2,10,,105011822
1,159409511,1089,OR10J1,10,,159410600
6,29424931,7168,OR2H1,10,,29432099
8,145106166,9440,OPLAH,10,,145115606
4,4387982,32803,NSG1,10,,4420785
13,97637972,8758,OXGR1,10,,97646730
1,36549675,4201,TEKT2,10,,36553876
8,24241797,21729,ADAMDEC1,10,,24263526
18,64168423,102952,CDH19,10,,64271375
19,13885256,4330,C19orf53,10,,13889586
4,69313166,50156,TMPRSS11E,10,,69363322
1,151142462,6085,TMOD4,10,,151148547
13,37523907,49597,ALG5,10,,37573504
16,30386097,3215,MYLPF,10,,30389312
12,104458235,42069,HCFC2,10,,104500304
19,48111452,95082,GLTSCR1,10,,48206534
11,10533224,29550,RNF141,10,,10562774
3,100941389,98030,IMPG2,10,,101039419
20,57608199,9702,SLMO2,10,,57617901
5,128430441,19278,ISOC1,10,,128449719
1,244816349,55987,DESI2,10,,244872336
2,238475216,602,PRLH,10,,238475818
8,79578281,53716,ZC2HC1A,10,,79631997
5,179264265,21575,C5orf45,10,,179285840
17,46103532,11636,COPZ2,10,,46115168
11,787109,3017,CEND1,10,,790126
15,42140343,45932,SPTBN5,10,,42186275
5,119799972,223053,PRR16,10,,120023025
12,9980076,17527,KLRF1,10,,9997603
3,48481647,3969,TMA7,10,,48485616
12,53551446,23247,CSAD,10,,53574693
X,6451658,1501,VCX3A,10,,6453159
15,44719578,99851,CTDSPL2,10,,44819429
6,139456248,45698,HECA,10,,139501946
16,19179534,100122,SYT17,10,,19279656
6,99817347,24735,COQ3,10,,99842082
X,72782983,123954,CHIC1,10,,72906937
10,43867091,4692,FXYD4,10,,43871783
4,184239219,2708,CLDN22,10,,184241927
21,19161283,30420,C21orf91,10,,19191703
1,155112366,517,DPM3,10,,155112883
22,50528434,71682,MOV10L1,10,,50600116
7,7606615,40495,MIOS,10,,7647110
17,6347734,6651,FAM64A,10,,6354385
7,150929574,6339,CHPF2,10,,150935913
4,40425271,206612,RBM47,10,,40631883
3,122130699,4183,WDR5B,10,,122134882
10,134621895,134194,CFAP46,10,,134756089
11,114441312,25172,NXPE4,10,,114466484
3,113251217,97205,SIDT1,10,,113348422
5,140044383,6170,WDR55,10,,140050553
X,69642880,10361,GDPD2,10,,69653241
15,31231143,52664,MTMR10,10,,31283807
21,34860361,3669,DNAJC28,10,,34864030
15,65550431,28750,PARP16,10,,65579181
15,85144248,15593,ZSCAN2,10,,85159841
13,114145307,59237,TMCO3,10,,114204544
14,90744397,54084,NRDE2,10,,90798481
1,26648349,32272,AIM1L,10,,26680621
1,245318286,548142,KIF26B,10,,245866428
14,96745538,84200,ATG2B,10,,96829738
1,17907047,117323,ARHGEF10L,10,,18024370
17,57287370,5241,SMG8,10,,57292611
15,41060066,39610,DNAJC17,10,,41099676
12,32112352,33691,KIAA1551,10,,32146043
11,111944967,10907,C11orf57,10,,111955874
1,65210777,88137,RAVER2,10,,65298914
13,48611702,9662,NUDT15,10,,48621364
15,56720928,36407,MNS1,10,,56757335
9,107526021,14024,NIPSNAP3B,10,,107540045
2,37458773,17530,NDUFAF7,10,,37476303
1,212859758,13569,BATF3,10,,212873327
5,114506798,9445,TRIM36,10,,114516243
16,20944432,226330,DNAH3,10,,21170762
2,216807313,71033,MREG,10,,216878346
13,111267930,24412,CARKD,10,,111292342
7,43678845,90295,COA1,10,,43769140
11,43380434,136049,TTC17,10,,43516483
1,200863948,20916,C1orf106,10,,200884864
1,155108287,3047,SLC50A1,10,,155111334
9,96713908,3700,BARX1,10,,96717608
5,140566700,4411,PCDHB9,10,,140571111
5,140557370,2711,PCDHB8,10,,140560081
5,140552201,3756,PCDHB7,10,,140555957
5,140345746,46183,PCDHAC2,10,,140391929
5,140220906,171023,PCDHA8,10,,140391929
5,140213968,177961,PCDHA7,10,,140391929
2,196602426,331110,DNAH7,10,,196933536
20,2774714,6578,CPXM1,10,,2781292
19,48532639,14672,CABP5,10,,48547311
10,69556426,41511,DNAJC12,10,,69597937
2,47747914,49556,KCNK12,10,,47797470
11,9002122,23474,NRIP3,10,,9025596
1,159796478,10804,SLAMF8,10,,159807282
16,81009698,30804,CMC2,10,,81040502
7,96745904,65171,ACN9,10,,96811075
19,55996556,2379,NAT14,10,,55998935
2,241508003,10146,RNPEPL1,10,,241518149
9,131843382,9335,DOLPP1,10,,131852717
12,51639132,25070,SMAGP,10,,51664202
19,50030874,16016,RCN3,10,,50046890
5,178029664,24390,CLK4,10,,178054054
19,50094899,34797,PRR12,10,,50129696
3,124684553,90249,HEG1,10,,124774802
12,8852380,77407,RIMKLB,10,,8929787
2,197063974,393361,HECW2,10,,197457335
14,52897307,121994,TXNDC16,10,,53019301
3,159974773,142547,IFT80,10,,160117320
14,61438166,9631,TRMT5,10,,61447797
9,5629118,140336,RIC1,10,,5769454
4,159690146,139056,FNIP2,10,,159829202
10,30301728,46760,KIAA1462,10,,30348488
16,77822460,191544,VAT1L,10,,78014004
6,36708554,98666,CPNE5,10,,36807220
4,119606524,26901,METTL14,10,,119633425
1,177140523,111035,BRINP2,10,,177251558
4,83351632,30696,ENOPH1,10,,83382328
11,10874250,5370,ZBED5,10,,10879620
2,202509596,53821,MPP4,10,,202563417
16,420775,11175,TMEM8A,10,,431950
19,50243010,23505,TSKS,10,,50266515
6,126307575,52845,TRMT11,10,,126360420
11,82970134,27316,CCDC90B,10,,82997450
4,44680432,22265,GUF1,10,,44702697
20,43374487,6467,KCNK15,10,,43380954
1,12079298,12808,MIIP,10,,12092106
10,120068571,33268,FAM204A,10,,120101839
2,193614570,27055,PCGEM1,10,,193641625
10,72014712,28738,NPFFR1,10,,72043450
7,25264190,3915,NPVF,10,,25268105
7,35672269,62503,HERPUD2,10,,35734772
X,140785557,1339,SPANXD,10,,140786896
3,158519714,27794,MFSD1,10,,158547508
16,31500795,18945,C16orf58,10,,31519740
19,42580289,5431,ZNF574,10,,42585720
17,77071018,13667,ENGASE,10,,77084685
20,2815960,5929,PCED1A,10,,2821889
7,100956647,8457,IFT22,10,,100965104
17,48624449,8764,SPATA20,10,,48633213
15,99676527,113297,TTC23,10,,99789824
11,86748885,290991,TMEM135,10,,87039876
18,11883471,25325,MPPE1,10,,11908796
8,146277823,3593,C8orf33,10,,146281416
5,863849,28825,BRD9,10,,892674
19,58595208,34585,ZSCAN18,10,,58629793
6,43418089,6281,DLK2,10,,43424370
16,30662187,5574,PRR14,10,,30667761
13,103436630,14774,KDELC1,10,,103451404
1,207191865,14236,C1orf116,10,,207206101
11,119205209,2815,RNF26,10,,119208024
16,67562719,17972,FAM65A,10,,67580691
16,75572014,18170,TMEM231,10,,75590184
13,111293756,64771,CARS2,10,,111358527
1,151129104,3121,TNFAIP8L2,10,,151132225
15,82422560,132544,EFTUD1,10,,82555104
1,39456915,14822,AKIRIN1,10,,39471737
1,49193194,49447,BEND5,10,,49242641
2,170385017,45414,FASTKD1,10,,170430431
1,38268613,5252,YRDC,10,,38273865
7,102036803,30326,PRKRIP1,10,,102067129
11,96085928,37155,CCDC82,10,,96123083
2,237232789,183389,IQCA1,10,,237416178
1,35525386,56073,ZMYM1,10,,35581459
11,32914723,87091,QSER1,10,,33001814
18,66382490,339936,CCDC102B,10,,66722426
10,104221169,15633,TMEM180,10,,104236802
10,25305507,10086,THNSL1,10,,25315593
20,24449834,197419,SYNDIG1,10,,24647253
8,25042237,230995,DOCK5,10,,25273232
10,124690418,23501,C10orf88,10,,124713919
2,220117964,18946,TUBA4B,10,,220136910
3,160394947,1288,ARL14,10,,160396235
9,35104117,11791,FAM214B,10,,35115908
15,65134081,26120,PLEKHO2,10,,65160201
6,28092333,5531,ZSCAN16,10,,28097864
6,30524485,7988,PRR3,10,,30532473
11,62414319,6455,INTS5,10,,62420774
18,31158540,172618,ASXL3,10,,31331158
7,36192835,148317,EEPD1,10,,36341152
22,36585175,15704,APOL4,10,,36600879
6,32116139,3581,PRRT1,10,,32119720
1,182758583,40936,NPL,10,,182799519
17,61600694,23395,KCNH6,10,,61624089
12,51454987,22467,CSRNP2,10,,51477454
19,6135643,57471,ACSBG2,10,,6193114
6,29341199,1869,OR12D3,10,,29343068
19,1876974,8544,ABHD17A,10,,1885518
20,60963685,18654,CABLES2,10,,60982339
17,40086875,30793,TTC25,10,,40117668
14,74111577,58854,DNAL1,10,,74170431
19,12936290,4940,RTBDN,10,,12941230
X,136112306,1527,GPR101,10,,136113833
22,24936390,15513,GUCD1,10,,24951903
12,7276276,5211,RBP5,10,,7281487
14,62462540,105887,SYT16,10,,62568427
13,50018428,50711,SETDB2,10,,50069139
5,10441973,23165,ROPN1L,10,,10465138
19,17360848,14696,USHBP1,10,,17375544
5,112768250,2478,TSSK1B,10,,112770728
19,19625027,1442,TSSK6,10,,19626469
11,117771355,28813,TMPRSS13,10,,117800168
3,182971031,20148,B3GNT5,10,,182991179
4,164392246,2801,TKTL2,10,,164395047
3,14716605,97938,C3orf20,10,,14814543
15,64364757,21450,FAM96A,10,,64386207
3,197615945,60851,IQCG,10,,197676796
12,120941081,25883,COQ5,10,,120966964
2,191045588,22622,C2orf88,10,,191068210
16,55600583,1009,CAPNS2,10,,55601592
1,9986355,17130,LZIC,10,,10003485
1,233463513,57381,KIAA1804,10,,233520894
X,101137259,49780,ZMAT1,10,,101187039
3,9932270,3761,JAGN1,10,,9936031
15,36871803,230658,C15orf41,10,,37102461
12,119419299,181557,SRRM4,10,,119600856
3,67048726,12906,KBTBD8,10,,67061632
1,40124792,12918,NT5C1A,10,,40137710
X,78426468,1258,GPR174,10,,78427726
19,14729928,55802,EMR3,10,,14785730
12,123259055,52872,CCDC62,10,,123311927
9,34379016,2582,C9orf24,10,,34381598
17,3343305,31837,SPATA22,10,,3375142
4,140187316,14176,MGARP,10,,140201492
6,107018645,58728,RTN4IP1,10,,107077373
1,230972864,32471,C1orf198,10,,231005335
X,70145429,5546,SLC7A3,10,,70150975
10,64564515,3724,ADO,10,,64568239
3,43120720,26855,POMGNT2,10,,43147575
9,35659340,5938,ARHGEF39,10,,35665278
2,85980908,37598,ATOH8,10,,86018506
19,36936020,44443,ZNF566,10,,36980463
15,85184725,12849,WDR73,10,,85197574
17,37408896,149013,FBXL20,10,,37557909
5,177635474,24349,PHYKPL,10,,177659823
12,42705887,14045,ZCRB1,10,,42719932
3,36753912,27440,DCLK3,10,,36781352
19,56687388,9756,GALP,10,,56697144
21,43892596,23868,RSPH1,10,,43916464
11,72525450,15230,ATG16L2,10,,72540680
3,119421868,64081,MAATS1,10,,119485949
9,139956578,8450,SAPCD2,10,,139965028
X,54466852,4879,TSR2,10,,54471731
20,39988605,6893,EMILIN3,10,,39995498
20,44462469,9445,SNX21,10,,44471914
1,6685209,8433,THAP3,10,,6693642
19,45715878,21591,EXOC3L2,10,,45737469
7,1004485,10750,COX19,10,,1015235
4,24807738,106862,CCDC149,10,,24914600
2,179966418,162932,SESTD1,10,,180129350
X,152853382,11250,FAM58A,10,,152864632
9,37887593,16757,SLC25A51,10,,37904350
18,65173818,10149,DSEL,10,,65183967
16,89787951,19381,ZNF276,10,,89807332
2,198570027,3087,MARS2,10,,198573114
12,58148880,5313,9-Mar,10,,58154193
13,103418237,7934,TEX30,10,,103426171
16,84254740,18616,KCNG4,10,,84273356
7,101256604,15972,MYL10,10,,101272576
7,129984629,23940,CPA5,10,,130008569
3,183977002,2249,CAMK2N2,10,,183979251
6,159071045,114863,SYTL3,10,,159185908
3,32433162,63174,CMTM7,10,,32496336
19,10420886,5805,FDX1L,10,,10426691
11,134094498,23188,VPS26B,10,,134117686
12,113860194,15887,SDSL,10,,113876081
3,126325894,48073,TXNRD3,10,,126373967
6,97372495,216135,KLHL32,10,,97588630
16,1399240,2633,TSR3,10,,1401873
5,89811444,13957,LYSMD3,10,,89825401
21,27838527,107196,CYYR1,10,,27945723
2,133400852,28300,LYPD1,10,,133429152
4,10491837,194549,CLNK,10,,10686386
11,68771861,8989,MRGPRF,10,,68780850
3,150804584,349881,MED12L,10,,151154465
1,1227763,15506,ACAP3,10,,1243269
15,43922759,18284,CATSPER2,10,,43941043
10,124030810,66885,BTBD16,10,,124097695
10,76993728,2042,COMTD1,10,,76995770
10,90579658,32074,ANKRD22,10,,90611732
11,92085261,544374,FAT3,10,,92629635
11,129685675,43731,TMEM45B,10,,129729406
12,15066960,24523,ERP27,10,,15091483
12,101188373,334046,ANO4,10,,101522419
13,37677396,2405,CSNK1A1L,10,,37679801
14,63779548,6045,GPHB5,10,,63785593
15,65293849,28128,MTFMT,10,,65321977
16,19727777,142012,IQCK,10,,19869789
16,50700210,15054,SNX20,10,,50715264
17,27920526,21253,ANKRD13B,10,,27941779
17,18855477,68527,SLC5A10,10,,18924004
1,1243959,3098,PUSL1,10,,1247057
1,100614003,29826,LRRC39,10,,100643829
1,161691333,6600,FCRLB,10,,161697933
2,124782863,890091,CNTNAP5,10,,125672954
2,79252811,2819,REG3G,10,,79255630
2,27600097,3214,ZNF513,10,,27603311
3,58619669,32892,FAM3D,10,,58652561
3,32859509,79809,TRIM71,10,,32939318
4,113066552,43685,C4orf32,10,,113110237
4,103946647,51283,SLC9B2,10,,103997930
5,10225619,24402,FAM173B,10,,10250021
5,148724976,9170,GRPEL2,10,,148734146
5,80625946,64042,ACOT12,10,,80689988
6,89805677,22123,SRSF12,10,,89827800
7,72726531,15554,TRIM50,10,,72742085
8,35092974,561094,UNC5D,10,,35654068
9,138898382,88749,NACC2,10,,138987131
9,32629451,6216,TAF1L,10,,32635667
9,34610481,1629,RPP25L,10,,34612110
X,105412297,40652,MUM1L1,10,,105452949
X,84258897,89426,APOOL,10,,84348323
X,44382884,19337,FUNDC1,10,,44402221
17,18218593,12777,SMCR8,10,,18231370
20,25593572,11076,NANP,10,,25604648
2,183943286,21436,DUSP19,10,,183964722
11,18627947,28073,SPTY2D1,10,,18656020
14,24683142,2134,MDP1,10,,24685276
14,42076058,297694,LRFN5,10,,42373752
15,57884101,125654,GCOM1,10,,58009755
16,742499,13326,FBXL16,10,,755825
18,70203914,7809,CBLN2,10,,70211723
19,52800421,28759,ZNF480,10,,52829180
19,22573898,31250,ZNF98,10,,22605148
19,1782073,30163,ATP8B3,10,,1812236
19,2841432,19040,ZNF555,10,,2860472
1,3668964,19245,CCDC27,10,,3688209
1,224804178,124071,CNIH3,10,,224928249
22,21982377,1963,YDJC,10,,21984340
22,31057444,6433,DUSP18,10,,31063877
22,42776413,51988,NFAM1,10,,42828401
2,113493926,28328,CKAP2L,10,,113522254
2,203499900,134580,FAM117B,10,,203634480
2,208576263,44633,CCNYL1,10,,208620896
3,68780914,200847,FAM19A4,10,,68981761
4,8442531,35751,TRMT44,10,,8478282
5,150694538,32613,SLC36A2,10,,150727151
5,158584416,52645,RNF145,10,,158637061
6,7590431,21769,SNRNP48,10,,7612200
7,149169883,25015,ZNF746,10,,149194898
8,96257140,24322,C8orf37,10,,96281462
8,62200524,213680,CLVS1,10,,62414204
9,100362361,33601,TSTD2,10,,100395962
X,74588261,155076,ZDHHC15,10,,74743337
11,18477373,23774,LDHAL6A,10,,18501147
17,43922255,2183,SPPL2C,10,,43924438
19,35615416,10762,LGI4,10,,35626178
20,6021191,13535,LRRN4,10,,6034726
7,151653463,63556,GALNTL5,10,,151717019
8,6863802,2544,DEFT1P,10,,6866346
12,124247041,173226,DNAH10,10,,124420267
10,135192740,12460,PAOX,10,,135205200
16,3589035,38370,NLRC3,10,,3627405
3,170582664,5381,RPL22L1,10,,170588045
17,16245847,10965,CENPV,10,,16256812
3,123210394,93638,PTPLB,10,,123304032
8,22004342,10002,LGI3,10,,22014344
9,101494290,64534,ANKS6,10,,101558824
3,196594726,66858,SENP5,10,,196661584
Y,2087554,281461,DHRSX,10,,2369015
10,81142082,63301,ZCCHC24,10,,81205383
10,71390002,3353,C10orf35,10,,71393355
10,38238499,27084,ZNF25,10,,38265583
11,133710516,4917,SPATA19,10,,133715433
11,61116219,8142,CYB561A3,10,,61124361
18,67068283,448039,DOK6,10,,67516322
10,61005888,116464,FAM13C,10,,61122352
10,43689980,35207,RASGEF1A,10,,43725187
10,18240767,91454,SLC39A12,10,,18332221
16,55880065,29217,CES5A,10,,55909282
6,43612766,25982,RSPH9,10,,43638748
6,17282294,11805,RBM24,10,,17294099
7,99767228,7821,GPC2,10,,99775049
16,57702156,21134,GPR97,10,,57723290
6,118228688,410151,SLC35F1,10,,118638839
6,54711568,98329,FAM83B,10,,54809897
6,28227074,1662,NKAPL,10,,28228736
7,30323922,83386,ZNRF2,10,,30407308
8,7679487,1925,DEFB105A,10,,7681412
Y,21729243,39813,TXLNGY,10,,21769056
2,172864803,82354,METAP1D,10,,172947157
7,138916230,76752,UBN2,10,,138992982
15,42433331,15508,PLA2G4F,10,,42448839
1,210111518,226115,SYT14,10,,210337633
9,85857904,295444,FRMD3,10,,86153348
11,117103451,52953,RNF214,10,,117156404
12,11213963,930,TAS2R46,10,,11214893
1,45249256,4170,BEST4,10,,45253426
10,50723150,9177,PGBD3,10,,50732327
11,64107689,17317,CCDC88B,10,,64125006
11,63678692,5624,RCOR2,10,,63684316
12,53574534,10120,ZNF740,10,,53584654
12,569542,101516,B4GALNT3,10,,671058
15,42359880,26872,PLA2G4D,10,,42386752
19,44300078,6535,LYPD5,10,,44306613
19,50979733,7050,EMC10,10,,50986783
19,51505768,7122,KLK9,10,,51512890
1,110009099,15665,SYPL2,10,,110024764
3,69024362,38683,EOGT,10,,69063045
4,1065265,42087,RNF212,10,,1107352
5,118171768,152532,DTWD2,10,,118324300
8,95732102,73974,DPY19L4,10,,95806076
3,140396865,23127,TRIM42,10,,140419992
1,55074849,14351,FAM151A,10,,55089200
11,24518515,585671,LUZP2,10,,25104186
3,180331795,65488,CCDC39,10,,180397283
4,2061238,9578,NAT8L,10,,2070816
6,74062784,1215,DPPA5,10,,74063999
7,63985033,38472,ZNF680,10,,64023505
7,128784711,24824,TSPAN33,10,,128809535
9,19408924,43576,ACER2,10,,19452500
10,120789227,4017,NANOS1,10,,120793244
16,71963440,70437,PKD1L3,10,,72033877
17,72606021,13876,CD300E,10,,72619897
4,88224940,19118,HSD17B13,10,,88244058
9,103340360,10309,MURC,10,,103350669
5,134303595,43802,CATSPER3,10,,134347397
5,101569691,62562,SLCO4C1,10,,101632253
12,7864049,6103,DPPA3,10,,7870152
22,21827286,44494,PI4KAP2,10,,21871780
5,65892175,573248,MAST4,10,,66465423
14,101346991,4193,RTL1,10,,101351184
19,33166312,2894,RGS9BP,10,,33169206
1,110693131,51692,SLC6A17,10,,110744823
3,156544095,219823,LEKR1,10,,156763918
15,68112041,14133,SKOR1,10,,68126174
X,53584152,83,MIRLET7F2,10,,53584235
5,167987900,78,MIR103A1,10,,167987978
2,220158832,90,MIR153-1,10,,220158922
18,33484780,109,MIR187,10,,33484889
15,63116155,85,MIR190A,10,,63116240
2,56216084,110,MIR216A,10,,56216194
1,207975787,81,MIR29B2,10,,207975868
15,89155055,110,MIR7-2,10,,89155165
3,68040733,554038,FAM19A1,10,,68594771
2,234651395,1266,DNAJB3,10,,234652661
X,8432870,1681,VCX3B,10,,8434551
13,73282494,19444,MZT1,10,,73301938
15,54304844,615962,UNC13C,10,,54920806
19,4522543,12665,PLIN5,10,,4535208
1,247835419,924,OR13G1,10,,247836343
12,95702195,94,MIR331,10,,95702289
X,57146114,1865,SPIN2B,10,,57147979
12,104697509,1473,EID3,10,,104698982
5,54455945,7184,GPX8,10,,54463129
8,7693992,4772,DEFB104B,10,,7698764
12,92817734,7044,CLLU1,10,,92824778
X,133304070,71,MIR18B,10,,133304141
14,101348222,93,MIR433,10,,101348315
14,101493121,80,MIR329-1,10,,101493201
14,101532248,80,MIR410,10,,101532328
7,136587913,128,MIR490,10,,136588041
10,135061014,110,MIR202,10,,135061124
14,101500091,82,MIR495,10,,101500173
14,74003927,6571,ACOT1,10,,74010498
5,180274610,13676,ZFP62,10,,180288286
7,29846169,110513,WIPF3,10,,29956682
1,33004745,66806,ZBTB8A,10,,33071551
19,43979254,29731,PHLDB3,10,,44008985
22,24299600,3768,GSTT2B,10,,24303368
16,30204250,1377,BOLA2B,10,,30205627
X,133675370,97,MIR542,10,,133675467
X,51927918,7448,MAGED4,10,,51935366
X,101615315,79614,NXF2B,10,,101694929
5,21459588,129893,GUSBP1,10,,21589481
1,206138454,16697,FAM72A,10,,206155151
4,37592421,95578,RELL1,10,,37687999
11,62439125,2037,UQCC3,10,,62441162
X,100743030,7768,ARMCX4,10,,100750798
17,73975297,21370,TEN1,10,,73996667
15,57884101,93461,MYZAP,10,,57977562
8,128092118,12722,PRNCR1,10,,128104840
3,159631189,293690,IL12A-AS1,10,,159924879
16,90038987,24041,AFG3L1P,9,,90063028
17,48541852,4375,CHAD,9,,48546227
12,12764766,33276,CREBL2,9,,12798042
17,61986956,1732,CSHL1,9,,61988688
22,42536213,4363,CYP2D7,9,,42540576
1,3404505,123554,MEGF6,9,,3528059
19,36132638,3135,ETV2,9,,36135773
7,27282163,5275,EVX1,9,,27287438
5,150883652,64853,FAT2,9,,150948505
X,49216647,77951,GAGE2C,9,,49294598
9,124217318,44988,GGTA1P,9,,124262306
6,110299458,2465,GPR6,9,,110301923
13,51568646,71647,GUCY1B2,9,,51640293
6,32520489,7290,HLA-DRB6,9,,32527779
1,117117019,93358,IGSF3,9,,117210377
2,48541794,64640,FOXN2,9,,48606434
1,111059838,1959,KCNA10,9,,111061797
12,75433857,169671,KCNC2,9,,75603528
11,71259465,1188,KRTAP5-9,9,,71260653
17,39502344,4720,KRT33A,9,,39507064
19,33685598,14175,LRP3,9,,33699773
13,36047925,2907,MAB21L1,9,,36050832
X,149009940,4669,MAGEA8,9,,149014609
X,30260056,2252,MAGEB4,9,,30262308
19,46436991,39666,NOVA2,9,,46476657
16,2521499,2647,NTN3,9,,2524146
2,36923832,118105,VIT,9,,37041937
2,88047609,11385,PLGLB1,9,,88058994
2,105470525,4506,POU3F3,9,,105475031
X,17755568,17540,SCML1,9,,17773108
10,114043413,21379,TECTB,9,,114064792
6,31976196,4604,TNXA,9,,31980800
X,2670092,64449,XG,9,,2734541
17,11880755,19934,ZNF18,9,,11900689
19,12242167,9055,ZNF20,9,,12251222
12,133562933,26221,ZNF26,9,,133589154
1,33938231,23764,ZSCAN20,9,,33961995
10,44139306,4941,ZNF32,9,,44144247
10,38383263,29015,ZNF37A,9,,38412278
X,134419718,10247,ZNF75D,9,,134429965
19,44978644,25931,ZNF180,9,,45004575
6,28193028,8236,ZSCAN9,9,,28201264
16,3185133,7672,ZNF213,9,,3192805
19,44669316,12522,ZNF226,9,,44681838
19,44716680,24741,ZNF227,9,,44741421
19,44930422,22344,ZNF229,9,,44952766
17,5009028,6541,ZNF232,9,,5015569
18,74536115,146567,ZNF236,9,,74682682
2,27477439,8521,SLC30A3,9,,27485960
5,137450860,24272,NME5,9,,137475132
17,3336163,972,OR1E2,9,,3337135
17,3323861,966,OR3A3,9,,3324827
4,2627158,107144,FAM193A,9,,2734302
17,39592620,4976,KRT38,9,,39597596
5,53751430,784,HSPB3,9,,53752214
6,132909730,1147,TAAR5,9,,132910877
Y,27177049,21202,BPY2,9,,27198251
6,85442215,31739,TBX18,9,,85473954
8,17154305,116735,MTMR7,9,,17271040
16,2039945,4331,SYNGR3,9,,2044276
17,7825176,7577,KCNAB3,9,,7832753
1,202092028,6606,GPR37L1,9,,202098634
6,132938288,7126,TAAR2,9,,132945414
6,132929363,1078,TAAR3,9,,132930441
18,55102916,55614,ONECUT2,9,,55158530
10,126307862,125068,FAM53B,9,,126432930
8,145743348,7211,LRRC14,9,,145750559
10,46993545,7023,GPRIN2,9,,47000568
15,49280834,57926,SECISBP2L,9,,49338760
12,7282966,28564,CLSTN3,9,,7311530
20,3143262,10976,LZTS3,9,,3154238
8,22077215,12636,PHYHIP,9,,22089851
3,10290176,32730,TATDN2,9,,10322906
5,141303384,18228,KIAA0141,9,,141321612
4,170907747,17196,MFAP3L,9,,170924943
17,6481644,62603,KIAA0753,9,,6544247
11,118978059,9775,C2CD2L,9,,118987834
17,44372496,42664,LRRC37A,9,,44415160
1,99729847,45291,LPPR4,9,,99775138
11,89867817,57962,NAALAD2,9,,89925779
16,3333486,7973,ZNF263,9,,3341459
3,48333806,9095,NME6,9,,48342901
16,54965110,3285,IRX5,9,,54968395
15,66782085,8068,SNAPC5,9,,66790153
14,24659243,5699,TM9SF1,9,,24664942
22,29708921,2824,RASL10A,9,,29711745
2,27323461,18312,CGREF1,9,,27341773
3,47603727,18003,CSPG5,9,,47621730
12,58191159,18693,AVIL,9,,58209852
20,61472365,20750,TCFL5,9,,61493115
11,94110476,24109,GPR83,9,,94134585
17,42385926,10112,RUNDC3A,9,,42396038
22,38864066,15386,KDELR3,9,,38879452
3,50392179,4760,TMEM115,9,,50396939
6,44126547,25592,CAPN11,9,,44152139
3,108015336,81795,HHLA2,9,,108097131
12,108909050,4330,FICD,9,,108913380
5,175953699,10722,RNF44,9,,175964421
1,155882833,21400,KIAA0907,9,,155904233
10,106400858,624142,SORCS3,9,,107025000
19,18208602,53897,MAST3,9,,18262499
7,32535037,93316,AVL9,9,,32628353
3,182895791,250266,MCF2L2,9,,183146057
17,4871286,19674,CAMTA2,9,,4890960
11,64662003,22719,ATG2A,9,,64684722
6,116571130,4131,TSPYL4,9,,116575261
3,184529930,240472,VPS8,9,,184770402
15,29412454,450473,FAM189A1,9,,29862927
17,7146905,8090,CTDNEP1,9,,7154995
6,39760158,112495,DAAM2,9,,39872653
17,53469973,29368,MMD,9,,53499341
16,75630776,26445,ADAT1,9,,75657221
5,40711677,44395,TTC33,9,,40756072
11,65339819,1850,FAM89B,9,,65341669
11,33563876,131770,KIAA1549L,9,,33695646
2,71127719,32856,VAX2,9,,71160575
4,139936912,30181,CCRN4L,9,,139967093
3,52009041,6175,ABHD14A,9,,52015216
X,3226605,38079,MXRA5,9,,3264684
11,74407472,34958,CHRDL2,9,,74442430
12,58166382,9942,METTL21B,9,,58176324
14,31760993,128795,HEATR5A,9,,31889788
2,99225010,9967,UNC50,9,,99234977
6,132617193,105480,MOXD1,9,,132722673
13,88324869,7001,SLITRK5,9,,88331870
20,20037289,115688,CFAP61,9,,20152977
1,16693524,31119,SZRD1,9,,16724643
15,55831084,49966,PYGO1,9,,55881050
7,150382793,7935,GIMAP2,9,,150390728
9,65503365,6245,SPATA31A7,9,,65509610
8,100973165,145179,RGS22,9,,101118344
7,143657019,1089,OR2F1,9,,143658108
14,37049215,2604,NKX2-8,9,,37051819
7,100187195,11545,FBXO24,9,,100198740
11,17809595,225114,SERGEF,9,,18034709
10,101088855,65232,CNNM1,9,,101154087
6,29364415,1033,OR12D2,9,,29365448
X,153046455,4732,SRPK3,9,,153051187
19,14937138,2138,OR7A5,9,,14939276
6,29011989,963,OR2W1,9,,29012952
6,29141310,1041,OR2J2,9,,29142351
22,31518908,11775,INPP5J,9,,31530683
4,128554086,83848,INTU,9,,128637934
22,23401592,82649,RSPH14,9,,23484241
4,8582216,9534,GPR78,9,,8591750
11,3819048,28553,PGAP2,9,,3847601
20,30063090,9618,REM1,9,,30072708
16,11022747,13510,DEXI,9,,11036257
7,150488375,9246,TMEM176B,9,,150497621
6,52535883,15502,TMEM14A,9,,52551385
2,170668266,13175,METTL5,9,,170681441
18,71815745,10459,TIMM21,9,,71826204
12,56211805,3154,ORMDL2,9,,56214959
21,30248385,9310,N6AMT1,9,,30257695
22,22051825,38298,YPEL1,9,,22090123
16,67428321,22018,ZDHHC1,9,,67450339
11,64808375,3925,SAC3D1,9,,64812300
19,56158953,5573,CCDC106,9,,56164526
17,46184946,15159,SNX11,9,,46200105
18,21083433,28338,C18orf8,9,,21111771
6,41748499,6611,PRICKLE4,9,,41755110
9,136080665,3972,OBP2B,9,,136084637
9,138437984,3831,OBP2A,9,,138441815
16,2570362,10593,AMDHD2,9,,2580955
1,43312243,5903,ZNF691,9,,43318146
14,75179849,23541,FCF1,9,,75203390
16,57290008,28576,PLLP,9,,57318584
20,42219252,56684,IFT52,9,,42275936
8,71549500,31947,LACTB2,9,,71581447
3,149456256,14030,COMMD2,9,,149470286
18,44558942,3046,TCEB3B,9,,44561988
14,70791797,34651,COX16,9,,70826448
6,46517316,103251,CYP39A1,9,,46620567
12,49315741,2923,FKBP11,9,,49318664
4,159045731,48471,FAM198B,9,,159094202
7,64126460,45500,ZNF107,9,,64171960
5,173472606,63576,HMP19,9,,173536182
19,35634153,11052,FXYD7,9,,35645205
12,54756228,2042,GPR84,9,,54758270
21,47720343,20396,C21orf58,9,,47740739
X,128913891,15285,SASH3,9,,128929176
X,100870107,2884,ARMCX6,9,,100872991
15,23888695,4298,MAGEL2,9,,23892993
15,85174690,11004,SCAND2P,9,,85185694
1,1288068,10853,MXRA8,9,,1298921
7,110731061,34448,LRRN3,9,,110765509
11,111338255,44824,BTG4,9,,111383079
9,116111811,21702,BSPRY,9,,116133513
13,103451398,42490,BIVM,9,,103493888
11,94227152,5592,ANKRD49,9,,94232744
11,60260250,14651,MS4A12,9,,60274901
1,113066140,95900,ST7L,9,,113162040
1,19638739,17055,PQLC2,9,,19655794
1,186344889,45614,C1orf27,9,,186390503
X,54094835,114856,FAM120C,9,,54209691
1,38147241,9026,C1orf109,9,,38156267
9,77676115,27018,NMRK1,9,,77703133
16,3072620,1667,HCFC1R1,9,,3074287
2,29072687,20488,TRMT61B,9,,29093175
17,71228760,16335,C17orf80,9,,71245095
19,18699494,3653,C19orf60,9,,18703147
9,77561498,6304,C9orf40,9,,77567802
5,37379361,373413,WDR70,9,,37752774
10,28101092,186887,ARMC4,9,,28287979
3,9439383,80455,SETD5,9,,9519838
1,212537815,50428,TMEM206,9,,212588243
6,107077440,38852,QRSL1,9,,107116292
4,26585545,172290,TBC1D19,9,,26757835
17,30178883,7443,COPRS,9,,30186326
6,44095290,27966,TMEM63B,9,,44123256
5,140019011,5982,TMCO6,9,,140024993
8,92006501,46702,TMEM55A,9,,92053203
9,86451614,84766,KIF27,9,,86536380
19,58987530,5071,ZNF446,9,,58992601
1,16888921,51179,NBPF1,9,,16940100
14,93703895,95543,BTBD7,9,,93799438
1,169764549,57681,C1orf112,9,,169822230
19,53073916,16511,ZNF701,9,,53090427
6,39071838,11124,SAYSD1,9,,39082962
16,71316202,7113,CMTR2,9,,71323315
19,53611131,25040,ZNF415,9,,53636171
19,35168543,8759,ZNF302,9,,35177302
22,30126944,36025,ZMAT5,9,,30162969
X,101087084,25465,NXF5,9,,101112549
5,140868807,23739,PCDHGC5,9,,140892546
5,140762305,130241,PCDHGA7,9,,140892546
5,140624916,2885,PCDHB15,9,,140627801
5,140479825,3582,PCDHB3,9,,140483407
5,140261853,130076,PCDHA13,9,,140391929
4,162305043,780143,FSTL5,9,,163085186
12,68688345,37816,MDM1,9,,68726161
19,6729924,7709,GPR108,9,,6737633
14,24908971,3036,SDR39U1,9,,24912007
1,197881634,17639,LHX9,9,,197899273
15,72533521,31395,PARP6,9,,72564916
11,129769600,103130,PRDM10,9,,129872730
1,25568727,5283,RSRP1,9,,25574010
20,54987313,47083,CASS4,9,,55034396
12,4596895,50779,C12orf4,9,,4647674
1,153302596,18721,PGLYRP4,9,,153321317
14,78266425,133872,ADCK1,9,,78400297
6,90341942,6532,LYRM2,9,,90348474
17,15602890,21210,ZNF286A,9,,15624100
19,54926604,21295,TTYH1,9,,54947899
X,50334642,222402,SHROOM4,9,,50557044
4,141786724,267892,RNF150,9,,142054616
18,34409079,396209,KIAA1328,9,,34805288
1,11539294,58346,PTCHD2,9,,11597640
2,217122584,114166,4-Mar,9,,217236750
6,158957467,99000,TMEM181,9,,159056467
2,224740059,70045,WDFY1,9,,224810104
X,153067620,28402,PDZD4,9,,153096022
19,35491223,26152,GRAMD1A,9,,35517375
5,60628099,213900,ZSWIM6,9,,60841999
12,50184928,37280,NCKAP5L,9,,50222208
19,37034516,61662,ZNF529,9,,37096178
14,94640648,53534,PPP4R4,9,,94694182
19,17434031,11607,ANO8,9,,17445638
9,115641199,11994,SLC46A2,9,,115653193
20,33292111,9132,TP53INP2,9,,33301243
21,33784744,102966,EVA1C,9,,33887710
8,38758752,72678,PLEKHA2,9,,38831430
1,175036993,80209,TNN,9,,175117202
21,43218384,81207,PRDM15,9,,43299591
16,68021292,12129,DPEP2,9,,68033421
20,23342768,10930,GZF1,9,,23353698
6,135238527,32733,ALDH8A1,9,,135271260
1,20465822,11057,PLA2G2F,9,,20476879
1,33283042,41438,S100PBP,9,,33324480
16,86563781,25060,MTHFSD,9,,86588841
15,89164526,10986,AEN,9,,89175512
3,49199967,3818,CCDC71,9,,49203785
2,203879601,203116,NBEAL1,9,,204082717
12,122989189,22371,RSRC2,9,,123011560
12,30862485,44963,CAPRIN2,9,,30907448
4,53728494,4508,RASL11B,9,,53733002
19,11033443,6245,YIPF2,9,,11039688
20,42875897,33660,GDAP1L1,9,,42909557
11,66624875,3071,LRFN4,9,,66627946
16,30205163,3724,SLX1B,9,,30208887
9,130922538,3669,C9orf16,9,,130926207
17,7138346,4479,PHF23,9,,7142825
19,54742828,3782,LILRA6,9,,54746610
19,13993160,23818,C19orf57,9,,14016978
20,43104525,18719,TTPAL,9,,43123244
12,122688227,5272,B3GNT4,9,,122693499
10,103605355,210577,C10orf76,9,,103815932
12,111051831,35104,TCTN1,9,,111086935
16,103828,3841,SNRNP25,9,,107669
8,49627473,20397,EFCAB1,9,,49647870
6,157802556,292421,ZDHHC14,9,,158094977
14,73957638,2467,C14orf169,9,,73960105
20,57264186,26714,NPEPL1,9,,57290900
8,82613565,19974,ZFAND1,9,,82633539
5,134209459,27864,TXNDC15,9,,134237323
11,47681142,55786,AGBL2,9,,47736928
15,64443915,5765,SNX22,9,,64449680
11,122753235,77195,C11orf63,9,,122830430
12,14656596,64195,PLBD1,9,,14720791
11,36317724,169030,PRR5L,9,,36486754
16,3507984,28979,NAA60,9,,3536963
19,6467214,14605,DENND1C,9,,6481819
7,149244244,77637,ZNF767P,9,,149321881
7,138818489,58243,TTC26,9,,138876732
17,40819932,9116,PLEKHH3,9,,40829048
1,233119881,311578,PCNXL2,9,,233431459
2,166326156,219761,CSRNP3,9,,166545917
2,77743791,5768,LRRTM4,9,,77749559
19,58488440,26274,ZNF606,9,,58514714
6,153019029,26686,MYCT1,9,,153045715
17,34868916,22389,MYO19,9,,34891305
10,81838778,13529,TMEM254,9,,81852307
13,39584001,28212,PROSER1,9,,39612213
9,86354335,78417,GKAP1,9,,86432752
18,52568739,56540,CCDC68,9,,52625279
1,249104650,15504,SH3BP5L,9,,249120154
1,39339738,7560,GJA9,9,,39347298
11,450279,41121,PTDSS2,9,,491400
1,184356149,242006,C1orf21,9,,184598155
19,13858676,15436,CCDC130,9,,13874112
6,29323006,1048,OR5V1,9,,29324054
5,149372685,7486,TIGD6,9,,149380171
8,70584567,161058,SLCO5A1,9,,70745625
17,6354582,105295,PITPNM3,9,,6459877
10,103986034,3310,ELOVL3,9,,103989344
12,13236470,20160,GSG1,9,,13256630
13,52436083,4289,CCDC70,9,,52440372
1,200613164,25962,DDX59,9,,200639126
6,132873822,1048,TAAR8,9,,132874870
2,128619206,24308,AMMECR1L,9,,128643514
9,95607312,33008,ZNF484,9,,95640320
6,39282473,7857,KCNK16,9,,39290330
3,138153414,45370,ESYT3,9,,138198784
19,1852397,11167,KLF16,9,,1863564
9,108210314,104400,FSD1L,9,,108314714
1,226411318,3438,MIXL1,9,,226414756
16,28986095,9774,SPNS1,9,,28995869
12,49981287,18146,FAM186B,9,,49999433
14,44973353,3146,FSCB,9,,44976499
4,122249796,52385,QRFPR,9,,122302181
16,734621,5803,WDR24,9,,740424
21,47581061,23312,SPATC1L,9,,47604373
9,130025940,129888,GARNL3,9,,130155828
2,73455133,5279,PRADC1,9,,73460412
8,117778741,8180,UTP23,9,,117786921
12,66516848,7685,LLPH,9,,66524533
2,131095505,4451,CCDC115,9,,131099956
5,76372501,10570,ZBED3,9,,76383071
10,82116523,11306,DYDC2,9,,82127829
5,139554652,68722,CYSTM1,9,,139623374
12,6747241,9339,ACRBP,9,,6756580
19,9434447,20074,ZNF559,9,,9454521
3,124801479,128764,SLC12A8,9,,124930243
10,29577989,22169,LYZL1,9,,29600158
9,97136832,86370,HIATL1,9,,97223202
1,152551859,1121,LCE3D,9,,152552980
12,75669758,54078,CAPS2,9,,75723836
5,180682146,5973,TRIM52,9,,180688119
19,37096206,23293,ZNF382,9,,37119499
3,122513900,86086,DIRC2,9,,122599986
3,196433147,6018,CEP19,9,,196439165
8,124194591,27728,FAM83A,9,,124222319
12,50505763,8477,COX14,9,,50514240
4,89442128,2824,PIGY,9,,89444952
21,11020841,78084,BAGE2,9,,11098925
8,86019322,38992,LRRCC1,9,,86058314
17,73780919,40967,UNK,9,,73821886
2,159825145,264025,TANC1,9,,160089170
6,42989339,7998,RRP36,9,,42997337
11,65808235,8416,GAL3ST3,9,,65816651
X,49126305,18250,PPP1R3F,9,,49144555
14,105714878,2552,BTBD6,9,,105717430
14,90389620,31501,EFCAB11,9,,90421121
19,53341784,19118,ZNF468,9,,53360902
7,1192542,7313,ZFAND2A,9,,1199855
Y,6778726,180998,TBL1Y,9,,6959724
X,102507922,2199,TCEAL8,9,,102510121
7,140372952,21956,ADCK2,9,,140394908
22,22988781,1587,GGTLC2,9,,22990368
11,47430045,8006,SLC39A13,9,,47438051
14,65381078,21006,CHURC1,9,,65402084
11,67410025,8105,ACY3,9,,67418130
20,23965689,3727,GGTLC1,9,,23969416
2,30945637,84674,CAPN13,9,,31030311
9,125001833,25310,RBM18,9,,125027143
10,112658487,20637,BBIP1,9,,112679124
2,18744136,26710,NT5C1B,9,,18770846
19,48799708,23624,CCDC114,9,,48823332
8,124084919,79473,TBC1D31,9,,124164392
13,43460523,105925,EPSTI1,9,,43566448
16,834973,3410,RPUSD1,9,,838383
8,144451024,15366,RHPN1,9,,144466390
4,6709428,2178,MRFAP1L1,9,,6711606
1,89646830,17803,GBP4,9,,89664633
16,30613878,7829,ZNF689,9,,30621707
1,27331510,7823,FAM46B,9,,27339333
13,52158483,177688,WDFY2,9,,52336171
20,54933982,9736,FAM210B,9,,54943718
1,227922696,46236,SNAP47,9,,227968932
10,135160843,5344,PRAP1,9,,135166187
10,125505151,146349,CPXM2,9,,125651500
14,104394816,124188,TDRD9,9,,104519004
15,99791566,139371,LRRC28,9,,99930937
17,27281946,51135,SEZ6,9,,27333081
17,77906141,18515,TBC1D16,9,,77924656
18,44056934,82336,LOXHD1,9,,44139270
19,16589867,17136,CALR3,9,,16607003
19,11925106,20910,ZNF440,9,,11946016
19,4640028,15552,TNFAIP8L1,9,,4655580
1,85527980,70841,WDR63,9,,85598821
1,76384557,13559,ASB17,9,,76398116
1,53527723,23451,PODN,9,,53551174
1,217804665,236830,SPATA17,9,,218041495
20,42931477,8415,FITM2,9,,42939892
20,10415950,192732,SLX4IP,9,,10608682
20,23420321,5246,CSTL1,9,,23425567
22,25202187,120626,SGSM1,9,,25322813
22,29601900,53686,EMID1,9,,29655586
2,6990780,15170,CMPK2,9,,7005950
2,135596185,63417,ACMSD,9,,135659602
2,43864438,130688,PLEKHH2,9,,43995126
2,150186498,144161,LYPD6,9,,150330659
3,126200007,36609,UROC1,9,,126236616
3,11831915,56478,TAMM41,9,,11888393
3,52280185,4430,PPM1M,9,,52284615
3,129262056,8254,H1FOO,9,,129270310
4,52917496,45975,SPATA18,9,,52963471
4,118004709,2027,TRAM1L1,9,,118006736
5,72416387,11257,TMEM171,9,,72427644
6,30103884,12628,TRIM40,9,,30116512
8,56651302,25237,TMEM68,9,,56676539
9,77595709,47637,C9orf41,9,,77643346
X,142710594,13332,SLITRK4,9,,142723926
X,74493893,30839,UPRT,9,,74524732
X,152935187,4629,PNCK,9,,152939816
Y,22917953,24965,RPS4Y2,9,,22942918
19,57050316,17854,ZFP28,9,,57068170
20,44517110,2816,NEURL2,9,,44519926
20,13202417,78880,ISM1,9,,13281297
10,82095860,20654,DYDC1,9,,82116514
12,38710556,12972,ALG10B,9,,38723528
12,129337978,131531,GLT1D1,9,,129469509
12,110940004,29887,RAD9B,9,,110969891
13,50746153,1598,ST13P4,9,,50747751
15,62359175,3941,C2CD4A,9,,62363116
17,80900024,109662,B3GNTL1,9,,81009686
17,1837970,90669,RTN4RL1,9,,1928639
17,33762114,13742,SLFN13,9,,33775856
17,41924515,11087,CD300LG,9,,41935602
17,7255207,3055,KCTD11,9,,7258262
11,193079,1494,SCGB1C1,9,,194573
19,49891474,29782,CCDC155,9,,49921256
1,6673755,10338,PHF13,9,,6684093
1,146373856,93783,NBPF12,9,,146467639
21,41117333,56690,IGSF5,9,,41174023
2,113239742,50480,TTL,9,,113290222
2,187692206,21691,ZSWIM2,9,,187713897
3,14860468,115604,FGD5,9,,14976072
6,130465446,78653,SAMD3,9,,130544099
6,125283690,130090,RNF217,9,,125413780
8,36641841,151802,KCNU1,9,,36793643
9,138700332,98673,CAMSAP1,9,,138799005
9,124584203,271682,TTLL11,9,,124855885
9,85594499,83544,RASEF,9,,85678043
9,18927657,121695,FAM154A,9,,19049352
9,115249247,178344,KIAA1958,9,,115427591
13,39540061,24935,STOML3,9,,39564996
15,31767600,395275,OTUD7A,9,,32162875
18,51884286,24119,C18orf54,9,,51908405
19,56088890,3321,ZNF579,9,,56092211
19,40029446,1392,EID2,9,,40030838
1,99355800,114649,LPPR5,9,,99470449
1,179560756,99651,TDRD5,9,,179660407
1,41326727,1291,CITED4,9,,41328018
1,226170402,16664,SDE2,9,,226187066
7,47814249,173822,PKD1L1,9,,47988071
7,150211944,6217,GIMAP7,9,,150218161
7,127010096,22682,ZNF800,9,,127032778
X,57017263,4725,SPIN3,9,,57021988
11,64701942,1418,GPHA2,9,,64703360
11,130318868,27672,ADAMTS15,9,,130346540
5,5140442,179973,ADAMTS16,9,,5320415
2,42669156,52081,KCNG3,9,,42721237
X,8992272,9896,FAM9B,9,,9002168
14,34902143,29325,SPTSSA,9,,34931468
11,118097404,25679,MPZL3,9,,118123083
12,123899585,21695,RILPL2,9,,123921280
12,113796370,31088,PLBD2,9,,113827458
10,50222289,101288,VSTM4,9,,50323577
19,11708234,21740,ZNF627,9,,11729974
1,155141883,3921,KRTCAP2,9,,155145804
2,97503650,6108,ANKRD23,9,,97509758
3,93776765,5302,DHFRL1,9,,93782067
17,43471267,36396,ARHGAP27,9,,43507663
18,8609442,29938,RAB12,9,,8639380
4,48485359,6182,SLC10A4,9,,48491541
5,138732455,7321,SPATA24,9,,138739776
X,105066535,136067,NRK,9,,105202602
X,134654554,61906,DDX26B,9,,134716460
X,134478695,18643,ZNF449,9,,134497338
10,25270907,80301,ENKUR,9,,25351208
10,23216952,110500,ARMC3,9,,23327452
11,61025757,37031,VWCE,9,,61062788
16,57576548,34552,GPR114,9,,57611100
6,52696540,14353,GSTA5,9,,52710893
6,47666288,23469,GPR115,9,,47689757
6,36916038,16575,PI16,9,,36932613
6,13925097,55143,RNF182,9,,13980240
10,13483087,61889,BEND7,9,,13544976
6,114376749,7292,HS3ST5,9,,114384041
8,7669241,3997,DEFB107A,9,,7673238
1,19592475,8093,AKR7L,9,,19600568
22,42949867,20521,SERHL2,9,,42970388
6,169857302,244857,WDR27,9,,170102159
11,65601409,19763,SNX32,9,,65621172
X,20024830,110284,MAP7D2,9,,20135114
6,28471072,12498,GPX6,9,,28483570
3,46710484,24662,ALS2CL,9,,46735146
7,143174965,924,TAS2R41,9,,143175889
12,11148560,2343,TAS2R20,9,,11150903
16,31227282,1132,PYDC1,9,,31228414
4,71091787,9181,FDCSP,9,,71100968
10,134020985,100492,STK32C,9,,134121477
11,828259,3732,CRACR2B,9,,831991
12,100967438,54628,GAS2L3,9,,101022066
12,120884240,17316,GATC,9,,120901556
14,24674925,2529,TSSK4,9,,24677454
15,55903738,131579,PRTG,9,,56035317
16,67034415,9244,CES4A,9,,67043659
16,8619501,2725,TMEM114,9,,8622226
19,49216254,6722,MAMSTR,9,,49222976
1,148558187,38080,NBPF15,9,,148596267
1,110036700,6363,CYB561D1,9,,110043063
3,56591183,64665,CCDC66,9,,56655848
5,141016516,4115,RELL2,9,,141020631
5,154393314,4378,KIF4B,9,,154397692
6,7326886,63056,CAGE1,9,,7389942
6,36210944,65428,PNPLA1,9,,36276372
8,38457692,1083,RNF5P1,9,,38458775
9,12775011,48048,LURAP1L,9,,12823059
X,26156459,2394,MAGEB18,9,,26158853
3,160153290,14336,TRIM59,9,,160167626
20,31781410,16858,BPIFA4P,9,,31798268
17,39994031,10584,KLHL10,9,,40004615
16,56677715,1138,MT1DP,9,,56678853
1,149821758,582,HIST2H2BC,9,,149822340
15,25415869,82,SNORD115-1,9,,25415951
17,79633760,7176,CCDC137,9,,79640936
1,227751219,98945,ZNF678,9,,227850164
1,40943301,18714,ZFP69,9,,40962015
2,139259349,71456,SPOPL,9,,139330805
6,2663862,87292,MYLK4,9,,2751154
X,73952690,192597,KIAA2022,9,,74145287
10,94821020,7434,CYP26C1,9,,94828454
16,71879893,11343,ATXN1L,9,,71891236
19,13988062,3509,NANOS3,9,,13991571
1,159772172,13875,FCRL6,9,,159786047
3,137980278,68450,NME9,9,,138048728
11,767222,10280,PDDC1,9,,777502
6,150238013,6275,RAET1G,9,,150244288
3,44481261,37901,ZNF445,9,,44519162
17,15468795,54223,CDRT1,9,,15523018
19,11453451,3530,TMEM205,9,,11456981
19,37407230,36415,ZNF568,9,,37443645
1,156863522,22704,PEAR1,9,,156886226
2,97779232,151025,ANKRD36,9,,97930257
8,86157715,38587,CA13,9,,86196302
14,55880929,26334,TBPL2,9,,55907263
14,95107061,6270,SERPINA13P,9,,95113331
19,53935226,26289,ZNF761,9,,53961515
1,145209112,77158,NOTCH2NL,9,,145286270
1,223714971,138465,CAPN8,9,,223853436
2,29284555,12572,C2orf71,9,,29297127
2,74362527,12512,BOLA3,9,,74375039
2,103089761,60670,SLC9A4,9,,103150431
8,27879480,61908,NUGGC,9,,27941388
14,21024251,4839,RNASE9,9,,21029090
15,23282264,95995,HERC2P2,9,,23378259
22,24108020,2139,CHCHD10,9,,24110159
8,86126287,6364,C8orf59,9,,86132651
19,52196038,79,MIRLET7E,9,,52196117
20,3898140,78,MIR103A2,9,,3898218
1,71533313,86,MIR186,9,,71533399
14,23857804,71,MIR208A,9,,23857875
14,101490130,63,MIR299,9,,101490193
10,99349449,1242,C10orf62,9,,99350691
17,74669731,37356,MXRA7,9,,74707087
13,52586522,17258,ALG11,9,,52603780
15,34817483,10739,GOLGA8B,9,,34828222
17,6915735,2117,RNASEK,9,,6917852
22,27053445,18995,MIAT,9,,27072440
7,76610138,42938,DTX2P1-UPK3BP1-PMS2P11,9,,76653076
10,14861250,18733,CDNF,9,,14879983
4,113569640,73,MIR302B,9,,113569713
7,1062568,94,MIR339,9,,1062662
5,179442302,95,MIR340,9,,179442397
10,88024450,95,MIR346,9,,88024545
14,101531934,70,MIR369,9,,101532004
X,154689075,594,H2AFB2,9,,154689669
14,101507118,68,MIR376A1,9,,101507186
3,49057580,87,MIR425,9,,49057667
8,7679487,1925,DEFB105B,9,,7681412
19,54189722,87,MIR519C,9,,54189809
X,49779205,86,MIR502,9,,49779291
5,109755197,307253,TMEM232,9,,110062450
11,60989820,9347,PGA4,9,,60999167
11,13030969,2684,RASSF10,9,,13033653
2,233385172,5253,PRSS56,9,,233390425
22,30681106,4510,GATSL3,9,,30685616
2,107021135,63666,RGPD3,9,,107084801
19,43341148,18722,PSG10P,9,,43359870
5,54466473,97,MIR449B,9,,54466570
10,102734741,100,MIR608,9,,102734841
14,65937819,85,MIR625,9,,65937904
19,10829079,100,MIR638,9,,10829179
2,88056717,68569,RGPD2,9,,88125286
2,39103102,6748,MORN2,9,,39109850
16,2580035,1374,CEMP1,9,,2581409
1,152691997,908,C1orf68,9,,152692905
4,77172852,32084,FAM47E,9,,77204936
6,135818938,193038,LINC00271,9,,136011976
21,9907188,61406,TEKT4P2,9,,9968594
4,184242916,663,CLDN24,9,,184243579
10,89618917,4277,KLLN,9,,89623194
10,57358749,1738,MTRNR2L5,9,,57360487
17,33801941,12817,SLFN12L,9,,33814758
11,3666360,19286,ART1,8,,3685646
X,70430034,518928,BCYRN1,8,,70948962
8,90914761,25354,OSGIN2,8,,90940115
1,207818457,78579,CR1L,8,,207897036
X,83116133,25575,CYLC1,8,,83141708
5,72742084,2268,FOXD1,8,,72744352
20,30432102,1318,FOXS1,8,,30433420
11,5263184,1638,HBBP1,8,,5264822
6,29973747,3986,HLA-J,8,,29977733
4,8868772,4771,HMX1,8,,8873543
12,10564913,8281,KLRC3,8,,10573194
4,671710,4107,MYL5,8,,675817
17,3181183,1085,OR3A2,8,,3182268
20,58511886,3466,PPP1R3D,8,,58515352
19,43511808,18823,PSG11,8,,43530631
12,133264191,17386,PXMP2,8,,133281577
17,80005777,3873,RFNG,8,,80009650
20,34203805,5166,SPAG4,8,,34208971
1,153084599,1392,SPRR2F,8,,153085991
19,49384221,17775,TULP2,8,,49401996
19,19821280,22641,ZNF14,8,,19843921
19,57922528,10779,ZNF17,8,,57933307
19,44529493,7769,ZNF222,8,,44537262
7,64254765,39294,ZNF138,8,,64294059
4,331595,36096,ZNF141,8,,367691
17,56048909,16706,VEZF1,8,,56065615
19,9486991,6302,ZNF177,8,,9493293
17,19314490,6099,RNF112,8,,19320589
19,22148896,44849,ZNF208,8,,22193745
17,3300759,945,OR1E1,8,,3301704
1,1631377,1870,MMP23A,8,,1633247
17,76419777,153699,DNAH17,8,,76573476
19,44790500,18678,ZNF235,8,,44809178
9,71939487,67883,FAM189A2,8,,72007370
X,52380347,6674,XAGE2,8,,52387021
2,219575567,44571,TTLL4,8,,219620138
19,34745455,101016,KIAA0355,8,,34846471
13,52598826,8910,UTP14C,8,,52607736
1,3728644,45153,CEP104,8,,3773797
1,47140830,43906,EFCAB14,8,,47184736
12,55342086,33536,TESPA1,8,,55375622
9,138371647,9092,PPP1R26,8,,138380739
14,75127954,51853,AREL1,8,,75179807
17,2240807,43541,SGSM2,8,,2284348
16,25703346,445663,HS3ST4,8,,26149009
16,78062985,3016,CLEC3A,8,,78066001
10,44282859,3006,HNRNPA3P1,8,,44285865
19,12540519,11407,ZNF443,8,,12551926
4,2932287,3677,MFSD10,8,,2935964
7,102553343,32213,LRRC17,8,,102585556
17,66970772,86364,ABCA9,8,,67057136
15,68908878,111266,CORO2B,8,,69020144
19,4542599,17172,SEMA6B,8,,4559771
9,1050353,7201,DMRT2,8,,1057554
2,162272604,9774,TBR1,8,,162282378
4,70065907,14542,UGT2B11,8,,70080449
22,32586421,13043,RFPL2,8,,32599464
19,44645709,18753,ZNF234,8,,44664462
14,21214098,2441,EDDM3A,8,,21216539
4,71248794,7167,SMR3B,8,,71255961
1,149900542,8249,MTMR11,8,,149908791
6,123110193,20671,SMPDL3A,8,,123130864
1,79086066,25764,IFI44L,8,,79111830
19,54754268,6903,LILRB5,8,,54761171
9,99082987,63005,SLC35D2,8,,99145992
7,107204401,14567,DUS4L,8,,107218968
1,120436155,2992,ADAM30,8,,120439147
4,175839508,59823,ADAM29,8,,175899331
4,174309298,11099,SCRG1,8,,174320397
19,38123388,22925,ZFP30,8,,38146313
9,37651051,95850,FRMPD1,8,,37746901
6,46097700,16736,ENPP4,8,,46114436
1,109512837,72013,WDR47,8,,109584850
7,76239302,17318,POMZP3,8,,76256620
7,45120035,8458,NACAD,8,,45128493
16,27561467,230225,KIAA0556,8,,27791692
12,57449425,23149,TMEM194A,8,,57472574
7,34968492,109161,DPY19L1,8,,35077653
6,42788793,47505,GLTSCR1L,8,,42836298
7,123485222,32309,HYAL4,8,,123517531
11,124617367,4801,VSIG2,8,,124622168
11,62619459,3901,SNHG1,8,,62623360
11,63871361,15284,FLRT1,8,,63886645
1,148250248,96508,NBPF14,8,,148346756
7,97844754,36809,TECPR1,8,,97881563
11,64067862,4377,TEX40,8,,64072239
20,3758150,3952,SPEF1,8,,3762102
6,139094656,19800,CCDC28A,8,,139114456
3,45265955,1859,TMEM158,8,,45267814
2,68520141,27042,CNRIP1,8,,68547183
10,74870132,21454,NUDT13,8,,74891586
21,43305218,68781,C2CD2,8,,43373999
5,74073398,89265,FAM169A,8,,74162663
3,9851643,26397,TTLL3,8,,9878040
10,98740987,14729,C10orf12,8,,98755716
9,40771411,20705,ZNF658,8,,40792116
17,3100810,932,OR1A2,8,,3101742
5,135266005,11362,FBXL21,8,,135277367
22,23604953,2233,FBXW4P1,8,,23607186
5,176074387,11672,TSPAN17,8,,176086059
7,135365986,46966,SLC13A4,8,,135412952
X,49335064,7296,GAGE12I,8,,49342360
2,220036618,5097,CNPPD1,8,,220041715
15,40861491,5402,RPUSD2,8,,40866893
17,64873390,8005,CACNG5,8,,64881395
18,596997,53296,CLUL1,8,,650293
19,18111940,12971,ARRDC2,8,,18124911
3,108677086,159907,MORC1,8,,108836993
7,140218218,122358,DENND2A,8,,140340576
6,36164549,36018,BRPF3,8,,36200567
1,28261465,21526,SMPDL3B,8,,28282991
11,77532159,51239,AAMDC,8,,77583398
22,24647588,13904,POM121L9P,8,,24661492
1,212606228,13493,NENF,8,,212619721
9,130647599,14328,ST6GALNAC6,8,,130661927
12,132680916,224989,GALNT9,8,,132905905
18,55019720,16441,ST8SIA3,8,,55036161
8,139142265,366800,FAM135B,8,,139509065
9,74480067,46094,ABHD17B,8,,74526161
9,131181438,18192,CERCAM,8,,131199630
3,14693252,20914,CCDC174,8,,14714166
11,73583712,4178,COA4,8,,73587890
11,60704554,14703,SLC15A3,8,,60719257
5,137273606,95196,FAM13B,8,,137368802
11,60048013,28432,MS4A4A,8,,60076445
6,17600517,11433,FAM8A1,8,,17611950
2,73927635,832,NAT8B,8,,73928467
12,104166080,68895,NT5DC3,8,,104234975
17,42923720,4128,HIGD1B,8,,42927848
7,76940067,105650,GSAP,8,,77045717
2,946553,424831,SNTG2,8,,1371384
11,114269255,2017,C11orf71,8,,114271272
1,6475293,4686,HES2,8,,6479979
15,59063390,90708,FAM63B,8,,59154098
9,131549485,23226,TBC1D13,8,,131572711
17,49254785,82642,MBTD1,8,,49337427
14,45393512,37667,KLHL28,8,,45431179
15,71184781,157655,LRRC49,8,,71342436
2,191273080,93961,MFSD6,8,,191367041
2,206858444,92462,INO80D,8,,206950906
3,125725199,77935,SLC41A3,8,,125803134
19,47549166,2716,TMEM160,8,,47551882
15,35270541,9956,ZNF770,8,,35280497
14,23564682,4983,C14orf119,8,,23569665
8,125463047,2219,TRMT12,8,,125465266
7,99998494,27937,ZCWPW1,8,,100026431
9,4598315,68359,SPATA6L,8,,4666674
6,107811316,171197,SOBP,8,,107982513
8,124428964,25516,WDYHV1,8,,124454480
1,32538499,29968,TMEM39B,8,,32568467
14,69658193,52544,EXD2,8,,69710737
1,53361581,25865,ECHDC2,8,,53387446
7,134832765,18202,TMEM140,8,,134850967
20,3801170,4784,AP5S1,8,,3805954
2,220378891,24603,ASIC4,8,,220403494
11,64591661,20380,CDC42BPG,8,,64612041
16,71893582,24511,ZNF821,8,,71918093
1,249144202,8923,ZNF692,8,,249153125
14,76618227,60919,GPATCH2L,8,,76679146
2,3705785,44475,ALLC,8,,3750260
X,9983794,128724,WWC3,8,,10112518
1,154966061,730,LENEP,8,,154966791
15,90293097,1443,MESP1,8,,90294540
16,28505969,4322,APOBR,8,,28510291
1,112264685,17361,FAM212B,8,,112282046
7,87463813,41879,SLC25A40,8,,87505692
5,140797259,95289,PCDHGB7,8,,140892548
5,140718326,174220,PCDHGA2,8,,140892546
5,140588290,3408,PCDHB12,8,,140591698
5,140306301,85628,PCDHAC1,8,,140391929
11,112038094,5185,TEX12,8,,112043279
X,69748789,379778,TEX11,8,,70128567
21,34162983,23070,C21orf62,8,,34186053
20,5525079,66593,GPCPD1,8,,5591672
7,117864711,18073,ANKRD7,8,,117882784
9,35957104,1047,OR2S2,8,,35958151
11,8941622,12931,C11orf16,8,,8954553
19,40194945,5143,LGALS14,8,,40200088
4,184826508,118175,STOX2,8,,184944683
12,102091416,31430,CHPT1,8,,102122846
11,89530822,10921,TRIM49,8,,89541743
1,24742244,57229,NIPAL3,8,,24799473
17,16450276,22250,ZNF287,8,,16472526
14,69726680,94510,GALNT16,8,,69821190
12,94960899,83439,TMCC3,8,,95044338
16,23072727,87864,USP31,8,,23160591
1,86815776,46249,ODF2L,8,,86862025
16,2227183,19282,CASKIN1,8,,2246465
X,109662284,37278,RGAG1,8,,109699562
14,93799564,374658,UNC79,8,,94174222
12,123468026,126949,PITPNM2,8,,123594975
2,226265601,253133,NYAP2,8,,226518734
7,76751933,172588,CCDC146,8,,76924521
12,133067156,94617,FBRSL1,8,,133161773
2,207139751,39399,ZDBF2,8,,207179150
1,64936475,222266,CACHD1,8,,65158741
19,9251055,23036,ZNF317,8,,9274091
3,170177341,126522,SLC7A14,8,,170303863
10,7200585,250718,SFMBT2,8,,7451303
9,132815984,86464,GPR107,8,,132902448
19,2933215,11754,ZNF77,8,,2944969
20,18004795,33731,OVOL2,8,,18038526
9,976967,14765,DMRT3,8,,991732
6,139349818,14621,ABRACL,8,,139364439
6,138537126,2501,PBOV1,8,,138539627
17,58120551,35741,HEATR6,8,,58156292
7,31377074,3464,NEUROD6,8,,31380538
16,2902727,5444,PRSS22,8,,2908171
11,102562414,14054,MMP27,8,,102576468
2,28004230,109033,RBKS,8,,28113263
20,3639938,4108,GFRA4,8,,3644046
16,68009565,4887,DPEP3,8,,68014452
14,21236585,2522,EDDM3B,8,,21239107
11,60197061,18204,MS4A5,8,,60215265
6,28292514,11397,ZSCAN31,8,,28303911
5,177611510,2923,GMCL1P1,8,,177614433
7,112402436,28042,TMEM168,8,,112430478
14,60558628,42904,PCNXL4,8,,60601532
17,72270385,40638,DNAI2,8,,72311023
17,15207128,37830,TEKT3,8,,15244958
4,115748928,286104,NDST4,8,,116035032
18,19993563,4315,CTAGE1,8,,19997878
15,67547137,247005,IQCH,8,,67794142
1,222841354,44510,AIDA,8,,222885864
19,17416476,1176,MRPL34,8,,17417652
16,30541687,4604,ZNF747,8,,30546291
7,150020295,14950,LRRC61,8,,150035245
5,148737569,11652,PCYOX1L,8,,148749221
16,90071272,14691,DBNDD1,8,,90085963
12,48357329,5332,TMEM106C,8,,48362661
19,16771937,27879,TMEM38A,8,,16799816
11,32851480,28189,PRRG4,8,,32879669
5,7859271,9879,FASTKD3,8,,7869150
1,43232915,8498,C1orf50,8,,43241413
6,31680117,1725,LY6G6E,8,,31681842
20,62152132,1392,PPDPF,8,,62153524
19,30156326,10057,PLEKHF1,8,,30166383
19,54659377,4104,LENG1,8,,54663481
16,54317211,3167,IRX3,8,,54320378
1,16558181,5478,RSG1,8,,16563659
16,3014216,4168,KREMEN2,8,,3018384
19,8274216,53088,CERS4,8,,8327304
16,68877508,241577,TANGO6,8,,69119085
4,121956781,36892,NDNF,8,,121993673
17,73106046,20314,ARMC7,8,,73126360
1,45118918,21362,TMEM53,8,,45140280
4,114821439,79439,ARSJ,8,,114900878
6,26634610,25370,ZNF322,8,,26659980
8,40388110,367233,ZMAT4,8,,40755343
2,144703580,348480,GTDC1,8,,145052060
4,83821802,19320,THAP9,8,,83841122
1,36771993,14955,SH3D21,8,,36786948
19,57999078,6970,ZNF419,8,,58006048
16,31072168,12655,ZNF668,8,,31084823
13,113979157,39306,GRTP1,8,,114018463
16,84682116,19176,KLHL36,8,,84701292
4,69794176,23333,UGT2A3,8,,69817509
19,2977535,17647,TLE6,8,,2995182
19,58318449,7832,ZNF552,8,,58326281
1,67278571,111999,WDR78,8,,67390570
2,172172255,119058,METTL8,8,,172291313
X,118108576,43742,LONRF3,8,,118152318
11,62518434,3222,ZBTB3,8,,62521656
5,795719,55382,ZDHHC11,8,,851101
19,15337732,6126,EPHX3,8,,15343858
2,228226753,17269,TM4SF20,8,,228244022
8,21964382,2550,NUDT18,8,,21966932
17,34900736,45540,GGNBP2,8,,34946276
5,180326076,51830,BTNL8,8,,180377906
1,35899090,123947,KIAA0319L,8,,36023037
10,75404638,11225,SYNPO2L,8,,75415863
19,16660647,22546,SLC35E1,8,,16683193
5,60047615,92486,ELOVL7,8,,60140101
12,43748011,197713,ADAMTS20,8,,43945724
11,124824016,87369,CCDC15,8,,124911385
11,67231818,4930,TMEM134,8,,67236748
19,50310123,6444,FUZ,8,,50316567
10,105889645,102490,CFAP43,8,,105992135
2,198318146,21887,COQ10B,8,,198340033
17,48503518,48688,ACSF2,8,,48552206
3,196673213,22529,PIGZ,8,,196695742
X,42636616,870,PPP1R2P9,8,,42637486
6,31686424,3087,LY6G6C,8,,31689511
2,39963199,43217,THUMPD2,8,,40006416
17,61773248,4271,LIMD2,8,,61777519
6,29968787,60174,ZNRD1-AS1,8,,30028961
1,33145506,22855,SYNC,8,,33168361
8,27092839,23117,STMN4,8,,27115956
2,135213329,263242,TMEM163,8,,135476571
6,24705089,14314,C6orf62,8,,24719403
6,88757506,19044,SPACA1,8,,88776550
6,10747991,9223,TMEM14B,8,,10757214
18,44526786,101828,KATNAL2,8,,44628614
18,33552587,6663,C18orf21,8,,33559250
15,83654954,4855,FAM103A1,8,,83659809
22,50639407,16638,SELO,8,,50656045
17,6703299,31761,TEKT1,8,,6735060
10,99473464,4445,MARVELD1,8,,99477909
6,159393902,27317,RSPH3,8,,159421219
8,125500734,50595,TATDN1,8,,125551329
8,102381120,703,NACAP1,8,,102381823
7,92158086,11709,RBM48,8,,92169795
17,48585744,23118,MYCBPAP,8,,48608862
12,105197274,125198,SLC41A2,8,,105322472
X,109245862,175154,TMEM164,8,,109421016
22,44888449,5556,LDOC1L,8,,44894005
7,140033551,64799,SLC37A3,8,,140098350
1,9599527,43304,SLC25A33,8,,9642831
3,49459765,6992,NICN1,8,,49466757
7,73095247,2534,DNAJC30,8,,73097781
4,926174,26269,TMEM175,8,,952443
1,245133630,154900,EFCAB2,8,,245288530
14,36295596,45573,BRMS1L,8,,36341169
15,45722726,2921,C15orf48,8,,45725647
15,66187633,358442,MEGF11,8,,66546075
14,24037243,10766,JPH4,8,,24048009
8,38120649,6089,PPAPDC1B,8,,38126738
17,40341104,5446,GHDC,8,,40346550
2,112973438,39226,ZC3H8,8,,113012664
2,61293004,58422,KIAA1841,8,,61351426
17,5082830,12348,ZNF594,8,,5095178
22,38339056,10620,C22orf23,8,,38349676
21,39493544,35061,DSCR8,8,,39528605
2,103331084,22263,MFSD9,8,,103353347
10,77157587,4065,ZNF503,8,,77161652
16,3138890,10428,ZSCAN10,8,,3149318
12,117176095,115341,RNFT2,8,,117291436
20,32319565,60510,ZNF341,8,,32380075
19,58361180,15311,ZNF587,8,,58376491
6,150139893,45587,LRP11,8,,150185480
9,133777824,36631,FIBCD1,8,,133814455
17,27941773,6668,CORO6,8,,27948441
13,108870762,15841,ABHD13,8,,108886603
17,1614797,4769,MIR22HG,8,,1619566
X,102862833,2022,TCEAL3,8,,102864855
9,139685776,1993,TMEM141,8,,139687769
22,20455993,5793,RIMBP3,8,,20461786
22,25423940,169475,KIAA1671,8,,25593415
4,10441503,17529,ZNF518B,8,,10459032
11,109964086,78480,ZC3H12C,8,,110042566
12,49297892,17467,CCDC65,8,,49315359
18,61369537,21590,SERPINB11,8,,61391127
1,159921281,2763,SLAMF9,8,,159924044
14,73704204,37143,PAPLN,8,,73741347
X,48916496,11014,CCDC120,8,,48927510
X,89176939,943,TGIF2LX,8,,89177882
19,41816067,14721,CCDC97,8,,41830788
19,51600862,10785,CTU1,8,,51611647
12,107349499,18316,TMEM263,8,,107367815
2,132285406,5833,CCDC74A,8,,132291239
19,11039423,1493,C19orf52,8,,11040916
4,183059812,5856,LOC90768,8,,183065668
4,148558935,46446,PRMT9,8,,148605381
9,103189710,24306,MSANTD3,8,,103214016
4,169277885,123780,DDX60L,8,,169401665
11,66790189,28145,SYT12,8,,66818334
8,12579403,33548,LONRF1,8,,12612951
5,150040402,18528,MYOZ3,8,,150058930
4,1717678,5406,TMEM129,8,,1723084
17,42248073,8378,ASB16,8,,42256451
12,66696324,41099,HELB,8,,66737423
10,135367403,11735,SYCE1,8,,135379138
17,40274755,616,HSPB9,8,,40275371
19,2096867,2716,IZUMO4,8,,2099583
9,116853917,7420,KIF12,8,,116861337
1,33360193,6848,TMEM54,8,,33367041
1,109190909,12835,HENMT1,8,,109203744
8,56015016,423694,XKR4,8,,56438710
17,74138533,97857,RNF157,8,,74236390
5,126203405,163095,3-Mar,8,,126366500
19,2819871,16862,ZNF554,8,,2836733
3,44771097,7478,ZNF501,8,,44778575
12,113633245,25654,IQCD,8,,113658899
19,11531271,14709,CCDC151,8,,11545980
8,99956630,7702,OSR2,8,,99964332
9,140476530,8407,ZMYND19,8,,140484937
11,124481452,8799,PANX3,8,,124490251
6,29454473,1260,MAS1L,8,,29455733
3,186838740,18523,RPL39L,8,,186857263
4,80748624,35777,PCAT4,8,,80784401
14,94547638,21422,IFI27L1,8,,94569060
14,105391152,8421,PLD4,8,,105399573
14,21051051,7366,RNASE11,8,,21058417
14,23511375,1894,PSMB11,8,,23513269
14,50159822,60048,KLHDC1,8,,50219870
15,76352298,145006,C15orf27,8,,76497304
15,83478379,25234,WHAMM,8,,83503613
15,42273779,69122,PLA2G4E,8,,42342901
16,3019245,4245,PAQR4,8,,3023490
16,75477141,21494,TMEM170A,8,,75498635
17,1945276,1449,OVCA2,8,,1946725
17,38516904,4041,GJD3,8,,38520945
19,6306509,27131,ACER1,8,,6333640
19,7696500,1398,PCP2,8,,7697898
19,56459197,40798,NLRP8,8,,56499995
19,2252249,4173,JSRP1,8,,2256422
19,1524072,11383,PLK5,8,,1535455
19,40826966,27468,C19orf47,8,,40854434
1,179334854,189016,AXDND1,8,,179523870
1,75198835,33525,TYW3,8,,75232360
1,34326075,4317,HMGB4,8,,34330392
1,204167287,15933,GOLT1A,8,,204183220
1,156307104,9681,TSACC,8,,156316785
1,16524348,14818,ARHGEF19,8,,16539166
20,61637330,1057,BHLHE23,8,,61638387
20,57766074,68093,ZNF831,8,,57834167
22,20004522,50165,TANGO2,8,,20054687
2,112895961,49830,FBLN7,8,,112945791
2,201353674,21143,KCTD18,8,,201374817
2,61404552,10134,AHSA2,8,,61414686
2,74802386,73079,M1AP,8,,74875465
4,69092370,19042,TMPRSS11B,8,,69111412
5,49692030,45204,EMB,8,,49737234
5,101707485,127235,SLCO6A1,8,,101834720
5,204874,13423,CCDC127,8,,218297
5,148651400,71798,AFAP1L1,8,,148723198
6,143743968,19846,ADAT2,8,,143763814
6,655938,1026,HUS1B,8,,656964
8,125985538,6092,ZNF572,8,,125991630
8,23559963,4148,NKX2-6,8,,23564111
X,103411155,29427,FAM199X,8,,103440582
X,117629871,190252,DOCK11,8,,117820123
20,44402846,17701,WFDC3,8,,44420547
20,17680592,35925,BANF2,8,,17716517
20,207898,2629,DEFB129,8,,210527
1,160914815,9774,ITLN2,8,,160924589
10,76871392,70489,SAMD8,8,,76941881
11,100558406,303250,ARHGAP42,8,,100861656
12,1675158,28173,FBXL14,8,,1703331
12,111798454,8471,FAM109A,8,,111806925
14,91006931,275830,TTC7B,8,,91282761
15,89420515,18342,HAPLN3,8,,89438857
16,21695749,76301,OTOA,8,,21772050
17,7620671,116391,DNAH2,8,,7737062
17,43002078,23001,KIF18B,8,,43025079
17,38904272,7312,KRT25,8,,38911584
1,150254942,4562,CIART,8,,150259504
1,234040457,419807,SLC35F3,8,,234460264
1,145549208,19318,ANKRD35,8,,145568526
1,205797149,22127,PM20D1,8,,205819276
1,158901336,45513,PYHIN1,8,,158946849
22,44275557,12336,PNPLA5,8,,44287893
2,95537177,5397,TEKT4,8,,95542574
2,73481809,14949,FBXO41,8,,73496758
2,208477462,12640,METTL21A,8,,208490102
2,182850550,131933,PPP1R1C,8,,182982483
2,14772809,7359,FAM84A,8,,14780168
2,160092303,51007,WDSUB1,8,,160143310
3,169511215,19359,LRRC34,8,,169530574
4,53178,34921,ZNF595,8,,88099
5,89754019,16566,MBLAC2,8,,89770585
5,2746278,5491,IRX2,8,,2751769
5,156277548,1991,PPP1R2P3,8,,156279539
6,150341265,5403,RAET1L,8,,150346668
6,88117689,56502,C6orf165,8,,88174191
7,149570056,7745,ATP6V0E2,8,,149577801
8,28285925,61910,FBXO16,8,,28347835
8,439789,55056,TDRP,8,,494845
8,614199,67040,ERICH1,8,,681239
9,5919007,88996,KIAA2026,8,,6008003
X,22291029,1547,ZNF645,8,,22292576
X,151903226,6292,CSAG1,8,,151909518
X,147062848,45339,FMR1NB,8,,147108187
X,57313109,202520,FAAH2,8,,57515629
X,103265718,2541,H2BFWT,8,,103268259
X,40486172,20647,CXorf38,8,,40506819
Y,24455009,109019,RBMY1F,8,,24564028
10,95653726,9855,SLC35G1,8,,95663581
10,106113521,101327,CFAP58,8,,106214848
11,108253726,84532,C11orf65,8,,108338258
12,9868455,17440,CLECL1,8,,9885895
12,31535156,208796,DENND5B,8,,31743952
14,61744088,4442,TMEM30B,8,,61748530
15,74165926,15630,TBC1D21,8,,74181556
15,39892231,182808,FSIP1,8,,40075039
17,48348766,10080,TMEM92,8,,48358846
1,115127195,85537,DENND2C,8,,115212732
20,57034159,55835,APCDD1L,8,,57089994
5,96427573,50947,LIX1,8,,96478520
7,106297210,4424,CCDC71L,8,,106301634
9,97021547,42564,ZNF169,8,,97064111
10,75532048,3928,FUT11,8,,75535976
X,52891557,4775,XAGE3,8,,52896332
4,46736846,174406,COX7B2,8,,46911252
4,54966247,1875,GSX2,8,,54968122
19,21324812,43993,ZNF431,8,,21368805
21,42547157,10009,PLAC4,8,,42557166
17,38854242,5760,KRT24,8,,38860002
12,6802956,7053,PIANP,8,,6810009
16,70488497,25680,FUK,8,,70514177
16,89284110,11855,ZNF778,8,,89295965
19,36525886,19778,THAP8,8,,36545664
1,9648931,16089,TMEM201,8,,9665020
1,47533159,50833,CYP4Z1,8,,47583992
2,27665232,4116,KRTCAP3,8,,27669348
2,233412679,2621,TIGD1,8,,233415300
18,45553638,110042,ZBTB7C,8,,45663680
4,16162127,66034,TAPT1,8,,16228161
5,146614578,149190,STK32A,8,,146763768
8,145597703,20750,ADCK5,8,,145618453
8,38831667,14514,HTRA4,8,,38846181
15,100940599,144326,CERS3,8,,101084925
1,75667815,408984,SLC44A5,8,,76076799
11,89392464,39422,FOLH1B,8,,89431886
10,63166399,46809,TMEM26,8,,63213208
10,72530993,14182,TBATA,8,,72545175
11,61248584,9816,PPP1R32,8,,61258400
13,51796469,61908,FAM124A,8,,51858377
18,47753563,39329,CFAP53,8,,47792892
10,44101854,11498,ZNF485,8,,44113352
13,21303069,45028,N6AMT2,8,,21348097
6,10887063,87478,SYCP2L,8,,10974541
7,29603426,3485,PRR15,8,,29606911
7,105603656,73221,CDHR3,8,,105676877
6,117586720,8008,VGLL2,8,,117594728
7,99717264,5864,CNPY4,8,,99723128
12,57637237,7739,STAC3,8,,57644976
6,31165536,6209,HCG27,8,,31171745
1,109358519,41207,AKNAD1,8,,109399726
9,131683173,21147,PHYHD1,8,,131704320
10,11865396,48880,PROSER2,8,,11914276
17,7306292,1158,TMEM256,8,,7307450
3,113666747,15473,ZDHHC23,8,,113682220
16,15489610,13933,MPV17L,8,,15503543
14,105639273,8387,NUDT14,8,,105647660
9,72658496,183392,MAMDC2,8,,72841888
19,8387467,20679,KANK3,8,,8408146
3,111393522,171772,PLCXD2,8,,111565294
1,161016731,23029,ARHGAP30,8,,161039760
20,44277201,21677,WFDC11,8,,44298878
11,18955359,1190,MRGPRX1,8,,18956549
1,47489239,27184,CYP4X1,8,,47516423
10,95717896,3776,PIPSL,8,,95721672
6,28962561,9281,ZNF311,8,,28971842
11,65142662,7483,SLC25A45,8,,65150145
11,74041356,68154,PGM2L1,8,,74109510
11,46624855,13922,HARBI1,8,,46638777
12,56624500,7129,SLC39A5,8,,56631629
12,56862300,2467,SPRYD4,8,,56864767
13,29274217,18933,SLC46A3,8,,29293150
14,100789678,7037,SLC25A47,8,,100796715
14,35514112,38477,FAM177A1,8,,35552589
14,105957585,8000,C14orf80,8,,105965585
16,29753785,3555,C16orf54,8,,29757340
16,77756388,19769,NUDT7,8,,77776157
19,58545433,20566,ZSCAN1,8,,58565999
19,19174802,49039,SLC25A42,8,,19223841
19,37825525,29833,HKR1,8,,37855358
2,179694483,220303,CCDC141,8,,179914786
3,120405527,55857,RABL3,8,,120461384
3,155480400,43676,C3orf33,8,,155524076
3,9879532,6170,RPUSD3,8,,9885702
4,154631311,50076,RNF175,8,,154681387
5,41904445,17293,C5orf51,8,,41921738
6,31021226,6429,HCG22,8,,31027655
8,144766621,10934,ZNF707,8,,144777555
8,101145587,12512,FBXO43,8,,101158099
3,71728439,75095,EIF4E3,8,,71803534
14,99977602,93125,CCDC85C,8,,100070727
11,7041699,51058,NLRP14,8,,7092757
12,8666135,8825,CLEC4D,8,,8674960
11,369794,12323,B4GALNT4,8,,382117
19,37001588,17660,ZNF260,8,,37019248
19,40502942,24006,ZNF546,8,,40526948
19,1505016,8172,ADAMTSL5,8,,1513188
1,162824086,14519,C1orf110,8,,162838605
5,149675901,6624,ARSI,8,,149682525
7,7398243,177217,COL28A1,8,,7575460
7,134671258,149272,AGBL3,8,,134820530
X,111873878,49497,LHFPL1,8,,111923375
10,19337699,685708,MALRD1,8,,20023407
11,17568919,98572,OTOG,8,,17667491
15,51633712,66497,GLDN,8,,51700209
19,58838384,15328,ZSCAN22,8,,58853712
1,196194909,382652,KCNT2,8,,196577561
6,116937641,16507,RSPH4A,8,,116954148
7,100839011,5291,MOGAT3,8,,100844302
X,130678047,927,OR13H1,8,,130678974
16,88772870,8916,CTU2,8,,88781786
1,152595309,270,LCE3A,8,,152595579
12,11338598,945,TAS2R42,8,,11339543
1,17698690,29505,PADI6,8,,17728195
Y,16168101,737,VCY1B,8,,16168838
20,31643136,18307,BPIFB3,8,,31661443
9,138515501,15885,GLT6D1,8,,138531386
10,115614390,57875,NHLRC2,8,,115672265
19,41931263,3372,B3GNT8,8,,41934635
1,43272722,10337,CCDC23,8,,43283059
1,226736500,60415,C1orf95,8,,226796915
3,52870771,60826,TMEM110,8,,52931597
6,87992696,46300,GJB7,8,,88038996
9,140354403,90618,PNPLA7,8,,140445021
6,28209482,10592,ZKSCAN4,8,,28220074
12,48577365,2344,CCDC184,8,,48579709
17,11144739,322641,SHISA6,8,,11467380
17,42977079,3968,CCDC103,8,,42981047
17,57409052,70043,YPEL2,8,,57479095
17,59489111,1530,C17orf82,8,,59490641
19,35978225,3208,KRTDAP,8,,35981433
1,48226199,236363,TRABD2B,8,,48462562
5,43039181,1266,ANXA2R,8,,43040447
6,30899126,826,SFTA2,8,,30899952
9,140063211,1280,LRRC26,8,,140064491
X,19378175,155204,MAP3K15,8,,19533379
19,1554667,13390,MEX3D,8,,1568057
2,186603621,94395,FSIP2,8,,186698016
4,71384288,14172,AMTN,8,,71398460
4,120217573,4395,C4orf3,8,,120221968
5,63801773,106348,RGS7BP,8,,63908121
6,21666674,527942,CASC15,8,,22194616
8,119201694,432490,SAMD12,8,,119634184
22,26879849,8055,SRRD,8,,26887904
9,138585254,6120,SOHLH1,8,,138591374
12,58218391,84,MIR26A2,8,,58218475
10,75669726,12809,C10orf55,8,,75682535
12,9570286,30482,DDX12P,8,,9600768
15,28899587,30823,HERC2P9,8,,28930410
1,13182959,1367,HNRNPCL2,8,,13184326
1,114419435,10734,BCL2L15,8,,114430169
X,134154533,2033,FAM127C,8,,134156566
6,29053984,1106,OR2B3,8,,29055090
14,101340829,93,MIR337,8,,101340922
9,70856860,58091,CBWD3,8,,70914951
10,50117528,4752,LRRC18,8,,50122280
2,53994919,7414,CHAC2,8,,54002333
X,85158640,72,MIR361,8,,85158712
8,7669241,3997,DEFB107B,8,,7673238
8,7682693,3882,DEFB106B,8,,7686575
14,101521755,73,MIR485,8,,101521828
12,95228173,116,MIR492,8,,95228289
14,101335396,89,MIR493,8,,101335485
19,13985688,137,MIR181D,8,,13985825
19,54215521,87,MIR517A,8,,54215608
19,54255650,85,MIR519A1,8,,54255735
X,137749871,83,MIR504,8,,137749954
15,75118950,5186,CPLX3,8,,75124136
19,41883168,6819,TMEM91,8,,41889987
1,12907229,1006,HNRNPCL3,8,,12908235
5,69515015,366614,GUSBP3,8,,69881629
1,161228516,26724,PCP4L1,8,,161255240
7,72634673,15306,NCF1B,8,,72649979
2,234184371,278,SCARNA5,8,,234184649
17,17717149,96,MIR33B,8,,17717245
22,23165269,96,MIR650,8,,23165365
8,128455594,38790,CASC8,8,,128494384
2,147344624,3934,PABPC1P2,8,,147348558
2,218148745,472571,DIRC3,8,,218621316
16,12995476,338797,SHISA9,8,,13334273
14,23887195,77,MIR208B,8,,23887272
17,29902429,111,MIR365B,8,,29902540
19,7694670,1840,PET100,8,,7696510
1,149369293,9010,FCGR1C,8,,149378303
6,41755180,2454,TOMM6,8,,41757634
10,37890365,1494,MTRNR2L7,8,,37891859
1,231664398,512621,TSNAX-DISC1,8,,232177019
5,79945818,1036,MTRNR2L2,8,,79946854
20,55933495,1383,MTRNR2L3,8,,55934878
16,3421052,1231,MTRNR2L4,8,,3422283
7,142374130,1395,MTRNR2L6,8,,142375525
11,10529433,1290,MTRNR2L8,8,,10530723
6,62284007,527,MTRNR2L9,8,,62284534
X,55207823,1121,MTRNR2L10,8,,55208944
X,148855725,2792,HSFX1,8,,148858517
3,64670545,326598,ADAMTS9-AS2,8,,64997143
1,156182778,30345,PMF1-BGLAP,8,,156213123
17,41102542,30003,PTGES3L-AARSD1,8,,41132545
12,50366619,4303,AQP6,7,,50370922
X,139865424,1299,CDR1,7,,139866723
11,6260321,5386,CNGA4,7,,6265707
X,153498929,24635,TEX28,7,,153523564
8,39308563,71945,ADAM3A,7,,39380508
9,123363195,113570,MEGF9,7,,123476765
17,7342345,5906,FGF11,7,,7348251
22,18761201,18273,GGT3P,7,,18779474
8,143916216,12046,GML,7,,143928262
16,215972,795,HBM,7,,216767
19,49570674,5524,KCNA7,7,,49576198
6,168418552,27217,KIF25,7,,168445769
8,144239330,2723,LY6H,7,,144242053
X,151282520,3891,MAGEA5,7,,151286411
X,30248552,7058,MAGEB3,7,,30255610
16,56651372,1358,MT1L,7,,56652730
X,92925924,2758,NAP1L3,7,,92928682
16,3254246,939,OR1F1,7,,3255185
10,118350470,18217,PNLIPRP1,7,,118368687
3,186505087,135,SNORA63,7,,186505222
1,153112593,1376,SPRR2C,7,,153113969
6,167786576,11422,TCP10,7,,167797998
19,21473962,38250,ZNF708,7,,21512212
16,3355405,13171,ZNF75A,7,,3368576
19,20188802,43175,ZNF90,7,,20231977
19,9676403,18806,ZNF121,7,,9695209
19,58944180,7409,ZNF132,7,,58951589
19,58207642,12937,ZNF154,7,,58220579
X,47229998,43100,ZNF157,7,,47273098
19,44617514,21455,ZNF225,7,,44638969
15,25230006,3373,PWAR5,7,,25233379
19,38701645,13245,DPF1,7,,38714890
X,153237990,10656,TMEM187,7,,153248646
4,119201192,72730,PRSS12,7,,119273922
10,81679933,2942,MBL1P,7,,81682875
5,140767451,125095,PCDHGB4,7,,140892546
11,6642554,34526,DCHS1,7,,6677080
17,39576808,4014,KRT37,7,,39580822
8,24298508,68569,ADAM7,7,,24367077
Y,16168097,741,VCY,7,,16168838
X,144908927,2443,TMEM257,7,,144911370
16,15031299,14632,NPIPA1,7,,15045931
1,174417211,1472,GPR52,7,,174418683
X,73012039,37027,TSIX,7,,73049066
3,38347426,12640,SLC22A14,7,,38360066
11,68503599,15389,MTL5,7,,68518988
5,140771482,3488,PCDHGA8,7,,140774970
7,143050492,9348,FAM131B,7,,143059840
6,28356726,10818,ZSCAN12,7,,28367544
X,12156584,586058,FRMPD4,7,,12742642
7,26572739,5705,KIAA0087,7,,26578444
7,28992973,5056,TRIL,7,,28998029
14,102829248,102760,TECPR2,7,,102932008
1,153901976,17178,DENND4B,7,,153919154
2,68961912,92045,ARHGAP25,7,,69053957
6,25754926,26477,SLC17A4,7,,25781403
3,44666510,23453,ZNF197,7,,44689963
16,21652604,11383,IGSF6,7,,21663987
21,39426312,67142,DSCR4,7,,39493454
12,64173905,29433,TMEM5,7,,64203338
22,46651559,7660,PKDREJ,7,,46659219
17,67144147,96809,ABCA10,7,,67240956
17,18647325,35337,FBXW10,7,,18682662
4,151503076,2769,MAB21L2,7,,151505845
11,61957709,3300,SCGB1D1,7,,61961009
4,110749149,16712,RRH,7,,110765861
6,42896867,10158,CNPY3,7,,42907025
4,37962055,576,PTTG2,7,,37962631
17,43037060,8584,C1QL1,7,,43045644
16,90122973,19365,PRDM7,7,,90142338
15,40091222,121871,GPR176,7,,40213093
2,105858199,1725,GPR45,7,,105859924
20,43935482,10982,RBPJL,7,,43946464
9,99516830,23581,ZNF510,7,,99540411
7,129710348,65212,KLHDC10,7,,129775560
6,83777384,100806,DOPEY1,7,,83878190
12,100463685,72957,UHRF1BP1L,7,,100536642
14,45431392,112242,FAM179B,7,,45543634
16,21413454,23204,NPIPB3,7,,21436658
5,177540555,12552,N4BP3,7,,177553107
11,58939811,36249,DTX4,7,,58976060
12,65218351,56447,TBC1D30,7,,65274798
16,30789775,8765,ZNF629,7,,30798540
12,49932939,19156,KCNH3,7,,49952095
X,119495939,21165,ATP1B4,7,,119517104
11,5172660,939,OR52A1,7,,5173599
22,16256331,31606,POTEH,7,,16287937
12,50017196,21256,PRPF40B,7,,50038452
22,29454659,3248,C22orf31,7,,29457907
19,58978411,6534,ZNF324,7,,58984945
19,37341777,28700,ZNF345,7,,37370477
5,59783539,59945,PART1,7,,59843484
16,8889036,2469,TMEM186,7,,8891505
11,35453375,94204,PAMR1,7,,35547579
1,248020500,22938,TRIM58,7,,248043438
1,161952981,41274,OLFML2B,7,,161994255
10,116853123,78003,ATRNL1,7,,116931126
5,138205078,5979,LRRTM2,7,,138211057
16,4798392,18827,ZNF500,7,,4817219
5,150560612,43042,CCDC69,7,,150603654
17,61086897,418170,TANC2,7,,61505067
14,104605059,42176,KIF26A,7,,104647235
9,114089762,951,OR2K2,7,,114090713
X,49178515,116083,GAGE2E,7,,49294598
17,7481272,137,SNORA67,7,,7481409
3,169755734,47449,GPR160,7,,169803183
14,96117514,22275,TCL6,7,,96139789
9,33240161,8404,SPINK4,7,,33248565
8,65492794,3397,BHLHE22,7,,65496191
11,130096573,88034,ZBTB44,7,,130184607
3,112709799,10422,GTPBP8,7,,112720221
5,140430960,2587,PCDHB1,7,,140433547
8,30853317,37914,PURG,7,,30891231
X,152224765,4062,PNMA3,7,,152228827
7,127233688,8163,FSCN3,7,,127241851
6,125596495,26787,HDDC2,7,,125623282
17,18684307,25719,TVP23B,7,,18710026
1,15802595,15300,CELA2B,7,,15817895
8,75736771,30508,PI15,7,,75767279
17,58029722,12395,RNFT1,7,,58042117
7,64434829,16585,ZNF117,7,,64451414
1,172502257,78718,SUCO,7,,172580975
11,67286417,4482,CABP2,7,,67290899
16,55794510,14316,CES1P1,7,,55808826
X,31089357,813,FTHL17,7,,31090170
21,43919741,81809,SLC37A1,7,,44001550
10,5920049,11811,ANKRD16,7,,5931860
10,88854952,96270,FAM35A,7,,88951222
1,48761043,176837,SPATA6,7,,48937880
10,97803158,17467,CCNJ,7,,97820625
5,140613904,3197,PCDHB18,7,,140617101
5,140535579,2411,PCDHB17,7,,140537990
1,27205872,10997,GPN2,7,,27216869
6,26421618,9198,BTN2A3P,7,,26430816
5,132332676,29620,ZCCHC10,7,,132362296
5,102421703,34139,GIN1,7,,102455842
4,106473776,128294,ARHGEF38,7,,106602070
15,69606741,93235,PAQR5,7,,69699976
9,140172279,4814,TOR4A,7,,140177093
17,36956686,24917,CWC25,7,,36981603
X,106045918,73459,TBC1D8B,7,,106119377
16,3432080,18985,ZSCAN32,7,,3451065
1,1017197,34539,C1orf159,7,,1051736
22,46663860,26045,TTC38,7,,46689905
1,223408251,129293,SUSD4,7,,223537544
1,15479027,67947,TMEM51,7,,15546974
19,41937222,8259,ATP5SL,7,,41945481
17,33737940,22255,SLFN12,7,,33760195
12,8373855,6359,FAM90A1,7,,8380214
3,186263855,24477,TBCCD1,7,,186288332
18,56529831,123881,ZNF532,7,,56653712
11,66357639,2915,CCDC87,7,,66360554
19,48835612,31882,TMEM143,7,,48867494
X,106305117,56940,RBM41,7,,106362057
4,37455551,139581,C4orf19,7,,37595132
19,56652534,19728,ZNF444,7,,56672262
12,13093708,9610,GPRC5D,7,,13103318
X,63487960,127373,MTMR8,7,,63615333
X,46306623,27451,KRBOX4,7,,46334074
20,49411430,82284,BCAS4,7,,49493714
20,45128268,13930,ZNF334,7,,45142198
1,32671235,3053,IQCC,7,,32674288
17,27082995,86862,FAM222B,7,,27169857
4,148538538,18134,TMEM184C,7,,148556672
5,59892738,103255,DEPDC1B,7,,59995993
5,140864740,27806,PCDHGC4,7,,140892546
5,140777694,114852,PCDHGB5,7,,140892546
5,140739702,152844,PCDHGB2,7,,140892546
5,140782519,110027,PCDHGA9,7,,140892546
5,140753650,138896,PCDHGA6,7,,140892546
5,140743897,148649,PCDHGA5,7,,140892546
5,140723600,168946,PCDHGA3,7,,140892546
5,140710251,182295,PCDHGA1,7,,140892546
5,140529602,3266,PCDHB6,7,,140532868
15,52873517,70730,FAM214A,7,,52944247
X,102470019,2109,BEX4,7,,102472128
9,135457992,7648,BARHL1,7,,135465640
15,71173680,11092,THAP10,7,,71184772
19,47906374,16411,MEIS3,7,,47922785
2,228474805,23231,C2orf83,7,,228498036
17,17206679,44298,NT5M,7,,17250977
19,4278597,12123,SHD,7,,4290720
14,96505660,54648,C14orf132,7,,96560308
4,81118656,6826,PRDM8,7,,81125482
6,144326052,3815,HYMAI,7,,144329867
10,101419262,51740,ENTPD7,7,,101471002
3,192958916,29728,HRASLS,7,,192988644
17,34261521,9193,LYZL6,7,,34270714
22,26825279,15699,ASPHD2,7,,26840978
4,53578620,1685,DANCR,7,,53580305
20,19193289,510252,SLC24A3,7,,19703541
3,44790235,12938,KIAA1143,7,,44803173
1,110049445,2891,AMIGO1,7,,110052336
19,12686919,34704,ZNF490,7,,12721623
5,143550436,306508,KCTD16,7,,143856944
15,85359910,56803,ALPK3,7,,85416713
7,148823507,56611,ZNF398,7,,148880118
1,159896828,18558,IGSF9,7,,159915386
18,30252635,100339,KLHL14,7,,30352974
4,186080815,44367,CFAP97,7,,186125182
20,2673523,67231,EBF4,7,,2740754
1,45482075,190175,ZSWIM5,7,,45672250
1,33231234,9337,KIAA1522,7,,33240571
6,56911329,8708,KIAA1586,7,,56920037
15,65673824,41586,IGDCC4,7,,65715410
1,169364107,32605,CCDC181,7,,169396712
12,55413728,10073,NEUROD4,7,,55423801
8,146102335,24511,ZNF250,7,,146126846
6,31683132,2449,LY6G6D,7,,31685581
16,11367055,397,PRM3,7,,11367452
11,105008447,2014,CARD18,7,,105010461
15,81293294,3051,MESDC1,7,,81296345
19,54466289,27180,CACNG8,7,,54493469
19,54415990,30979,CACNG7,7,,54446969
X,100333835,17520,TMEM35,7,,100351355
20,58571416,16752,CDH26,7,,58588168
X,44703248,886,DUSP21,7,,44704134
5,159820154,6950,ZBED8,7,,159827104
20,10015646,21764,ANKEF1,7,,10037410
19,42349085,7312,DMRTC2,7,,42356397
1,53925071,8089,DMRTB1,7,,53933160
9,22446839,5633,DMRTA1,7,,22452472
3,47269515,54822,KIF9,7,,47324337
17,30655459,13769,C17orf75,7,,30669228
8,91803920,167710,NECAB1,7,,91971630
14,59930239,1820,GPR135,7,,59932059
1,100503788,45141,HIAT1,7,,100548929
8,21946713,15178,FAM160B2,7,,21961891
11,111749947,4850,C11orf1,7,,111754797
4,109663201,21034,ETNPPL,7,,109684235
18,2537523,33979,METTL4,7,,2571502
17,42219269,20575,C17orf53,7,,42239844
7,134850531,5047,C7orf49,7,,134855578
1,26158403,27546,AUNIP,7,,26185949
7,42948871,2818,C7orf25,7,,42951689
2,120975046,5938,TMEM185B,7,,120980984
7,86825477,23837,TMEM243,7,,86849314
20,2462465,42703,ZNF343,7,,2505168
19,44100737,3850,ZNF576,7,,44104587
19,7069470,18508,ZNF557,7,,7087978
19,36428021,8076,LRFN3,7,,36436097
1,231041986,72632,TTC13,7,,231114618
19,17402939,11343,ABHD8,7,,17414282
19,17337012,3016,OCEL1,7,,17340028
1,150245182,8153,C1orf54,7,,150253335
16,1578741,26840,TMEM204,7,,1605581
3,122458843,53823,HSPBAP1,7,,122512666
1,220863627,8872,C1orf115,7,,220872499
16,67233027,4900,ELMO3,7,,67237927
5,94041241,376329,MCTP1,7,,94417570
1,222695601,25843,HHIPL2,7,,222721444
5,71616193,38987,PTCD2,7,,71655180
14,92047117,151313,CATSPERB,7,,92198430
18,6834431,81281,ARHGAP28,7,,6915712
16,18995608,79654,TMC7,7,,19075262
16,10479911,97584,ATF7IP2,7,,10577495
19,52516576,15104,ZNF614,7,,52531680
22,38480895,25781,BAIAP2L2,7,,38506676
14,74486058,46738,CCDC176,7,,74532796
18,77662419,49234,PQLC1,7,,77711653
19,21203425,39427,ZNF430,7,,21242852
10,134145740,49270,LRRC27,7,,134195010
5,176873795,9492,PRR7,7,,176883287
1,1260142,4134,CPTP,7,,1264276
2,120436742,2952,TMEM177,7,,120439694
1,18081807,71751,ACTL8,7,,18153558
1,32827861,2063,TSSK3,7,,32829924
17,3572016,947,EMC6,7,,3572963
11,125763379,9737,PUS3,7,,125773116
3,46539484,2955,RTP3,7,,46542439
8,11188494,1201,SLC35G5,7,,11189695
11,60467046,16239,MS4A8,7,,60483285
14,75370656,18489,RPS6KL1,7,,75389145
10,46957880,12721,SYT15,7,,46970601
18,48321489,30265,MRO,7,,48351754
17,79609330,6455,TSPAN10,7,,79615785
16,2762418,8134,PRSS27,7,,2770552
5,94994019,24695,SPATA9,7,,95018714
4,147627789,239249,TTC29,7,,147867038
1,62146718,44377,TM2D1,7,,62191095
2,74648849,4033,WDR54,7,,74652882
7,99090853,7078,ZNF394,7,,99097931
12,85430098,208785,LRRIQ1,7,,85638883
12,82752275,120741,METTL25,7,,82873016
1,42896000,25938,ZMYND12,7,,42921938
16,57728712,36655,DRC7,7,,57765367
5,80597401,11564,ZCCHC9,7,,80608965
5,139175405,48643,PSD2,7,,139224048
5,93954390,77183,ANKRD32,7,,94031573
16,777245,2470,HAGHL,7,,779715
19,6372443,2818,ALKBH7,7,,6375261
17,8076296,3418,TMEM107,7,,8079714
3,49946301,21144,MON1A,7,,49967445
17,7759998,1211,NAA38,7,,7761209
16,684426,1940,C16orf13,7,,686366
16,691803,6671,FAM195A,7,,698474
17,42088555,3842,TMEM101,7,,42092397
1,63988971,49393,EFCAB7,7,,64038364
1,173837434,18340,ZBTB37,7,,173855774
6,159590428,102712,FNDC1,7,,159693140
10,74694519,20058,PLA2G12B,7,,74714577
5,40841409,14047,CARD6,7,,40855456
8,33228343,102321,FUT10,7,,33330664
19,51300949,7161,C19orf48,7,,51308110
9,134165080,19569,PPAPDC3,7,,134184649
1,48998526,1491100,AGBL4,7,,50489626
3,100328432,85891,GPR128,7,,100414323
17,71203491,25042,FAM104A,7,,71228533
8,124232195,21443,C8orf76,7,,124253638
9,139690789,11404,CCDC183,7,,139702193
10,134973970,65946,KNDC1,7,,135039916
15,40650435,12822,DISP2,7,,40663257
4,153864134,36714,FHDC1,7,,153900848
9,6328348,3552,TPD52L3,7,,6331900
19,55043908,13116,KIR3DX1,7,,55057024
20,43991739,13703,SYS1,7,,44005442
1,11979644,6841,KIAA2013,7,,11986485
19,58193336,7833,ZNF551,7,,58201169
19,14198657,2730,SAMD1,7,,14201387
Y,3447125,957,TGIF2LY,7,,3448082
18,56807088,18981,SEC11C,7,,56826069
X,55246779,3762,PAGE5,7,,55250541
9,7796490,3316,TMEM261,7,,7799806
22,20778873,13273,SCARF2,7,,20792146
22,50941375,4760,LMF2,7,,50946135
19,37127522,30233,ZNF461,7,,37157755
19,37672480,28971,ZNF585B,7,,37701451
16,30565084,4558,ZNF764,7,,30569642
2,216946588,20918,TMEM169,7,,216967506
16,82031250,13843,SDR42E1,7,,82045093
10,46110948,57313,ZFAND4,7,,46168261
4,100467863,17351,TRMT10A,7,,100485214
12,1901122,126748,CACNA2D4,7,,2027870
22,42896584,11982,SERHL,7,,42908566
2,73169164,129801,SFXN5,7,,73298965
2,111222627,8025,LIMS3,7,,111230652
14,31915242,11438,DTD2,7,,31926680
6,111279762,9329,GTF3C6,7,,111289091
2,87754973,66057,LINC00152,7,,87821030
22,45277042,128767,PHF21B,7,,45405809
17,41363845,8212,TMEM106A,7,,41372057
11,196760,3498,ODF3,7,,200258
7,150026937,2874,ZBED6CL,7,,150029811
19,50452249,12180,SIGLEC11,7,,50464429
5,176022802,14329,GPRIN1,7,,176037131
12,126106997,39926,TMEM132B,7,,126146923
1,15573767,150855,FHAD1,7,,15724622
4,15341559,106232,C1QTNF7,7,,15447791
16,2933195,16188,FLYWCH2,7,,2949383
9,116638561,180314,ZNF618,7,,116818875
1,58946390,66081,OMA1,7,,59012471
7,1094910,3995,GPR146,7,,1098905
16,24857183,65766,SLC5A11,7,,24922949
2,189598464,56367,DIRC1,7,,189654831
8,69242956,205106,C8orf34,7,,69448062
11,68747489,966,MRGPRD,7,,68748455
17,79791367,1559,PPP1R27,7,,79792926
5,132209357,1225,LEAP2,7,,132210582
11,3659735,3811,ART5,7,,3663546
6,33689442,25320,IP6K3,7,,33714762
12,12510012,114143,LOH12CR1,7,,12624155
10,124739555,10352,PSTK,7,,124749907
10,48355088,18778,ZNF488,7,,48373866
10,30900707,17940,LYZL2,7,,30918647
10,105232560,6437,CALHM3,7,,105238997
11,92877336,53285,SLC36A4,7,,92930621
12,57316937,11252,SDR9C7,7,,57328189
12,107974633,78786,BTBD11,7,,108053419
12,109715782,31243,FOXN4,7,,109747025
14,105452615,9240,C14orf79,7,,105461855
14,105190533,23129,ADSSL1,7,,105213662
14,74960422,1849,ISCA2,7,,74962271
14,100757447,15437,SLC25A29,7,,100772884
15,102193954,70691,TARSL2,7,,102264645
16,20866246,45434,DCUN1D3,7,,20911680
16,89724211,12655,SPATA33,7,,89736866
16,772581,3892,CCDC78,7,,776473
16,20042806,42294,GPR139,7,,20085100
17,74722911,7052,METTL23,7,,74729963
17,72322350,29609,KIF19,7,,72351959
17,9548853,84150,USP43,7,,9633003
17,4460221,3670,GGT6,7,,4463891
19,9324525,1022,OR7D4,7,,9325547
19,5678424,2483,C19orf70,7,,5680907
19,56407310,36392,NLRP13,7,,56443702
19,56598728,34014,ZNF787,7,,56632742
19,38229202,41028,ZNF573,7,,38270230
19,2900895,17579,ZNF57,7,,2918474
19,44088518,11769,IRGQ,7,,44100287
1,154451953,22573,SHE,7,,154474526
1,110026560,8860,ATXN7L2,7,,110035420
1,154991002,15255,DCST2,7,,155006257
1,225117355,94636,DNAH14,7,,225211991
1,182023704,7143,ZNF648,7,,182030847
1,20512570,9971,UBXN10,7,,20522541
1,231359508,17425,C1orf131,7,,231376933
20,61872135,13757,NKAIN4,7,,61885892
20,36531498,42249,VSTM2L,7,,36573747
20,1514896,23447,SIRPD,7,,1538343
20,23583046,3564,CST9,7,,23586610
20,31619453,12400,BPIFB6,7,,31631853
22,38226861,13492,ANKRD54,7,,38240353
2,48667907,74624,PPP1R21,7,,48742531
2,200793633,26826,TYW5,7,,200820459
2,101086943,12799,NMS,7,,101099742
2,8992819,151060,MBOAT2,7,,9143879
2,96257765,7704,TRIM43,7,,96265469
2,203637872,98836,ICA1L,7,,203736708
2,159027868,285397,CCDC148,7,,159313265
3,19190016,387119,KCNH8,7,,19577135
3,102153858,44827,ZPLD1,7,,102198685
3,42438569,13525,LYZL4,7,,42452094
3,42727010,6928,KLHL40,7,,42733938
3,195924322,13978,ZDHHC19,7,,195938300
3,130279177,116711,COL6A6,7,,130395888
3,186915273,3980,RTP1,7,,186919253
4,135117488,5415,PABPC4L,7,,135122903
4,15004297,67480,CPEB2,7,,15071777
4,57204450,49224,AASDH,7,,57253674
4,87797357,16218,C4orf36,7,,87813575
4,20702035,32144,PACRGL,7,,20734179
5,35960857,40273,UGT3A1,7,,36001130
5,35904397,34340,CAPSL,7,,35938737
5,134181657,13768,C5orf24,7,,134195425
6,84562984,4250,RIPPLY2,7,,84567234
6,79577260,33423,IRAK1BP1,7,,79610683
6,132859426,1049,TAAR9,7,,132860475
6,71276624,21982,C6orf57,7,,71298606
7,148766732,21137,ZNF786,7,,148787869
7,25174315,45502,C7orf31,7,,25219817
8,94712734,28744,FAM92A1,7,,94741478
9,130475941,2014,PTRH1,7,,130477955
X,50108405,105332,DGKK,7,,50213737
X,23352984,61934,PTCHD1,7,,23414918
X,27826106,15025,MAGEB10,7,,27841131
X,62567106,4112,SPIN4,7,,62571218
4,177134825,55548,ASB5,7,,177190373
22,31500762,2789,SELM,7,,31503551
20,30598244,21740,CCM2L,7,,30619984
20,44486219,21550,ZSWIM3,7,,44507769
7,123249076,28858,ASB15,7,,123277934
11,107197071,131501,CWF19L2,7,,107328572
11,18720281,6051,TMEM86A,7,,18726332
11,6866913,954,OR10A5,7,,6867867
11,6806247,998,OR2AG1,7,,6807245
12,75784849,41328,GLIPR1L2,7,,75826177
14,61447831,102620,SLC38A6,7,,61550451
14,77940737,24473,ISM2,7,,77965210
15,100267605,6044,LYSMD4,7,,100273649
15,97326636,2209,SPATA8,7,,97328845
16,67679029,12443,RLTPR,7,,67691472
16,30591993,5099,ZNF785,7,,30597092
16,30581018,2710,ZNF688,7,,30583728
16,5094122,22024,C16orf89,7,,5116146
17,9479943,66833,CFAP52,7,,9546776
17,8633245,14909,CCDC42,7,,8648154
17,33474835,41529,UNC45B,7,,33516364
17,27224798,5291,DHRS13,7,,27230089
17,38975436,17090,TMEM99,7,,38992526
19,58433251,13504,ZNF418,7,,58446755
19,21264952,42931,ZNF714,7,,21307883
19,37902059,56280,ZNF569,7,,37958339
20,57393972,31986,GNAS-AS1,7,,57425958
20,4711927,9387,PRNT,7,,4721314
20,31669317,30240,BPIFB4,7,,31699557
22,30476057,97007,HORMAD2,7,,30573064
22,41255553,2577,DNAJB7,7,,41258130
22,42470254,5188,FAM109B,7,,42475442
2,96991061,3030,ITPRIPL1,7,,96994091
2,217081611,3304,PKI55,7,,217084915
2,28718937,147716,PLB1,7,,28866653
2,153574406,43361,ARL6IP6,7,,153617767
2,202352143,131762,ALS2CR11,7,,202483905
2,220026180,8637,SLC23A3,7,,220034817
3,192514604,121346,MB21D2,7,,192635950
4,82347546,45536,RASGEF1B,7,,82393082
5,82348664,24608,TMEM167A,7,,82373272
5,94890824,49982,ARSK,7,,94940806
5,34839268,60296,TTC23L,7,,34899564
6,37450696,17004,CCDC167,7,,37467700
7,123092235,80767,IQUB,7,,123173002
7,72299951,4635,SBDSP1,7,,72304586
7,73082173,4267,VPS37D,7,,73086440
8,125323158,61782,TMEM65,7,,125384940
X,130192215,31644,ARHGAP36,7,,130223859
X,53449804,8264,RIBC1,7,,53458068
X,69260391,9397,AWAT2,7,,69269788
Y,20893325,42276,HSFY2,7,,20935601
11,93063882,107754,CCDC67,7,,93171636
12,25649250,152246,LMNTD1,7,,25801496
12,119772516,206336,CCDC60,7,,119978852
18,14099941,32548,ZNF519,7,,14132489
19,52839497,30879,ZNF610,7,,52870376
19,53268065,21979,ZNF600,7,,53290044
19,53379424,15175,ZNF320,7,,53394599
19,38085730,19349,ZNF540,7,,38105079
1,152943128,1921,SPRR4,7,,152945049
1,62701836,83247,KANK4,7,,62785083
22,21987085,4531,CCDC116,7,,21991616
2,100889752,49443,LONRF2,7,,100939195
6,84222193,13228,PRSS35,7,,84235421
6,165693152,29959,C6orf118,7,,165723111
9,127563152,14018,OLFML2A,7,,127577170
19,23835707,34310,ZNF675,7,,23870017
11,28129797,225257,METTL15,7,,28355054
11,31453945,77230,IMMP1L,7,,31531175
15,49620591,292527,FAM227B,7,,49913118
19,38874991,3677,GGN,7,,38878668
1,28052489,36934,FAM76A,7,,28089423
2,114256660,2067,FOXD4L1,7,,114258727
3,97705526,48622,GABRR3,7,,97754148
17,17104308,5338,PLD6,7,,17109646
17,79981177,7850,LRRC45,7,,79989027
17,34249481,8299,RDM1,7,,34257780
8,38965047,177389,ADAM32,7,,39142436
9,35658286,3214,CCDC107,7,,35661500
16,20370491,45542,PDILT,7,,20416033
11,58975982,4512,MPEG1,7,,58980494
11,82612736,32963,DDIAS,7,,82645699
18,59482303,78001,RNF152,7,,59560304
10,13263765,12563,UCMA,7,,13276328
6,109615505,13918,CCDC162P,7,,109629423
6,37185417,40514,TMEM217,7,,37225931
6,35704808,11882,ARMC12,7,,35716690
7,99143922,5835,FAM200A,7,,99149757
7,86506222,182792,KIAA1324L,7,,86689014
15,69222838,16312,SPESP1,7,,69239150
4,65144176,131002,TECRL,7,,65275178
1,92495532,33561,EPHX4,7,,92529093
13,45967453,25137,SLC25A30,7,,45992590
14,39865576,36128,FBXO33,7,,39901704
2,99858710,12860,LYG2,7,,99871570
4,186366337,26576,CCDC110,7,,186392913
17,79859984,797,NPB,7,,79860781
5,79407049,144852,SERINC5,7,,79551901
X,21673466,3039,KLHL34,7,,21676505
20,44236577,23330,WFDC9,7,,44259907
12,11285883,960,TAS2R30,7,,11286843
7,72418831,6471,NSUN5P2,7,,72425302
22,30855215,12819,SEC14L3,7,,30868034
22,24033047,8316,RGL4,7,,24041363
X,102192199,1029,RAB40AL,7,,102193228
10,133879470,118843,JAKMIP3,7,,133998313
14,77597612,10522,ZDHHC22,7,,77608134
14,77801363,42089,TMED8,7,,77843452
17,80376251,24265,HEXDC,7,,80400516
17,46839592,54877,TTLL6,7,,46894469
17,7338761,2237,TMEM102,7,,7340998
18,39766632,504757,LINC00907,7,,40271389
19,12075868,15330,ZNF763,7,,12091198
19,54544079,23128,VSTM1,7,,54567207
19,463345,11638,ODF3L2,7,,474983
1,47603096,11430,CYP4A22,7,,47614526
1,109102970,78979,FAM102B,7,,109181949
1,92545861,67540,BTBD8,7,,92613401
1,42846467,43433,RIMKLA,7,,42889900
2,9614657,14096,IAH1,7,,9628753
3,88198892,8223,C3orf38,7,,88207115
3,9987225,6874,PRRT3,7,,9994099
7,128695276,2017,TPI1P2,7,,128697293
19,53770012,906,VN1R4,7,,53770918
21,14982497,31409,POTED,7,,15013906
4,48492268,4138,ZAR1,7,,48496406
19,6952510,38347,EMR4P,7,,6990857
1,113252615,5335,PPM1J,7,,113257950
10,17357412,138974,ST8SIA6,7,,17496386
11,82904780,55233,ANKRD42,7,,82960013
19,46416472,1564,NANOS2,7,,46418036
1,3805696,11161,C1orf174,7,,3816857
1,33086816,29375,ZBTB8OS,7,,33116191
4,189060594,8300,TRIML1,7,,189068894
X,101408678,2308,BEX5,7,,101410986
X,64708614,19153,ZC3H12B,7,,64727767
15,74362197,12694,GOLGA6A,7,,74374891
2,131486642,1267,GPR148,7,,131487909
3,142680073,2105,PAQR9,7,,142682178
3,187416046,4299,RTP2,7,,187420345
5,176827107,530,PFN3,7,,176827637
3,181328121,131892,SOX2-OT,7,,181460013
17,79780236,10934,FAM195B,7,,79791170
7,39773166,61056,LINC00265,7,,39834222
19,55670028,8062,DNAAF3,7,,55678090
19,44764032,15438,ZNF233,7,,44779470
1,39957317,38224,BMP8A,7,,39995541
1,197122813,46859,ZBTB41,7,,197169672
12,103695718,194070,C12orf42,7,,103889788
18,30517365,502680,CCDC178,7,,31020045
19,9401815,18575,ZNF699,7,,9420390
3,196366566,22308,NRROS,7,,196388874
7,75024902,9994,TRIM73,7,,75034896
9,98637899,93223,ERCC6L2,7,,98731122
7,72430015,9982,TRIM74,7,,72439997
Y,24049996,14218,RBMY1B,7,,24064214
22,51007289,14139,CHKB-CPT1B,7,,51021428
4,44175919,274905,KCTD8,7,,44450824
21,46020496,1595,KRTAP10-7,7,,46022091
3,49754266,2972,AMIGO3,7,,49757238
6,170102207,4246,C6orf120,7,,170106453
1,6307405,13630,GPR153,7,,6321035
10,91190050,105263,SLC16A12,7,,91295313
12,105724413,40883,C12orf75,7,,105765296
17,5112215,25940,SCIMP,7,,5138155
19,57078889,15373,ZNF470,7,,57094262
1,6266188,15171,RNF207,7,,6281359
2,85832375,6804,C2orf68,7,,85839179
3,52867130,2105,MUSTN1,7,,52869235
3,171561138,15970,TMEM212,7,,171577108
4,42895282,137393,GRXCR1,7,,43032675
6,3259161,9139,PSMG4,7,,3268300
15,65369153,3123,KBTBD13,7,,65372276
17,3213538,1202,OR3A4P,7,,3214740
1,6304251,1387,HES3,7,,6305638
1,84830640,19844,UOX,7,,84850484
20,52491039,1209,SUMO1P1,7,,52492248
X,71364033,17567,FLJ44635,7,,71381600
19,38880839,9684,SPRED3,7,,38890523
15,38988798,3441,C15orf53,7,,38992239
16,19717673,11819,KNOP1,7,,19729492
20,238376,3360,DEFB132,7,,241736
6,31496738,1270,MCCD1,7,,31498008
6,31730772,1852,SAPCD1,7,,31732624
6,53512698,17808,KLHL31,7,,53530506
7,127990378,11361,PRRT4,7,,128001739
9,115513133,124134,SNX30,7,,115637267
1,183615410,7038,APOBEC4,7,,183622448
19,19366451,7145,HAPLN4,7,,19373596
14,19553364,31578,POTEG,7,,19584942
14,101351038,82,MIR136,7,,101351120
7,157367027,87,MIR153-2,7,,157367114
X,49768108,86,MIR188,7,,49768194
9,131154896,97,MIR219A2,7,,131154993
11,103907307,2615,DDI1,7,,103909922
22,50750391,15098,DENND6B,7,,50765489
2,96789588,14587,ASTL,7,,96804175
11,64981310,12201,SLC22A20,7,,64993511
17,36481492,18201,GPR179,7,,36499693
19,19903519,29041,ZNF506,7,,19932560
19,43256838,12993,PSG8,7,,43269831
7,134233848,30744,AKR1B15,7,,134264592
7,143996613,985,OR2A9P,7,,143997598
20,47894714,11081,ZFAS1,7,,47905795
2,108856447,25360,SULT1C3,7,,108881807
Y,27177049,21202,BPY2B,7,,27198251
Y,27177049,21202,BPY2C,7,,27198251
14,101492068,86,MIR323A,7,,101492154
14,100774195,98,MIR345,7,,100774293
1,152730505,4024,KPRP,7,,152734529
X,154689079,517,H2AFB1,7,,154689596
2,170550963,7255,PHOSPHO2,7,,170558218
14,101528386,69,MIR377,7,,101528455
18,43914186,126597,RNF165,7,,44040783
7,141408152,22919,WEE2,7,,141431071
18,47007547,6097,C18orf32,7,,47013644
1,46669005,17923,LURAP1,7,,46686928
12,74931550,3682,ATXN7L3B,7,,74935232
9,21454266,105431,MIR31HG,7,,21559697
14,101350819,94,MIR432,7,,101350913
19,54205990,83,MIR518B,7,,54206073
19,54216600,88,MIR519D,7,,54216688
X,146312237,124,MIR506,7,,146312361
14,19983953,36319,POTEM,7,,20020272
7,45763385,45232,SEPT7P2,7,,45808617
15,41062158,2490,C15orf62,7,,41064648
5,147715121,4291,SPINK9,7,,147719412
13,103381716,29706,CCDC168,7,,103411422
16,54952776,10325,CRNDE,7,,54963101
5,87836596,144024,LINC00461,7,,87980620
14,56232962,1473,RPL13AP3,7,,56234435
1,121107151,27584,SRGAP2C,7,,121134735
1,149553002,785,PPIAL4B,7,,149553787
17,18380098,18161,LGALS9C,7,,18398259
10,53059332,83,MIR605,7,,53059415
9,140114698,1077,RNF208,7,,140115775
X,148863592,5807,MAGEA9B,7,,148869399
5,70196495,7447,SERF1B,7,,70203942
14,24476217,44369,DHRS4L1,7,,24520586
6,8652441,1639,HULC,7,,8654080
15,25417781,82,SNORD115-2,7,,25417863
15,25420073,82,SNORD115-3,7,,25420155
15,25421978,82,SNORD115-4,7,,25422060
15,25436565,79,SNORD115-5,7,,25436644
15,25425643,82,SNORD115-6,7,,25425725
15,25427531,82,SNORD115-7,7,,25427613
15,25429452,82,SNORD115-8,7,,25429534
15,25436562,82,SNORD115-9,7,,25436644
15,25492491,82,SNORD115-10,7,,25492573
15,25494344,82,SNORD115-11,7,,25494426
15,25436562,82,SNORD115-12,7,,25436644
15,25438467,82,SNORD115-13,7,,25438549
15,25440067,81,SNORD115-14,7,,25440148
15,25451408,26207,SNORD115-15,7,,25477615
15,25444594,82,SNORD115-16,7,,25444676
15,25449503,82,SNORD115-17,7,,25449585
15,25449503,82,SNORD115-18,7,,25449585
15,25449503,82,SNORD115-19,7,,25449585
15,25451408,82,SNORD115-20,7,,25451490
15,25451408,26207,SNORD115-21,7,,25477615
15,25455064,82,SNORD115-22,7,,25455146
15,25456942,82,SNORD115-23,7,,25457024
15,25460687,82,SNORD115-25,7,,25460769
15,25463763,82,SNORD115-26,7,,25463845
15,25494344,82,SNORD115-29,7,,25494426
15,25470349,82,SNORD115-30,7,,25470431
15,25472255,82,SNORD115-31,7,,25472337
15,25474113,82,SNORD115-32,7,,25474195
15,25475984,82,SNORD115-33,7,,25476066
15,25477533,82,SNORD115-34,7,,25477615
15,25479393,82,SNORD115-35,7,,25479475
15,25494344,82,SNORD115-36,7,,25494426
15,25483132,82,SNORD115-37,7,,25483214
15,25484984,82,SNORD115-38,7,,25485066
15,25486892,82,SNORD115-39,7,,25486974
15,25488760,82,SNORD115-40,7,,25488842
15,25490624,82,SNORD115-41,7,,25490706
15,25492491,82,SNORD115-42,7,,25492573
15,25494344,82,SNORD115-43,7,,25494426
15,25496005,82,SNORD115-44,7,,25496087
15,25514929,76,SNORD115-48,7,,25515005
5,136983260,78,MIR874,7,,136983338
10,43008960,39358,ZNF37BP,7,,43048318
X,148855729,2799,HSFX2,7,,148858528
11,10329859,122361,CAND1.11,7,,10452220
4,53609683,8124,ERVMER34-1,7,,53617807
7,148959261,22824,ZNF783,7,,148982085
10,65132716,92,MIR1296,7,,65132808
2,25551508,82,MIR1301,7,,25551590
1,19223564,78,MIR1290,7,,19223642
5,114914192,47684,TMED7-TICAM2,7,,114961876
7,27240039,6839,HOTTIP,7,,27246878
22,23229959,8054,IGLL5,7,,23238013
17,44416763,22371,ARL17B,7,,44439134
16,87336404,14622,C16orf95,7,,87351026
6,133823389,386755,TARID,7,,134210144
3,9834231,43809,ARPC4-TTLL3,7,,9878040
11,66384052,29892,RBM14-RBM4,7,,66413944
18,47007547,10407,RPL17-C18orf32,7,,47017954
14,24683142,18449,NEDD8-MDP1,7,,24701591
16,4390251,76711,CORO7-PAM16,7,,4466962
14,65381078,148295,CHURC1-FNTB,7,,65529373
18,54721803,17547,LINC-ROR,7,,54739350
15,21040700,30943,POTEB,7,,21071643
5,134368969,311401,C5orf66,7,,134680370
10,50723150,24019,ERCC6-PGBD3,7,,50747169
17,69093914,104406,CASC17,7,,69198320
5,55807220,94839,LOC101928448,7,,55902059
2,150443871,260877,LOC101929231,7,,150704748
12,9381128,5675,A2MP1,6,,9386803
17,40996608,6116,AOC2,6,,41002724
19,45430059,4584,APOC1P1,6,,45434643
1,47901688,4675,FOXD2,6,,47906363
8,144349606,9495,GLI4,6,,144359101
8,142366586,10779,GPR20,6,,142377365
19,51273720,1269,GPR32,6,,51274989
6,30227338,7390,HLA-L,6,,30234728
10,124907637,2551,HMX2,6,,124910188
15,74466086,3126,ISLR,6,,74469212
8,99439249,3774,KCNS2,6,,99443023
12,52787734,12442,KRT82,6,,52800176
11,2908574,16601,SLC22A18AS,6,,2925175
5,22142460,9919,PMCHL1,6,,22152379
7,72476643,15064,PMS2L2,6,,72491707
7,66757422,10007,PMS2P4,6,,66767429
22,29834571,3873,RFPL1,6,,29838444
20,62171276,7581,SRMS,6,,62178857
20,584636,6274,TCF15,6,,590910
1,236305831,66378,GPR137B,6,,236372209
22,24083770,9509,ZNF70,6,,24093279
19,44455396,16356,ZNF221,6,,44471752
12,133656788,27470,ZNF140,6,,133684258
6,28234787,11213,ZSCAN26,6,,28246000
11,6947653,31625,ZNF215,6,,6979278
19,44556163,15984,ZNF223,6,,44572147
19,44830705,30151,ZNF112,6,,44860856
9,103235519,104399,TMEFF1,6,,103339918
11,6815755,1384,OR6A2,6,,6817139
12,57345214,7944,RDH16,6,,57353158
11,96123157,3570,JRKL,6,,96126727
16,725665,2603,RHBDL1,6,,728268
Y,24636543,24241,PRY,6,,24660784
3,42589458,53114,SEC22C,6,,42642572
12,86198330,31988,RASSF9,6,,86230318
15,65619464,50914,IGDCC3,6,,65670378
16,31085742,9091,ZNF646,6,,31094833
14,106383837,14665,KIAA0125,6,,106398502
8,1922043,33066,KBTBD11,6,,1955109
1,22328148,10887,CELA3A,6,,22339035
19,58452200,6877,ZNF256,6,,58459077
2,73441365,12990,SMYD5,6,,73454355
1,156374043,25297,C1orf61,6,,156399340
22,32753853,3295,RFPL3,6,,32757148
9,125670334,5273,ZBTB6,6,,125675607
18,32870235,20495,ZNF271P,6,,32890730
20,44141100,3164,SPINT3,6,,44144264
1,186369703,884,OCLM,6,,186370587
5,69423288,98334,SMA4,6,,69521622
1,70820492,13213,HHLA3,6,,70833705
9,5163862,21756,INSL6,6,,5185618
12,57610577,9655,NXPH4,6,,57620232
2,139426726,111085,NXPH2,6,,139537811
3,164904507,10133,SLITRK3,6,,164914640
15,34671269,10732,GOLGA8A,6,,34682001
5,159990126,289093,ATP10B,6,,160279219
10,96162185,133904,TBC1D12,6,,96296089
14,77253585,25698,ANGEL1,6,,77279283
19,43853207,493,PRG1,6,,43853700
22,17134598,21832,ANKRD62P1-PARP4P3,6,,17156430
11,35639734,2687,FJX1,6,,35642421
16,1271650,3604,TPSG1,6,,1275254
20,25653830,23710,ZNF337,6,,25677540
1,247920763,945,OR1C1,6,,247921708
22,18958010,24132,DGCR5,6,,18982142
12,4829751,52141,GALNT8,6,,4881892
19,14991237,930,OR7A17,6,,14992167
11,7960122,945,OR10A3,6,,7961067
6,29393280,2229,OR11A1,6,,29395509
19,15852202,951,OR10H3,6,,15853153
X,7810302,1882,VCX,6,,7812184
19,9361719,1020,OR7E24,6,,9362739
19,15052300,960,OR7C2,6,,15053260
19,14909985,963,OR7C1,6,,14910948
15,102462344,918,OR4F4,6,,102463262
9,125273080,942,OR1J2,6,,125274022
X,118921315,132,SNORA69,6,,118921447
6,86387011,75,SNORD50A,6,,86387086
9,136216250,75,SNORD24,6,,136216325
19,44889807,15970,ZNF285,6,,44905777
8,110975873,12203,KCNV1,6,,110988076
5,137225124,51032,PKD2L2,6,,137276156
12,6930962,5621,GPR162,6,,6936583
20,44002519,4438,TP53TG5,6,,44006957
22,17597188,5069,CECR6,6,,17602257
18,59000814,222192,CDH20,6,,59223006
16,9185536,28019,C16orf72,6,,9213555
4,25314395,57610,ZCCHC4,6,,25372005
3,38035077,13599,VILL,6,,38048676
14,24608173,2624,EMC9,6,,24610797
3,8661085,25399,SSUH2,6,,8686484
1,156698262,8490,RRNAD1,6,,156706752
3,42623331,13159,SS18L2,6,,42636490
9,21967137,616,CDKN2A-AS1,6,,21967753
2,241418838,78600,ANKMY1,6,,241497438
19,362056,13957,THEG,6,,376013
2,88326721,28599,KRCC1,6,,88355320
19,12778880,1585,WDR83OS,6,,12780465
11,61129472,7503,TMEM138,6,,61136975
19,56154985,2004,ZNF581,6,,56156989
11,68028802,10667,C11orf24,6,,68039469
21,47706243,6192,YBEY,6,,47712435
21,34144410,25606,C21orf62-AS1,6,,34170016
21,45917774,213721,TSPEAR,6,,46131495
X,53078505,31291,GPR173,6,,53109796
2,67624441,13092,ETAA1,6,,67637533
1,100598705,17349,TRMT13,6,,100616054
2,190526124,9433,ASNSD1,6,,190535557
19,305574,39267,MIER2,6,,344841
1,152486977,1504,CRCT1,6,,152488481
12,118501397,40413,VSIG10,6,,118541810
1,232940637,5455,MAP10,6,,232946092
19,9759337,26439,ZNF562,6,,9785776
15,41107642,13265,PPP1R14D,6,,41120907
9,140260596,57118,EXD3,6,,140317714
X,134290460,15291,CT55,6,,134305751
11,63320241,10614,HRASLS2,6,,63330855
16,20420855,31426,ACSM5,6,,20452281
19,1275519,3724,C19orf24,6,,1279243
X,119392504,52887,TMEM255A,6,,119445391
3,112280856,22428,SLC35A5,6,,112303284
20,18364010,83819,DZANK1,6,,18447829
11,71639767,68876,RNF121,6,,71708643
10,15085894,29957,OLAH,6,,15115851
20,56807832,76663,PPP4R1L,6,,56884495
12,69139935,19918,SLC35E3,6,,69159853
4,169137441,102517,DDX60,6,,169239958
13,111545038,22416,ANKRD10,6,,111567454
14,102783713,25798,ZNF839,6,,102809511
6,170151717,29963,ERMARD,6,,170181680
4,186285031,15121,LRP2BP,6,,186300152
16,67840780,21191,TSNAXIP1,6,,67861971
17,62224792,115891,TEX2,6,,62340683
15,72947037,12701,GOLGA6B,6,,72959738
5,140787769,104777,PCDHGB6,6,,140892546
5,140749830,142716,PCDHGB3,6,,140892546
5,140729827,162719,PCDHGB1,6,,140892546
5,140792742,99804,PCDHGA10,6,,140892546
5,140734591,157955,PCDHGA4,6,,140892546
5,140805852,1973,PCDHGB8P,6,,140807825
8,30689059,17474,TEX15,6,,30706533
13,25338300,115758,RNF17,6,,25454058
X,134021655,27719,MOSPD1,6,,134049374
11,8959118,5462,ASCL3,6,,8964580
11,64051810,5162,GPR137,6,,64056972
1,109633402,6152,TMEM167B,6,,109639554
7,4897368,4257,PAPOLB,6,,4901625
17,10600926,13949,ADPRM,6,,10614875
3,146151074,36014,PLSCR2,6,,146187088
1,247108848,62547,ZNF695,6,,247171395
19,11504731,25287,RGL3,6,,11530018
6,88032305,19741,SMIM8,6,,88052046
14,77648101,77737,TMEM63C,6,,77725838
15,75192327,6908,FAM219B,6,,75199235
10,38117692,29320,ZNF248,6,,38147012
3,42734154,10165,HHATL,6,,42744319
3,128689781,23205,KIAA1257,6,,128712986
17,16524047,33120,ZNF624,6,,16557167
16,58028571,5191,ZNF319,6,,58033762
12,13197314,39069,KIAA1467,6,,13236383
19,22817125,33347,ZNF492,6,,22850472
19,39797456,8520,LRFN1,6,,39805976
20,61924537,37748,COL20A1,6,,61962285
19,57631508,11785,USP29,6,,57643293
19,36825354,44751,ZFP14,6,,36870105
2,98121260,85168,ANKRD36B,6,,98206428
5,143191725,8559,HMHB1,6,,143200284
19,38826442,35147,CATSPERG,6,,38861589
15,80987651,60311,ABHD17C,6,,81047962
19,54495541,20379,CACNG6,6,,54515920
15,72577067,35220,CELF6,6,,72612287
19,3224701,72372,CELF5,6,,3297073
20,35918050,27613,MANBAL,6,,35945663
6,13786780,28012,MCUR1,6,,13814792
20,58508818,14884,FAM217B,6,,58523702
1,40235196,1824,OXCT2,6,,40237020
12,113900693,9184,LHX5,6,,113909877
10,124750321,17882,IKZF5,6,,124768203
14,23516269,10478,CDH24,6,,23526747
2,74710199,11492,TTC31,6,,74721691
16,1961464,6860,HS3ST6,6,,1968324
19,11466061,10313,LPPR2,6,,11476374
1,40974432,7782,EXO5,6,,40982214
15,56382730,152753,RFX7,6,,56535483
7,94139169,47159,CASD1,6,,94186328
19,15562437,12945,RASAL3,6,,15575382
1,12916940,4824,PRAMEF2,6,,12921764
11,63527363,8750,C11orf95,6,,63536113
16,765172,4483,METRN,6,,769655
17,17942610,29108,GID4,6,,17971718
20,62184372,3688,C20orf195,6,,62188060
7,6629651,18706,C7orf26,6,,6648357
11,62557786,1700,TMEM223,6,,62559486
16,30116130,8748,GDPD3,6,,30124878
16,55358470,6202,IRX6,6,,55364672
3,111311746,2436,ZBED2,6,,111314182
6,132020783,1758,OR2A4,6,,132022541
1,31652591,60143,NKAIN1,6,,31712734
12,81471796,178741,ACSS3,6,,81650537
2,27848505,3240,CCDC121,6,,27851745
3,111805181,31892,C3orf52,6,,111837073
12,123459249,5339,OGFOD2,6,,123464588
22,19833660,8711,C22orf29,6,,19842371
11,124636393,33907,MSANTD2,6,,124670300
3,128720471,39114,EFCC1,6,,128759585
2,225243414,23297,FAM124B,6,,225266711
18,77794345,16307,RBFA,6,,77810652
19,58231118,7877,ZNF671,6,,58238995
1,2252691,70499,MORN1,6,,2323190
9,39072763,215537,CNTNAP3,6,,39288300
10,104209593,1707,C10orf95,6,,104211300
19,812487,9465,LPPR3,6,,821952
15,43425721,51620,TMEM62,6,,43477341
19,2867332,11171,ZNF556,6,,2878503
11,289137,6551,ATHL1,6,,295688
15,102182048,10546,TM2D3,6,,102192594
X,30576940,19093,CXorf21,6,,30596033
8,145754562,76518,ARHGAP39,6,,145831080
22,36113918,11611,APOL5,6,,36125529
1,247693433,3708,OR2C3,6,,247697141
21,45875368,3371,LRRC3,6,,45878739
9,125871772,5984,MIR600HG,6,,125877756
9,116135695,2646,HDHD3,6,,116138341
8,145554227,5716,SCRT1,6,,145559943
8,75912388,34405,CRISPLD1,6,,75946793
17,39279344,1075,KRTAP4-12,6,,39280419
7,75616154,7838,TMEM120A,6,,75623992
16,68334517,10351,SLC7A6OS,6,,68344868
19,16607121,22142,C19orf44,6,,16629263
7,98870923,24671,MYH16,6,,98895594
7,30811032,120970,FAM188B,6,,30932002
9,67926760,43080,ANKRD20A1,6,,67969840
1,27153200,29011,ZDHHC18,6,,27182211
9,95858404,17173,C9orf89,6,,95875577
9,104235439,14064,TMEM246,6,,104249503
19,52901120,20537,ZNF528,6,,52921657
14,100111446,35460,HHIPL1,6,,100146906
19,14800869,30903,ZNF333,6,,14831772
3,169484710,2973,ACTRT3,6,,169487683
14,93669236,4223,C14orf142,6,,93673459
6,99720792,76739,FAXC,6,,99797531
16,56598960,3909,MT4,6,,56602869
13,50234811,30812,EBPL,6,,50265623
11,44087728,17841,ACCS,6,,44105569
2,27346656,7024,ABHD1,6,,27353680
16,67182004,2898,B3GNT9,6,,67184902
19,52374550,16639,ZNF577,6,,52391189
19,18304039,3511,MPV17L2,6,,18307550
19,38187263,22826,ZNF607,6,,38210089
1,211556096,49781,LINC00467,6,,211605877
7,43980493,78300,POLR2J4,6,,44058793
1,45792544,1802,HPDL,6,,45794346
19,56102736,8157,FIZ1,6,,56110893
13,31480311,19398,MEDAG,6,,31499709
8,144680073,2412,TIGD5,6,,144682485
8,12039612,12012,FAM86B1,6,,12051624
2,240115026,2127,MGC16025,6,,240117153
4,4237268,12701,TMEM128,6,,4249969
18,20875978,141955,TMEM241,6,,21017933
11,63273523,10723,LGALS12,6,,63284246
13,100615274,8904,ZIC5,6,,100624178
4,71200670,2163,CABS1,6,,71202833
14,23990063,30795,ZFHX2,6,,24020858
8,66933790,78965,DNAJC5B,6,,67012755
19,8953268,748,MBD3L1,6,,8954016
11,134201767,44451,GLB1L2,6,,134246218
20,44180400,27565,WFDC8,6,,44207965
19,52772823,23153,ZNF766,6,,52795976
3,185207388,9457,TMEM41A,6,,185216845
15,40845111,12145,C15orf57,6,,40857256
17,45908992,6087,LRRC46,6,,45915079
17,45915046,3653,SCRN2,6,,45918699
15,45459411,33962,SHF,6,,45493373
13,32974859,27456,N4BP2L1,6,,33002315
14,24521205,17732,LRRC16B,6,,24538937
14,23765129,6928,PPP1R3E,6,,23772057
7,23636997,47330,CCDC126,6,,23684327
X,55169534,18094,FAM104B,6,,55187628
1,32256022,25630,SPOCD1,6,,32281652
19,20115226,34838,ZNF682,6,,20150064
3,44754134,11189,ZNF502,6,,44765323
19,53898396,16866,ZNF765,6,,53915262
19,53836971,22401,ZNF845,6,,53859372
22,42475694,4594,SMDT1,6,,42480288
6,111580481,9780,KIAA1919,6,,111590261
11,111744779,5402,FDXACB1,6,,111750181
11,111789600,7995,C11orf52,6,,111797595
1,167063326,35040,DUSP27,6,,167098366
1,167599473,76013,RCSD1,6,,167675486
12,128751947,440513,TMEM132C,6,,129192460
1,172389827,48142,C1orf105,6,,172437969
3,140950666,63079,PXYLP1,6,,141013745
X,13336767,1751,ATXN3L,6,,13338518
16,90036182,3058,CENPBD1,6,,90039240
19,7541755,12169,PEX11G,6,,7553924
8,110374705,168795,PKHD1L1,6,,110543500
12,8608590,22336,CLEC6A,6,,8630926
X,37892786,95287,SYTL5,6,,37988073
16,20807661,10134,ERI2,6,,20817795
11,134146274,43184,GLB1L3,6,,134189458
11,61382507,24414,RPLP0P2,6,,61406921
19,1905212,8234,ADAT3,6,,1913446
6,166733215,22879,SFT2D1,6,,166756094
2,71213067,8934,TEX261,6,,71222001
1,35315962,8684,SMIM12,6,,35324646
16,66600349,12689,CMTM1,6,,66613038
21,40969074,15675,B3GALT5-AS1,6,,40984749
5,111496222,1976,EPB41L4A-AS1,6,,111498198
9,116075501,27119,WDR31,6,,116102620
18,56148481,147708,ALPK2,6,,56296189
3,149036284,14975,TM4SF18,6,,149051259
11,3249040,4576,MRGPRE,6,,3253616
6,133090506,29241,SLC18B1,6,,133119747
4,176986984,116995,WDR17,6,,177103979
11,18142501,17526,MRGPRX3,6,,18160027
11,63228875,29805,HRASLS5,6,,63258680
2,114368815,15900,RPL23AP7,6,,114384715
10,99374309,19604,MORN4,6,,99393913
11,111934733,10162,PIH1D2,6,,111944895
11,31391376,63006,DNAJC24,6,,31454382
12,96260825,75603,CCDC38,6,,96336428
12,10323197,21206,TMEM52B,6,,10344403
12,105380097,8408,C12orf45,6,,105388505
12,48733792,10882,ZNF641,6,,48744674
12,54849735,17651,GTSF1,6,,54867386
12,108168161,2260,ASCL4,6,,108170421
12,101869198,11577,SPIC,6,,101880775
14,77860364,29035,NOXRED1,6,,77889399
14,100612752,13260,DEGS2,6,,100626012
16,81087101,23771,C16orf46,6,,81110872
16,49407718,25624,C16orf78,6,,49433342
16,89762764,5357,SPATA2L,6,,89768121
16,4746510,37868,ANKS3,6,,4784378
16,4658883,6044,UBALD1,6,,4664927
16,31724549,48337,ZNF720,6,,31772886
17,43331759,7720,SPATA32,6,,43339479
17,45401326,106750,EFCAB13,6,,45508076
17,39133967,9420,KRT40,6,,39143387
18,13663345,63246,FAM210A,6,,13726591
19,53452631,13533,ZNF816,6,,53466164
19,55861069,5113,COX6B2,6,,55866182
19,53970988,26558,ZNF813,6,,53997546
19,11909390,9916,ZNF491,6,,11919306
19,11457180,8440,CCDC159,6,,11465620
19,4292224,10204,TMIGD2,6,,4302428
19,40022172,1335,EID2B,6,,40023507
19,44111375,12639,ZNF428,6,,44124014
19,18501953,6462,LRRC25,6,,18508415
19,35447257,7696,ZNF792,6,,35454953
1,161068180,1958,KLHDC9,6,,161070138
1,74491701,172170,LRRIQ3,6,,74663871
1,3541555,5139,TPRG1L,6,,3546694
1,24382530,56135,MYOM3,6,,24438665
1,46972667,7219,DMBX1,6,,46979886
1,159504867,930,OR10J5,6,,159505797
1,38273472,1654,C1orf122,6,,38275126
20,43752066,1040,WFDC12,6,,43753106
20,56725982,10201,C20orf85,6,,56736183
20,61147659,20312,MIR1-1HG,6,,61167971
20,33873533,6692,FAM83C,6,,33880225
22,22868060,6564,ZNF280A,6,,22874624
2,99900700,16939,LYG1,6,,99917639
2,55399686,60013,CLHC1,6,,55459699
2,223289225,138116,SGPP2,6,,223427341
2,20096391,5356,TTC32,6,,20101747
2,207804277,29921,CPO,6,,207834198
2,11295497,23501,PQLC3,6,,11318998
3,161214595,7135,OTOL1,6,,161221730
3,184053716,10347,FAM131A,6,,184064063
3,190146444,21221,TMEM207,6,,190167665
3,15451266,17788,METTL6,6,,15469054
4,185009858,129256,ENPP6,6,,185139114
5,40998121,73323,MROH2B,6,,41071444
5,72469022,1948,TMEM174,6,,72470970
7,141951957,5921,PRSS58,6,,141957878
7,76018645,20367,SSC4D,6,,76039012
9,74526422,61949,C9orf85,6,,74588371
X,18189056,49968,BEND2,6,,18239024
X,75002822,2257,MAGEE2,6,,75005079
X,15299830,32851,ASB11,6,,15332681
19,7581003,4908,ZNF358,6,,7585911
1,2938045,1422,ACTRT2,6,,2939467
20,251503,19916,C20orf96,6,,271419
20,62492565,1776,ABHD16B,6,,62494341
20,34114798,2683,C20orf173,6,,34117481
20,49202644,50811,FAM65C,6,,49253455
20,60985292,17337,RBBP8NL,6,,61002629
10,49364601,118340,FRMPD2,6,,49482941
10,93666344,2914,FGFBP3,6,,93669258
10,118423206,6275,C10orf82,6,,118429481
11,35965530,288156,LDLRAD3,6,,36253686
11,74551954,108278,XRRA1,6,,74660232
11,105921824,26641,KBTBD3,6,,105948465
11,108342832,26327,KDELC2,6,,108369159
12,96337070,25300,AMDHD1,6,,96362370
15,93014906,29441,C15orf32,6,,93044347
15,43650369,11889,ZSCAN29,6,,43662258
16,84043271,32491,SLC38A8,6,,84075762
16,10721360,67442,TEKT5,6,,10788802
16,27798849,275981,GSG1L,6,,28074830
16,3482421,11116,ZNF597,6,,3493537
17,8243187,6176,ODF4,6,,8249363
17,41132578,13131,RUNDC1,6,,41145709
17,28903482,61002,LRRC37BP1,6,,28964484
18,21178889,63960,ANKRD29,6,,21242849
19,53517343,2490,ERVV-1,6,,53519833
19,40885177,10951,HIPK4,6,,40896128
19,54663832,13112,TMC4,6,,54676944
19,12428303,16231,ZNF563,6,,12444534
19,47150868,13527,DACT3,6,,47164395
19,56894119,10851,ZNF582,6,,56904970
19,56915382,21018,ZNF583,6,,56936400
19,5455425,1442,ZNRF4,6,,5456867
19,35248978,15156,ZNF599,6,,35264134
19,54976208,8229,CDC42EP5,6,,54984437
1,861120,18841,SAMD11,6,,879961
1,95558072,105089,TMEM56,6,,95663161
1,179712297,73036,FAM163A,6,,179785333
1,47073386,7419,MOB3C,6,,47080805
1,153175905,1696,LELP1,6,,153177601
1,155006281,17125,DCST1,6,,155023406
1,166038535,97457,FAM78B,6,,166135992
1,201857804,3911,SHISA4,6,,201861715
1,44457279,4919,CCDC24,6,,44462198
1,212797788,2332,FAM71A,6,,212800120
22,24105207,2843,C22orf15,6,,24108050
22,42095517,99942,MEI1,6,,42195459
2,99758075,9853,C2orf15,6,,99767928
2,241070241,5506,MYEOV2,6,,241075747
2,96687693,13300,GPAT2,6,,96700993
2,210886144,149950,KANSL1L,6,,211036094
3,42749873,64872,CCDC13,6,,42814745
4,1641607,44111,FAM53A,6,,1685718
5,135170364,53962,SLC25A48,6,,135224326
5,87485449,79247,TMEM161B,6,,87564696
5,145135906,79026,PRELID2,6,,145214932
6,160221280,20456,PNLDC1,6,,160241736
7,112459201,120731,C7orf60,6,,112579932
7,148982371,12032,LOC155060,6,,148994403
7,2727835,28328,AMZ1,6,,2756163
7,73248920,7935,WBSCR27,6,,73256855
7,75039604,6467,NSUN5P1,6,,75046071
8,13424351,1446,C8orf48,6,,13425797
8,73976777,28730,SBSPON,6,,74005507
9,91150015,9447,NXNL2,6,,91159462
9,139638468,4512,LCN6,6,,139642980
10,38645307,22126,HSD17B7P2,6,,38667433
9,114448798,73015,C9orf84,6,,114521813
9,99579272,37117,ZNF782,6,,99616389
X,34147868,2579,FAM47A,6,,34150447
X,26210556,3207,MAGEB6,6,,26213763
X,101394932,2456,TCEAL6,6,,101397388
X,133941222,47419,FAM122C,6,,133988641
12,110972236,48828,PPTC7,6,,111021064
12,111284763,60576,CCDC63,6,,111345339
16,84224722,6050,ADAD2,6,,84230772
19,58053203,18028,ZNF550,6,,58071231
19,12571997,23635,ZNF709,6,,12595632
19,37178513,33725,ZNF567,6,,37212238
19,21906842,43588,ZNF100,6,,21950430
1,91726322,144104,HFM1,6,,91870426
1,110655061,1508,UBL4B,6,,110656569
22,30116343,11477,CABP7,6,,30127820
22,42394728,29749,WBP2NL,6,,42424477
3,119884327,78815,GPR156,6,,119963142
4,144498560,123268,FREM3,6,,144621828
4,4291923,31590,ZBTB49,6,,4323513
4,90033967,2085,TIGD2,6,,90036052
5,36035118,31905,UGT3A2,6,,36067023
7,63688851,38458,ZNF679,6,,63727309
7,149461270,9298,ZNF467,6,,149470568
8,139600477,325772,COL22A1,6,,139926249
8,182459,14881,ZNF596,6,,197340
9,136243283,27937,STKLD1,6,,136271220
X,79591002,109808,FAM46D,6,,79700810
10,74653313,39481,OIT3,6,,74692794
10,134210701,20657,PWWP2B,6,,134231358
19,4183350,41461,ANKRD24,6,,4224811
5,128795957,278419,ADAMTS19,6,,129074376
11,76745384,7621,B3GNT6,6,,76753005
2,10196925,23613,CYS1,6,,10220538
9,99403532,14067,AAED1,6,,99417599
9,99148224,32445,ZNF367,6,,99180669
12,56075329,3065,METTL7B,6,,56078394
12,100041527,2365,FAM71C,6,,100043892
15,66839805,18512,LCTL,6,,66858317
16,699362,18467,WDR90,6,,717829
16,1823228,3011,EME2,6,,1826239
16,30389632,21797,ZNF48,6,,30411429
3,137787824,44498,DZIP1L,6,,137832322
19,13080431,5136,DAND5,6,,13085567
1,41481268,6159,SLFNL1,6,,41487427
20,55099784,1424,FAM209A,6,,55101208
2,120302007,112230,CFAP221,6,,120414237
2,62727355,6249,TMEM17,6,,62733604
17,15440293,26652,TVP23C,6,,15466945
17,6939393,4047,SLC16A13,6,,6943440
19,58180302,10218,ZSCAN4,6,,58190520
3,57611180,67636,DENND6A,6,,57678816
7,1581870,14196,TMEM184A,6,,1596066
9,15553096,418801,CCDC171,6,,15971897
9,95820969,26449,SUSD3,6,,95847418
12,66151799,68955,RPSAP52,6,,66220754
2,200775978,17018,C2orf69,6,,200792996
1,1385068,20470,ATAD3C,6,,1405538
11,57412559,4858,YPEL4,6,,57417417
10,35894337,3526,GJD4,6,,35897863
11,120894802,65552,TBCEL,6,,120960354
11,58601539,10458,GLYATL2,6,,58611997
11,60524339,19865,MS4A15,6,,60544204
13,46276438,12256,SPERT,6,,46288694
10,15253643,159415,FAM171A1,6,,15413058
6,116850175,32111,FAM26D,6,,116882286
6,117073359,13527,FAM162B,6,,117086886
6,46655611,16445,TDRD6,6,,46672056
7,12370508,73344,VWDE,6,,12443852
6,47624325,41208,GPR111,6,,47665533
6,41010236,1840,TSPO2,6,,41012076
6,35773070,18782,LHFPL5,6,,35791852
11,60102354,6087,MS4A6E,6,,60108441
7,92817898,37934,HEPACAM2,6,,92855832
9,38571360,49297,ANKRD18A,6,,38620657
11,101761404,25849,ANGPTL5,6,,101787253
12,31812608,9408,METTL20,6,,31822016
1,1109285,24028,TTLL10,6,,1133313
6,116832807,13148,FAM26E,6,,116845955
22,32809833,43540,BPIFC,6,,32853373
11,66306734,6937,ZDHHC24,6,,66313671
11,67395409,1999,NUDT8,6,,67397408
19,1229946,8044,C19orf26,6,,1237990
4,81256873,628037,C4orf22,6,,81884910
1,86194915,427206,COL24A1,6,,86622121
3,196018089,27076,TCTEX1D2,6,,196045165
3,141876368,68081,GK5,6,,141944449
12,75728418,35751,GLIPR1L1,6,,75764169
7,48026745,41971,SUN3,6,,48068716
19,5558177,9868,TINCR,6,,5568045
9,116172923,19041,C9orf43,6,,116191964
21,38580803,13234,DSCR9,6,,38594037
11,66188474,5703,NPAS4,6,,66194177
20,44313289,20369,WFDC10B,6,,44333658
10,135168657,2872,FUOM,6,,135171529
11,73977693,45028,P4HA3,6,,74022721
11,7506599,26007,OLFML1,6,,7532606
14,99177949,6154,C14orf177,6,,99184103
15,45803333,45595,HMGN2P46,6,,45848928
15,20613649,97784,HERC2P3,6,,20711433
17,4688579,1150,VMO1,6,,4689729
17,15339331,31594,CDRT4,6,,15370925
17,34891402,3748,PIGW,6,,34895150
17,35732927,16735,C17orf78,6,,35749662
19,45596430,54113,PPP1R37,6,,45650543
19,36879531,30045,ZFP82,6,,36909576
19,19867180,20042,LINC00663,6,,19887222
1,248100330,163894,OR2L13,6,,248264224
22,28315363,5588,TTC28-AS1,6,,28320951
2,201838440,97954,FAM126B,6,,201936394
4,98480024,584367,STPG2,6,,99064391
5,178368191,25243,ZNF454,6,,178393434
6,41196061,10059,TREML4,6,,41206120
7,112120907,10036,LSMEM1,6,,112130943
9,134133464,18442,FAM78A,6,,134151906
X,103217199,3364,TMSB15B,6,,103220563
1,247419373,1074,VN1R5,6,,247420447
16,16411465,33000,PKD1P1,6,,16444465
17,42253341,10744,ASB16-AS1,6,,42264085
17,79648194,2760,ARL16,6,,79650954
18,56962635,23246,CPLX4,6,,56985881
1,895966,5133,KLHL17,6,,901099
1,36038970,21957,TFAP2E,6,,36060927
2,8147900,320649,LINC00299,6,,8468549
2,61389628,2336,C2orf74,6,,61391964
3,37440967,36021,C3orf35,6,,37476988
7,1272653,3960,UNCX,6,,1276613
8,144915754,7392,NRBP2,6,,144923146
X,71346960,4791,RGAG4,6,,71351751
X,102528617,3180,TCEAL5,6,,102531797
X,111326252,374221,ZCCHC16,6,,111700473
11,31284170,107187,DCDC1,6,,31391357
11,111126706,30423,C11orf53,6,,111157129
11,6890985,912,OR10A2,6,,6891897
12,48722762,1300,H1FNT,6,,48724062
14,93813536,1164,COX8C,6,,93814700
15,90895476,9239,ZNF774,6,,90904715
17,38933059,5727,KRT27,6,,38938786
17,37366788,15252,STAC2,6,,37382040
19,39687603,4919,NCCRP1,6,,39692522
19,56270506,4035,RFPL4A,6,,56274541
3,111758464,41652,TMPRSS7,6,,111800116
3,190917029,66374,OSTN,6,,190983403
5,79272538,14550,MTX3,6,,79287088
15,25456838,342,PWAR4,6,,25457180
15,65032089,35697,RBPMS2,6,,65067786
16,69984607,13643,CLEC18A,6,,69998250
17,34310691,18393,CCL15-CCL14,6,,34329084
3,126113781,41617,CCDC37,6,,126155398
17,72363644,5095,GPR142,6,,72368739
6,31439005,1180,HCG26,6,,31440185
1,152538174,1055,LCE3E,6,,152539229
17,38922489,5922,KRT26,6,,38928411
4,186317839,3560,ANKRD37,6,,186321399
3,57094468,14992,SPATA12,6,,57109460
7,37723377,60046,GPR141,6,,37783423
19,54818352,6057,LILRA5,6,,54824409
17,289770,5961,FAM101B,6,,295731
15,50792758,46144,USP50,6,,50838902
17,48248788,1049,HILS1,6,,48249837
19,5680775,7759,HSD11B1L,6,,5688534
19,19639669,8724,YJEFN3,6,,19648393
19,48673948,26929,C19orf68,6,,48700877
1,55107412,68528,MROH7,6,,55175940
2,24346349,46158,FAM228B,6,,24392507
2,152104727,13662,RBM43,6,,152118389
3,49306029,8479,C3orf62,6,,49314508
9,132374503,8552,C9orf50,6,,132383055
2,113033177,64463,ZC3H6,6,,113097640
1,26517118,11915,CATSPER4,6,,26529033
7,122341719,1302,RNF148,6,,122343021
Y,24049764,14450,RBMY1D,6,,24064214
Y,24049764,14410,RBMY1E,6,,24064174
21,45993605,1643,KRTAP10-4,6,,45995248
21,45959067,1011,KRTAP10-1,6,,45960078
21,45999331,1150,KRTAP10-5,6,,46000481
16,32888796,7667,SLC6A10P,6,,32896463
1,166882440,62121,ILDR2,6,,166944561
10,21802408,12203,SKIDA1,6,,21814611
10,97759847,32594,CC2D2B,6,,97792441
10,127344262,27451,TEX36,6,,127371713
12,10065825,19155,CLEC2A,6,,10084980
13,26618734,6464,SHISA2,6,,26625198
13,44947977,23873,SERP2,6,,44971850
16,46835958,29116,C16orf87,6,,46865074
19,58962970,6229,ZNF324B,6,,58969199
1,3689350,3196,SMIM1,6,,3692546
1,27705665,4158,CD164L2,6,,27709823
1,171106878,23824,FMO6P,6,,171130702
1,197871681,4816,C1orf53,6,,197876497
20,37049266,14696,SNHG17,6,,37063962
20,55108301,3273,FAM209B,6,,55111574
2,208686011,204273,PLEKHM3,6,,208890284
3,49840686,1777,FAM212A,6,,49842463
7,74508346,57277,GTF2IRD2B,6,,74565623
7,121941362,3203,FEZF1,6,,121944565
7,135414345,19249,FAM180A,6,,135433594
9,131937830,2710,IER5L,6,,131940540
X,73524024,845,ZCCHC13,6,,73524869
2,37394962,20728,SULT6B1,6,,37415690
9,130702860,39952,FAM102A,6,,130742812
10,8092412,3035,GATA3-AS1,6,,8095447
10,126446399,34111,METTL10,6,,126480510
11,121959810,114007,MIR100HG,6,,122073817
16,86508130,34336,FENDRR,6,,86542466
19,50472856,3932,SIGLEC16,6,,50476788
1,144614958,215449,NBPF9,6,,144830407
2,58747887,543014,LINC01122,6,,59290901
2,177037916,15770,HAGLR,6,,177053686
4,68926327,2688,SYT14P1,6,,68929015
2,215276291,167385,VWC2L,6,,215443676
7,98771196,33916,KPNA7,6,,98805112
11,1753639,18185,IFITM10,6,,1771824
17,46667781,15993,HOXB-AS3,6,,46683774
12,97957589,100,MIR135A2,6,,97957689
4,8007027,81,MIR95,6,,8007108
12,176048,111577,IQSEC3,6,,287625
17,36351795,61461,LOC440434,6,,36413256
8,145747760,4656,LRRC24,6,,145752416
9,140194082,2621,NRARP,6,,140196703
X,71264258,553,RPS26P11,6,,71264811
6,29407715,1039,OR10C1,6,,29408754
6,47845763,190662,PTCHD4,6,,48036425
7,123295860,8287,LMOD2,6,,123304147
17,7126615,83,MIR324,6,,7126698
X,76225828,98,MIR325,6,,76225926
11,5617864,47761,TRIM6-TRIM34,6,,5665625
4,190945522,2890,FRG2,6,,190948412
1,89445138,13505,RBMXL1,6,,89458643
14,101488402,67,MIR379,6,,101488469
14,101520642,76,MIR382,6,,101520718
18,649619,8721,TYMSOS,6,,658340
11,27528398,170952,BDNF-AS,6,,27699350
X,149100414,6302,CXorf40B,6,,149106716
9,114393631,38895,DNAJC25-GNG10,6,,114432526
X,133674370,91,MIR450A1,6,,133674461
14,101493436,84,MIR329-2,6,,101493520
14,101506772,100,MIR376B,6,,101506872
1,176998498,83,MIR488,6,,176998581
7,93113247,84,MIR489,6,,93113331
10,18134035,87,MIR511,6,,18134122
19,54172416,84,MIR512-1,6,,54172500
X,146353852,74,MIR510,6,,146353926
4,70454134,51226,UGT2A2,6,,70505360
19,51385351,14303,KLKP1,6,,51399654
5,126984712,9610,CTXN3,6,,126994322
16,15737150,79,MIR484,6,,15737229
14,101518782,80,MIR487A,6,,101518862
3,12881810,139,SNORA7A,6,,12881949
X,46357159,47733,ZNF674,6,,46404892
20,1206763,28382,RAD21L1,6,,1235145
19,36486089,1131,SDHAF1,6,,36487220
1,34610,1471,FAM138A,6,,36081
4,145564067,3104,HHIP-AS1,6,,145567171
13,32877907,8184,ZAR1L,6,,32886091
22,38974124,78510,FAM227A,6,,39052634
3,158787040,197056,IQCJ,6,,158984096
15,58982671,3135,HSP90AB4P,6,,58985806
7,73605527,97,MIR590,6,,73605624
10,29833932,94,MIR604,6,,29834026
17,61021575,98,MIR633,6,,61021673
14,101515886,97,MIR655,6,,101515983
17,1173857,708,BHLHA9,6,,1174565
15,32734114,13721,GOLGA8O,6,,32747835
17,5402746,1573,LOC728392,6,,5404319
2,3751181,143819,DCDC2C,6,,3895000
1,1592938,31305,SLC35E2B,6,,1624243
1,147574322,772607,NBPF8,6,,148346929
7,63774250,42762,ZNF736,6,,63817012
19,46498718,23156,CCDC61,6,,46521874
X,49354117,7313,GAGE2A,6,,49361430
6,157710053,35238,TMEM242,6,,157745291
17,74536120,5338,PRCD,6,,74541458
7,150935506,118,MIR671,6,,150935624
7,72569011,52325,LOC100093631,6,,72621336
18,32831021,39188,ZSCAN30,6,,32870209
X,73438381,72,MIR374B,6,,73438453
3,10436172,74,MIR885,6,,10436246
X,146342057,76,MIR509-3,6,,146342133
6,116817650,49123,TRAPPC3L,6,,116866773
7,143963766,2626,CTAGE4,6,,143966392
2,27293341,1226,OST4,6,,27294567
14,105267517,3531,ZBTB42,6,,105271048
19,20720797,27829,ZNF737,6,,20748626
5,61874561,2714,LRRC70,6,,61877275
6,31141511,4165,PSORS1C3,6,,31145676
17,72576110,12260,CD300LD,6,,72588370
3,75786028,48125,ZNF717,6,,75834153
15,28765515,12628,GOLGA8F,6,,28778143
17,21308447,12035,KCNJ18,6,,21320482
6,160424322,4374,AIRN,6,,160428696
1,68297970,370700,GNG12-AS1,6,,68668670
X,63005881,86,MIR1468,6,,63005967
10,21785490,80,MIR1915,6,,21785570
10,100154974,90,MIR1287,6,,100155064
12,57588286,73,MIR1228,6,,57588359
11,61582632,80,MIR1908,6,,61582712
X,73247970,265439,FTX,6,,73513409
9,131007225,84,MIR3154,6,,131007309
22,31127543,85,MIR3200,6,,31127628
8,104166841,76,MIR3151,6,,104166917
2,207974710,87,MIR2355,6,,207974797
1,173204198,242096,LOC100506023,6,,173446294
3,42977833,6450,KRBOX1,6,,42984283
4,100010007,212506,LOC100507053,6,,100222513
8,128219626,11887,CCAT1,6,,128231513
22,19704742,7555,SEPT5-GP1BB,6,,19712297
1,74663895,346221,FPGT-TNNI3K,6,,75010116
X,101854275,118386,ARMCX5-GPRASP2,6,,101972661
19,9434901,58392,ZNF559-ZNF177,6,,9493293
4,77172852,59431,FAM47E-STBD1,6,,77232283
4,89442128,2824,PYURF,6,,89444952
2,207068099,62868,GPR1-AS,6,,207130967
7,99933687,31767,STAG3L5P-PVRIG2P-PILRB,6,,99965454
11,89984399,663821,DISC1FP1,6,,90648220
15,20874796,86684,NBEAP1,5,,20961480
9,36169388,1943,CCIN,5,,36171331
22,25844053,13592,CRYBB2P1,5,,25857645
19,41430169,26396,CYP2B7P,5,,41456565
14,106135913,3231,ELK2AP,5,,106139144
9,125795921,2023,GPR21,5,,125797944
1,200842082,1224,GPR25,5,,200843306
6,167570359,960,GPR31,5,,167571319
22,19136503,1293,GSC2,5,,19137796
12,54348651,1739,HOXC12,5,,54350390
2,11052062,2289,KCNF1,5,,11054351
19,51874873,1087,NKG7,5,,51875960
19,47523100,25933,NPAS1,5,,47549033
7,75137068,20385,PMS2P3,5,,75157453
4,76781025,42656,PPEF2,5,,76823681
2,79362628,2925,REG1P,5,,79365553
3,39452544,154,SNORA62,5,,39452698
11,18134018,3661,SAA3P,5,,18137679
16,4239374,52707,SRL,5,,4292081
6,170140210,11469,TCTE3,5,,170151679
11,7020548,21038,ZNF214,5,,7041586
17,3118914,930,OR1A1,5,,3119844
17,2965962,939,OR1D5,5,,2966901
14,70918873,7749,ADAM21,5,,70926622
14,70989077,12655,ADAM20,5,,71001732
16,89773540,13854,VPS9D1,5,,89787394
3,108626641,46036,GUCA1C,5,,108672677
19,52534631,17746,ZNF432,5,,52552377
12,108523247,121066,WSCD2,5,,108644313
8,144718331,17569,ZNF623,5,,144735900
7,100612903,49327,MUC12,5,,100662230
11,65360325,3142,KCNK7,5,,65363467
6,25912983,13124,SLC17A2,5,,25926107
20,58438611,70107,SYCP2,5,,58508718
2,16076386,5459,MYCNOS,5,,16081845
19,58144534,10880,ZNF211,5,,58155414
18,12407894,24342,SLMO1,5,,12432236
11,55702931,945,OR5I1,5,,55703876
5,154198051,32194,FAXDC2,5,,154230245
19,32836513,42060,ZNF507,5,,32878573
19,41396730,9683,CYP2G1P,5,,41406413
11,133778519,48130,IGSF9B,5,,133826649
1,16010826,50438,PLEKHM2,5,,16061264
15,79724857,39785,KIAA1024,5,,79764642
7,36363758,65976,KIAA0895,5,,36429734
17,40308909,24387,KCNH4,5,,40333296
14,71108503,33574,TTC9,5,,71142077
19,57285922,66175,ZIM2,5,,57352097
19,18723681,8168,TMEM59L,5,,18731849
2,241938254,95389,SNED1,5,,242033643
10,48737041,90925,PTPN20B,5,,48827966
10,85991275,9942,LRIT1,5,,86001217
6,27925018,942,OR2B6,5,,27925960
1,152658598,1278,LCE2B,5,,152659876
1,248402230,936,OR2M4,5,,248403166
11,124310045,936,OR8B8,5,,124310981
14,22037933,942,OR10G3,5,,22038875
19,15838833,1029,OR10H2,5,,15839862
17,56232514,933,OR4D1,5,,56233447
5,138614468,200,SNORA74A,5,,138614668
4,71226492,6331,SMR3A,5,,71232823
X,70711530,769,INGX,5,,70712299
1,231950371,3892,DISC2,5,,231954263
X,41583407,5981,GPR82,5,,41589388
22,21636713,15302,POM121L8P,5,,21652015
2,132480063,44914,C2orf27A,5,,132524977
12,110906231,21961,FAM216A,5,,110928192
18,44259080,78052,ST8SIA5,5,,44337132
3,150915618,5370,GPR171,5,,150920988
5,178487415,23563,ZNF354C,5,,178510978
11,5528529,2624,UBQLN3,5,,5531153
1,8378144,26083,SLC45A1,5,,8404227
12,45566816,42973,PLEKHA8P1,5,,45609789
3,50595455,9768,C3orf18,5,,50605223
17,38334241,17667,RAPGEFL1,5,,38351908
X,114524282,17841,LUZP4,5,,114542123
22,23950638,23870,DRICH1,5,,23974508
1,46153846,6262,TMEM69,5,,46160108
2,97541618,110683,FAM178B,5,,97652301
15,65345674,14776,RASL12,5,,65360450
15,90808894,6549,NGRN,5,,90815443
3,50606582,15839,HEMK1,5,,50622421
X,135614310,24656,VGLL1,5,,135638966
X,8137984,1324,VCX2,5,,8139308
6,29758807,2043,HCG4,5,,29760850
4,8200970,41860,SH3TC1,5,,8242830
4,70146216,14552,UGT2B28,5,,70160768
9,27284653,12484,EQTN,5,,27297137
12,12482217,20952,MANSC1,5,,12503169
19,58281019,10965,ZNF586,5,,58291984
16,90015138,19330,DEF8,5,,90034468
19,49103856,12838,FAM83E,5,,49116694
9,103947316,140101,LPPR1,5,,104087417
9,111696672,6565,FAM206A,5,,111703237
3,73110809,1662,EBLN2,5,,73112471
1,28285972,8635,XKR8,5,,28294607
11,71498556,13724,FAM86C1,5,,71512280
1,205305192,21026,KLHDC8A,5,,205326218
14,74815165,11546,VRTN,5,,74826711
16,58699012,19669,SLC38A7,5,,58718681
12,72079877,17962,TMEM19,5,,72097839
3,12775028,35928,TMEM40,5,,12810956
1,116519118,93557,SLC22A15,5,,116612675
13,45563664,38740,GPALPP1,5,,45602404
1,20808883,3845,CAMK2N1,5,,20812728
11,2891262,2074,KCNQ1DN,5,,2893336
12,100558827,8294,GOLGA2P5,5,,100567121
19,4247066,22024,CCDC94,5,,4269090
3,113005776,154585,CFAP44,5,,113160361
X,129628914,2507,FAM45B,5,,129631421
20,21106623,120635,KIZ,5,,21227258
1,210406194,10246,SERTAD4,5,,210416440
5,140098510,88,VTRNA1-2,5,,140098598
5,140090860,98,VTRNA1-1,5,,140090958
12,57628685,5790,NDUFA4L2,5,,57634475
19,45174723,12904,CEACAM19,5,,45187627
4,125585206,48681,ANKRD50,5,,125633887
1,3652547,11390,TP73-AS1,5,,3663937
3,54952380,9721,LRTM1,5,,54962101
3,62304717,17171,C3orf14,5,,62321888
9,34366663,10231,KIAA1161,5,,34376894
14,68000007,56248,PLEKHH1,5,,68056255
4,57036360,160530,KIAA1211,5,,57196890
16,1664640,63269,CRAMP1L,5,,1727909
15,74421714,7429,ISLR2,5,,74429143
19,49340353,31531,PLEKHA4,5,,49371884
9,125680307,13523,ZBTB26,5,,125693830
10,116581502,78084,FAM160B1,5,,116659586
1,180882312,32927,KIAA1614,5,,180915239
9,118650543,36834,LINC00474,5,,118687377
6,46126918,11829,ENPP5,5,,46138747
9,133539980,18404,PRDM12,5,,133558384
6,100054649,8805,PRDM13,5,,100063454
1,46092975,59327,GPBP1L1,5,,46152302
3,93781854,63776,NSUN3,5,,93845630
1,27216978,9984,GPATCH3,5,,27226962
X,72064875,3761,DMRTC1,5,,72068636
3,119360898,18539,POPDC2,5,,119379437
3,187086167,3202,RTP4,5,,187089369
2,190611385,16539,OSGEPL1,5,,190627924
5,43444353,39639,C5orf28,5,,43483992
7,100209724,3276,MOSPD3,5,,100213000
9,26993134,12557,LRRC19,5,,27005691
7,66767624,18889,STAG3L4,5,,66786513
1,12851545,5232,PRAMEF1,5,,12856777
1,40916336,13054,ZFP69B,5,,40929390
X,150863729,6334,PRRG3,5,,150870063
11,62430288,8953,LBHD1,5,,62439241
16,8715496,24583,METTL22,5,,8740079
17,34948225,9008,DHRS11,5,,34957233
11,5322243,933,OR51B4,5,,5323176
2,220101319,8832,GLB1L,5,,220110151
1,230457391,104283,PGBD5,5,,230561674
14,50575349,7948,VCPKMT,5,,50583297
14,95873603,2824,LINC00341,5,,95876427
14,75536279,10411,ZC2HC1C,5,,75546690
11,66512206,98781,C11orf80,5,,66610987
2,29338291,68388,CLIP4,5,,29406679
10,11784355,21710,ECHDC3,5,,11806065
6,146920135,216462,ADGB,5,,147136597
13,52344912,33386,DHRS12,5,,52378298
3,169557028,30695,LRRC31,5,,169587723
7,89874487,65890,CFAP69,5,,89940377
1,247263263,4411,ZNF669,5,,247267674
10,115511212,30980,PLEKHS1,5,,115542192
12,49740699,6768,DNAJC22,5,,49747467
X,100264333,42772,TRMT2B,5,,100307105
6,168456463,20083,FRMD1,5,,168476546
6,161581163,1851,AGPAT4-IT1,5,,161583014
2,71205574,7055,ANKRD53,5,,71212629
1,9164475,24754,GPR157,5,,9189229
6,170190168,12801,LINC00574,5,,170202969
4,48988658,75437,CWH43,5,,49064095
16,2510114,4850,C16orf59,5,,2514964
17,45922279,6237,SP6,5,,45928516
20,13830043,141222,SEL1L2,5,,13971265
6,73951037,68901,KHDC1,5,,74019938
17,39190136,971,KRTAP1-3,5,,39191107
17,39196810,903,KRTAP1-1,5,,39197713
19,53206065,32242,ZNF611,5,,53238307
6,50681256,59490,TFAP2D,5,,50740746
6,167738573,17604,TTLL2,5,,167756177
17,39155444,694,KRTAP3-2,5,,39156138
17,39388714,992,KRTAP9-3,5,,39389706
17,39471168,779,KRTAP17-1,5,,39471947
1,901876,8608,PLEKHN1,5,,910484
4,675612,7618,MFSD7,5,,683230
19,48023941,35172,ZNF541,5,,48059113
1,145456235,14173,POLR3GL,5,,145470408
19,8575461,3587,ZNF414,5,,8579048
16,89894906,42821,SPIRE2,5,,89937727
19,42891170,3274,CNFN,5,,42894444
21,46353198,6630,LINC01547,5,,46359828
19,50000975,87,SNORD35B,5,,50001062
7,149412101,19563,KRBA1,5,,149431664
19,53641956,20357,ZNF347,5,,53662313
14,36003247,3013,INSM2,5,,36006260
7,128355395,16402,FAM71F1,5,,128371797
1,32712817,1644,FAM167B,5,,32714461
7,6369039,19551,FAM220A,5,,6388590
2,128458596,2811,SFT2D3,5,,128461407
2,74699958,10399,CCDC142,5,,74710357
2,95810744,14586,ZNF514,5,,95825330
7,77423044,4703,TMEM60,5,,77427747
17,39149681,704,KRTAP3-3,5,,39150385
20,36838906,50268,KIAA1755,5,,36889174
14,20811229,341,RPPH1,5,,20811570
13,101182417,58629,GGACT,5,,101241046
12,112369086,81937,TMEM116,5,,112451023
14,94385239,10715,FAM181A,5,,94395954
19,35417806,18270,ZNF30,5,,35436076
9,139006426,3851,C9orf69,5,,139010277
20,44509847,4058,ZSWIM1,5,,44513905
19,42082530,10667,CEACAM21,5,,42093197
3,129120163,27331,EFCAB12,5,,129147494
19,14063285,8976,DCAF15,5,,14072261
19,12500827,11261,ZNF799,5,,12512088
19,12255708,11838,ZNF625,5,,12267546
19,11976843,3463,ZNF439,5,,11980306
11,27360060,24735,CCDC34,5,,27384795
16,3348807,6632,TIGD7,5,,3355439
11,33037409,17719,DEPDC7,5,,33055128
19,33210678,71036,TDRD12,5,,33281714
3,101498285,48790,NXPE3,5,,101547075
14,103566480,10414,EXOC3L4,5,,103576894
15,68483042,15406,CALML4,5,,68498448
2,178479025,4669,TTC30A,5,,178483694
17,7758383,1034,TMEM88,5,,7759417
5,36103413,48602,LMBRD2,5,,36152015
11,58695101,29446,GLYATL1,5,,58724547
1,156041803,9986,MEX3A,5,,156051789
2,26624779,54800,DRC1,5,,26679579
2,232260334,5541,B3GNT7,5,,232265875
19,9718001,13915,ZNF561,5,,9731916
3,167967309,581065,EGFEM1P,5,,168548374
19,54972978,1916,LENG9,5,,54974894
22,22652462,24862,BMS1P20,5,,22677324
13,114076254,31585,ADPRHL1,5,,114107839
8,145734418,2193,MFSD3,5,,145736611
22,50986461,2991,KLHDC7B,5,,50989452
22,40390952,35091,FAM83F,5,,40426043
21,35552977,9243,LINC00310,5,,35562220
2,56411257,202052,CCDC85A,5,,56613309
11,47611215,4746,C1QTNF4,5,,47615961
8,42396764,11376,SMIM19,5,,42408140
7,130353485,17921,TSGA13,5,,130371406
17,39981333,11190,NT5C3B,5,,39992523
2,223536456,38193,MOGAT1,5,,223574649
1,10057254,18824,RBP7,5,,10076078
11,18194383,1444,MRGPRX4,5,,18195827
10,50507186,28351,C10orf71,5,,50535537
10,75183336,9983,MSS51,5,,75193319
10,46321039,21882,AGAP4,5,,46342921
10,92911760,1077,NUDT9P1,5,,92912837
11,55860783,933,OR8I2,5,,55861716
12,56030675,942,OR10P1,5,,56031617
13,111972990,23604,TEX29,5,,111996594
13,78273015,65362,SLAIN1,5,,78338377
13,57741330,3022,PRR20A,5,,57744352
13,113030650,58359,SPACA7,5,,113089009
14,45366506,9954,C14orf28,5,,45376460
14,21498344,1988,TPPP2,5,,21500332
14,21525980,634,RNASE8,5,,21526614
14,57857270,22196,NAA30,5,,57879466
15,83424116,50706,FSD2,5,,83474822
17,79218610,50529,SLC38A10,5,,79269139
17,26934981,6230,SGK494,5,,26941211
17,4046914,14081,CYB5D2,5,,4060995
17,4402137,40195,SPNS2,5,,4442332
17,38811871,9545,KRT222,5,,38821416
17,15879874,23132,ZSWIM7,5,,15903006
18,21594383,121191,TTC39C,5,,21715574
19,57831864,10280,ZNF543,5,,57842144
19,11877814,17079,ZNF441,5,,11894893
19,39358471,10448,RINL,5,,39368919
1,152056619,4921,TCHHL1,5,,152061540
1,152126070,5634,RPTN,5,,152131704
1,154474694,45929,TDRD10,5,,154520623
1,19230773,52053,IFFO2,5,,19282826
1,40997232,16609,ZNF684,5,,41013841
1,241815579,149855,WDR64,5,,241965434
1,212965169,24998,TATDN3,5,,212990167
20,31805115,10497,BPIFA3,5,,31815612
22,19428409,7346,C22orf39,5,,19435755
2,131805448,45585,FAM168B,5,,131851033
2,26804069,60167,CIB4,5,,26864236
2,198435526,105058,RFTN2,5,,198540584
2,120059792,64526,C2orf76,5,,120124318
2,231860838,11161,SPATA3,5,,231871999
2,149894980,176792,LYPD6B,5,,150071772
2,39892637,52467,TMEM178A,5,,39945104
2,230787206,90619,FBXO36,5,,230877825
3,194406621,3145,FAM43A,5,,194409766
4,122680087,6253,TMEM155,5,,122686340
4,56422691,35688,PDCL2,5,,56458379
5,132149015,3474,SOWAHA,5,,132152489
6,49518112,1696,C6orf141,5,,49519808
7,143632325,954,OR2F2,5,,143633279
7,129847703,8981,SSMEM1,5,,129856684
7,133812104,137239,LRGUK,5,,133949343
8,143831567,2385,LYPD2,5,,143833952
8,38243958,23084,LETM2,5,,38267042
9,116059372,1948,RNF183,5,,116061320
9,72435720,85431,C9orf135,5,,72521151
9,96846710,25428,PTPDC1,5,,96872138
9,107288533,957,OR13C4,5,,107289490
X,142596563,8740,SPANXN3,5,,142605303
X,106449861,37612,PIH1D3,5,,106487473
X,83572881,184606,HDX,5,,83757487
X,135383121,115926,GPR112,5,,135499047
X,55649832,2789,FOXR2,5,,55652621
X,114423962,3469,RBMXL3,5,,114427431
13,98828038,1483,RNF113B,5,,98829521
20,62605465,5530,SAMD10,5,,62610995
2,120189445,6651,TMEM37,5,,120196096
20,22541191,18089,LINC00261,5,,22559280
20,44258384,1447,WFDC10A,5,,44259831
20,44162835,5299,WFDC6,5,,44168134
3,57302378,24332,ASB14,5,,57326710
12,124773709,26861,FAM101A,5,,124800570
12,24719897,17205,LINC00477,5,,24737102
12,25348149,9800,LYRM5,5,,25357949
12,122150657,69317,TMEM120B,5,,122219974
13,43355685,10000,FAM216B,5,,43365685
14,74399694,17423,FAM161B,5,,74417117
15,59730371,85380,FAM81A,5,,59815751
16,66648652,81958,CMTM4,5,,66730610
16,31150246,11169,PRSS36,5,,31161415
17,79202076,10815,ENTHD2,5,,79212891
17,61934375,7364,TCAM1P,5,,61941739
19,52956828,63303,ZNF578,5,,53020131
19,58469804,16098,C19orf18,5,,58485902
19,57901217,12702,ZNF548,5,,57913919
19,42341147,7589,LYPD4,5,,42348736
19,9577030,32249,ZNF560,5,,9609279
19,56111705,2799,ZNF524,5,,56114504
19,56132106,3835,ZNF784,5,,56135941
19,36672961,33025,ZNF565,5,,36705986
19,8920251,22729,ZNF558,5,,8942980
1,209952552,5523,C1orf74,5,,209958075
1,64669489,40538,UBE2U,5,,64710027
1,247670359,70633,GCSAML,5,,247740992
1,16330730,2460,C1orf64,5,,16333190
20,5731032,114021,C20orf196,5,,5845053
21,15481134,98136,LIPI,5,,15579270
21,40777769,38359,LCA5L,5,,40816128
21,43131679,4256,LINC00479,5,,43135935
22,17071647,2053,CCT8L2,5,,17073700
22,17264305,38284,XKR3,5,,17302589
22,23732791,12008,ZDHHC8P1,5,,23744799
2,100824715,43231,LINC01104,5,,100867946
2,241078445,1628,OTOS,5,,241080073
2,190540710,70666,ANKAR,5,,190611376
2,27371944,3875,TCF23,5,,27375819
2,26395959,16573,GAREML,5,,26412532
2,223162865,7071,CCDC140,5,,223169936
3,167196472,174817,WDR49,5,,167371289
3,28283123,78140,CMC1,5,,28361263
5,54921672,67209,SLC38A9,5,,54988881
5,147648422,17351,SPINK13,5,,147665773
5,172483354,35979,CREBRF,5,,172519333
5,94727047,59097,FAM81B,5,,94786144
5,114602884,29574,CCDC112,5,,114632458
7,108524031,613,C7orf66,5,,108524644
8,9757573,3266,LINC00599,5,,9760839
8,87226287,16317,SLC7A13,5,,87242604
8,11197145,28816,TDH,5,,11225961
8,109791204,8640,TMEM74,5,,109799844
9,125377016,945,OR1Q1,5,,125377961
11,125616187,3556,PATE1,5,,125619743
12,88373815,49361,C12orf50,5,,88423176
13,44410488,43338,CCDC122,5,,44453826
14,67656109,39158,FAM71D,5,,67695267
14,67936982,45039,TMEM229B,5,,67982021
17,54230835,329172,ANKFN1,5,,54560007
17,38948447,7764,KRT28,5,,38956211
18,44554572,1877,TCEB3C,5,,44556449
19,58865722,8492,ZNF497,5,,58874214
19,45574757,5089,ZNF296,5,,45579846
19,9296269,3224,OR7D2,5,,9299493
19,12721731,18945,ZNF791,5,,12740676
19,12636183,26173,ZNF564,5,,12662356
19,36494200,5495,SYNE4,5,,36499695
19,22361902,17851,ZNF676,5,,22379753
1,1846265,2468,CALML6,5,,1848733
1,20878931,2582,FAM43B,5,,20881513
1,223566714,2098,CCDC185,5,,223568812
20,44330654,6802,WFDC13,5,,44337456
2,71035775,11957,CLEC4F,5,,71047732
3,126243130,19004,CHST13,5,,126262134
3,127641901,64613,KBTBD12,5,,127706514
4,165953150,9746,TRIM60,5,,165962896
5,43192169,88783,NIM1K,5,,43280952
8,87878675,516280,CNBD1,5,,88394955
8,101585111,76782,SNX31,5,,101661893
8,91634222,23911,TMEM64,5,,91658133
X,34960912,2122,FAM47B,5,,34963034
X,35937850,70419,CXorf22,5,,36008269
10,134258713,3112,C10orf91,5,,134261825
19,53868967,20874,ZNF525,5,,53889841
4,433772,59188,ZNF721,5,,492960
X,13053735,9182,FAM9C,5,,13062917
5,175815526,1246,HIGD2A,5,,175816772
10,119243803,60776,EMX2OS,5,,119304579
12,97858798,68746,RMST,5,,97927544
10,124608609,30548,FAM24B,5,,124639157
15,72452146,37990,GRAMD2,5,,72490136
19,37638339,25304,ZNF585A,5,,37663643
19,20802744,41658,ZNF626,5,,20844402
1,152681522,388,LCE4A,5,,152681910
1,57184476,100893,C1orf168,5,,57285369
1,244515936,36452,C1orf100,5,,244552388
2,98703594,225816,VWA3B,5,,98929410
4,153690505,10411,TIGD4,5,,153700916
4,153547265,54052,TMEM154,5,,153601317
4,16228285,31525,TAPT1-AS1,5,,16259810
6,44247896,17562,TCTE1,5,,44265458
8,10383055,28621,PRSS55,5,,10411676
X,115592852,1342,CT83,5,,115594194
X,77911565,3260,ZCCHC5,5,,77914825
X,55115484,3785,PAGE2,5,,55119269
2,131513223,12484,AMER3,5,,131525707
7,92759366,18335,SAMD9L,5,,92777701
10,81892257,12527,PLAC9,5,,81904784
13,28366779,1310,GSX1,5,,28368089
11,57310113,7634,SMTNL1,5,,57317747
11,59224433,945,OR4D6,5,,59225378
11,85566143,64920,CCDC83,5,,85631063
11,85394886,2434,CCDC89,5,,85397320
10,45493145,3213,C10orf25,5,,45496358
7,99214570,15460,ZSCAN25,5,,99230030
7,27225026,3886,HOXA11-AS,5,,27228912
7,100032911,1183,PPP1R35,5,,100034094
7,102389398,60274,FAM185A,5,,102449672
6,40994639,12299,UNC5CL,5,,41006938
6,28400431,10848,ZSCAN23,5,,28411279
6,4068592,10865,FAM217A,5,,4079457
7,19184404,640,FERD3L,5,,19185044
7,100081549,10875,NYAP1,5,,100092424
7,31553684,139619,CCDC129,5,,31693303
20,30028321,9739,DEFB123,5,,30038060
20,168493,1829,DEFB128,5,,170322
18,32946660,10641,ZNF396,5,,32957301
5,176057682,15960,EIF4E1B,5,,176073642
3,40547529,12183,ZNF620,5,,40559712
14,36942493,40497,SFTA3,5,,36982990
16,1883983,38196,MEIOB,5,,1922179
1,152483319,1334,LCE5A,5,,152484653
19,1952525,2023,CSNK1G2-AS1,5,,1954548
9,113065866,34298,TXNDC8,5,,113100164
17,79897520,7589,MYADML2,5,,79905109
4,53192,104757,ZNF718,5,,157949
5,179527794,108336,RASGEF1C,5,,179636130
16,50059116,11883,CNEP1R1,5,,50070999
8,39172181,88194,ADAM5,5,,39260375
19,58038692,13552,ZNF549,5,,58052244
19,50837056,10949,NAPSB,5,,50848005
14,94463615,10283,LINC00521,5,,94473898
1,244624672,178990,C1orf101,5,,244803662
4,7042575,2153,CCDC96,5,,7044728
2,231902280,12147,C2orf72,5,,231914427
16,21245015,18735,ANKS4B,5,,21263750
6,31674683,3689,LY6G6F,5,,31678372
X,47967366,12702,SSX6,5,,47980068
11,5363743,163139,OR51B5,5,,5526882
10,50887683,15265,C10orf53,5,,50902948
11,118842416,9579,FOXR1,5,,118851995
11,75133437,8237,KLHL35,5,,75141674
11,77882289,17386,KCTD21,5,,77899675
11,6897855,995,OR10A4,5,,6898850
12,13523604,6075,LINC01559,5,,13529679
12,109826523,59653,MYO1H,5,,109886176
16,67218281,5826,EXOC3L1,5,,67224107
17,26603011,31397,KRT18P55,5,,26634408
17,36886509,5349,CISD3,5,,36891858
19,40578898,17912,ZNF780A,5,,40596810
19,44331472,21578,ZNF283,5,,44353050
19,55824168,12540,TMEM150B,5,,55836708
19,3474404,6136,SMIM24,5,,3480540
19,4769116,3452,MIR7-3HG,5,,4772568
19,21579920,30376,ZNF493,5,,21610296
1,151694012,8070,RIIAD1,5,,151702082
1,151819576,6597,THEM5,5,,151826173
1,16062808,5079,SLC25A34,5,,16067887
20,58630979,17029,C20orf197,5,,58648008
20,1455235,16998,SIRPB2,5,,1472233
20,29611878,22129,FRG1B,5,,29634007
20,31219426,20357,C20orf203,5,,31239783
2,106998569,9282,PLGLA,5,,107007851
3,111859751,153354,SLC9C1,5,,112013105
3,44540461,11671,ZNF852,5,,44552132
3,188889762,151509,TPRG1,5,,189041271
4,187207251,214961,F11-AS1,5,,187422212
4,1385339,4443,CRIPAK,5,,1389782
4,178649910,261994,LINC01098,5,,178911904
4,15683351,8719,FAM200B,5,,15692070
5,177150364,57141,FAM153A,5,,177207505
5,175792470,8033,ARL10,5,,175800503
5,158758525,31317,LOC285626,5,,158789842
5,101944195,62973,LINC00491,5,,102007168
6,109711417,50957,PPIL6,5,,109762374
6,6346697,276362,LY86-AS1,5,,6623059
6,29694377,22449,HLA-F-AS1,5,,29716826
7,65841030,24365,LINC00174,5,,65865395
7,26677489,9400,C7orf71,5,,26686889
7,99070514,9434,ZNF789,5,,99079948
8,93895757,82615,TRIQK,5,,93978372
9,139886869,1571,C9orf142,5,,139888440
17,1182956,21325,TUSC5,5,,1204281
19,53761544,1311,VN1R2,5,,53762855
14,60902673,50091,C14orf39,5,,60952764
1,120906033,8809,HIST2H2BA,5,,120914842
5,129240522,281805,CHSY3,5,,129522327
21,32252963,911,KRTAP11-1,5,,32253874
19,56219797,29971,NLRP9,5,,56249768
12,108983621,8273,TMEM119,5,,108991894
14,20978630,651,RNASE10,5,,20979281
17,21431570,23371,C17orf51,5,,21454941
1,152285934,53234,FLG-AS1,5,,152339168
1,87597608,4744,LINC01140,5,,87602352
3,134318764,51100,KY,5,,134369864
3,129035113,8299,H1FX-AS1,5,,129043412
4,77234191,94267,CCDC158,5,,77328458
10,124895566,1681,HMX3,5,,124897247
12,33528347,64407,SYT10,5,,33592754
12,52281792,3713,ANKRD33,5,,52285505
12,55945010,930,OR6C4,5,,55945940
15,81624759,41659,TMC3,5,,81666418
19,53738633,19523,ZNF677,5,,53758156
2,109745996,516217,SH3RF3,5,,110262213
3,32023265,9963,ZNF860,5,,32033228
3,112534555,30242,CD200R1L,5,,112564797
4,110769339,24132,LRIT3,5,,110793471
5,167956581,1058,FBLL1,5,,167957639
7,143792200,933,OR2A12,5,,143793133
8,82605890,1317,SLC10A5,5,,82607207
9,38406524,17920,IGFBPL1,5,,38424444
X,69502021,2831,RAB41,5,,69504852
15,25227140,1797,PWARSN,5,,25228937
19,40005752,5574,SELV,5,,40011326
2,200625258,90638,FTCDNL1,5,,200715896
3,13978806,128675,TPRXL,5,,14107481
9,70427648,1251,FOXD4L4,5,,70428899
7,99798277,71578,GATS,5,,99869855
6,127898318,14645,C6orf58,5,,127912963
12,123955634,62631,RILPL1,5,,124018265
1,152777310,1797,LCE1C,5,,152779107
1,152670839,1079,LCE2A,5,,152671918
17,74075262,3623,ZACN,5,,74078885
21,46086105,739,KRTAP12-2,5,,46086844
21,46101490,588,KRTAP12-1,5,,46102078
19,2389768,36488,TMPRSS9,5,,2426256
14,104552022,27024,ASPG,5,,104579046
15,56657621,80574,TEX9,5,,56738195
15,85049398,10680,GOLGA6L5P,5,,85060078
17,7323678,1273,SPEM1,5,,7324951
17,28256873,144770,EFCAB5,5,,28401643
17,62850429,65169,LRRC37A3,5,,62915598
19,37379025,28168,ZNF829,5,,37407193
19,46733008,1492,IGFL1,5,,46734500
19,58011221,8376,ZNF773,5,,58019597
5,43486802,28471,C5orf34,5,,43515273
6,58246158,41566,GUSBP4,5,,58287724
7,100813773,9784,NAT16,5,,100823557
9,131038424,12844,SWI5,5,,131051268
9,140119086,1677,CYSRT1,5,,140120763
12,70002344,2598,LRRC10,5,,70004942
9,140328815,7086,ENTPD8,5,,140335901
21,46839630,5355,COL18A1-AS1,5,,46844985
Y,24549556,14240,RBMY1J,5,,24563796
21,46011148,1238,KRTAP10-6,5,,46012386
21,45977905,738,KRTAP10-3,5,,45978643
22,17082800,46920,TPTEP1,5,,17129720
11,62931295,65829,SLC22A25,5,,62997124
11,27015627,3005,FIBIN,5,,27018632
11,63057429,21817,SLC22A10,5,,63079246
12,10163225,8174,CLEC12B,5,,10171399
13,24465237,5908,C1QTNF9B,5,,24471145
15,40623652,9516,C15orf52,5,,40633168
16,28303839,31331,SBK1,5,,28335170
19,14693895,28061,CLEC17A,5,,14721956
19,37309223,32466,ZNF790,5,,37341689
19,45202420,11566,CEACAM16,5,,45213986
19,46623327,4604,IGFL3,5,,46627931
19,53030908,28395,ZNF808,5,,53059303
19,57946692,11773,ZNF749,5,,57958465
1,1177825,4277,FAM132A,5,,1182102
1,151132223,6201,LYSMD1,5,,151138424
21,31691449,1158,KRTAP26-1,5,,31692607
22,24981590,7445,LRRC75B,5,,24989035
2,171571856,2642,SP5,5,,171574498
6,49467670,28107,GLYATL3,5,,49495777
8,142443928,73402,MROH5,5,,142517330
9,135285582,163124,C9orf171,5,,135448706
X,49644469,2699,USP27X,5,,49647168
10,16555741,8263,C1QL3,5,,16564004
11,5461771,1012,OR51I1,5,,5462783
11,5474637,1070,OR51I2,5,,5475707
11,5509914,1064,OR52D1,5,,5510978
11,67218771,1429,GPR152,5,,67220200
11,76391209,41624,GUCY2EP,5,,76432833
11,122848356,4023,BSX,5,,122852379
12,55714383,939,OR6C1,5,,55715322
15,90777486,7826,GDPGP1,5,,90785312
15,102345922,939,OR4F6,5,,102346861
16,88929747,3321,PABPN1L,5,,88933068
17,39114668,8476,KRT39,5,,39123144
1,156268414,1014,VHLL,5,,156269428
1,159824105,8342,VSIG8,5,,159832447
4,165875597,23221,TRIM61,5,,165898818
7,6536408,54659,GRID2IP,5,,6591067
17,8191080,7581,SLC25A35,5,,8198661
14,73945188,80463,HEATR4,5,,74025651
10,21783420,2793,CASC10,5,,21786213
11,125646027,2687,PATE2,5,,125648714
13,37248048,23927,SERTM1,5,,37271975
16,21312169,17743,CRYM-AS1,5,,21329912
1,21046224,12909,SH2D5,5,,21059133
1,98453555,61694,MIR137HG,5,,98515249
2,237103514,69474,ASB18,5,,237172988
4,36283236,63171,DTHD1,5,,36346407
4,71019903,12423,PRR27,5,,71032326
11,48510344,930,OR4A47,5,,48511274
9,129622943,25213,ZBTB34,5,,129648156
19,7989380,1671,CTXN1,5,,7991051
16,85741123,43566,C16orf74,5,,85784689
11,62063753,2783,SCGB1D4,5,,62066536
11,64658826,85,MIR194-2,5,,64658911
17,36337710,10939,TBC1D3C,5,,36348649
10,15117473,13302,ACBD7,5,,15130775
12,14957583,9533,SMCO3,5,,14967116
15,44028145,10351,CATSPER2P1,5,,44038496
16,75237993,3079,CTRB2,5,,75241072
1,165513477,19708,LRRC52,5,,165533185
1,206238871,49776,C1orf186,5,,206288647
2,111160495,20898,LOC440895,5,,111181393
4,75023828,144986,MTHFD2L,5,,75168814
6,44238479,8703,TMEM151B,5,,44247182
7,57509882,23383,ZNF716,5,,57533265
9,22646198,178014,LINC01239,5,,22824212
4,172734574,1226984,GALNTL6,5,,173961558
7,63505820,33107,ZNF727,5,,63538927
7,74298091,8640,STAG3L2,5,,74306731
4,113569518,68,MIR302C,5,,113569586
6,33551475,5328,GGNBP1,5,,33556803
17,44590075,42939,LRRC37A2,5,,44633014
5,139505520,2871,IGIP,5,,139508391
2,99215785,9196,COA5,5,,99224981
14,101491353,61,MIR380,5,,101491414
15,64163128,90,MIR422A,5,,64163218
8,22457113,4549,C8orf58,5,,22461662
X,73164158,126059,JPX,5,,73290217
2,68689504,4945,FBXO48,5,,68694449
X,49773571,64,MIR362,5,,49773635
14,101347343,114,MIR431,5,,101347457
1,228392175,9190,C1orf145,5,,228401365
19,54172410,98,MIR512-2,5,,54172508
19,54177450,124,MIR498,5,,54177574
19,54198466,81,MIR519B,5,,54198547
19,54210706,87,MIR520C,5,,54210793
19,54223349,87,MIR520D,5,,54223436
19,54225419,90,MIR520G,5,,54225509
19,54244566,95,MIR517C,5,,54244661
19,54245765,88,MIR520H,5,,54245853
19,54254464,87,MIR522,5,,54254551
19,54265597,87,MIR519A2,5,,54265684
X,133674537,100,MIR450A2,5,,133674637
X,139006306,84,MIR505,5,,139006390
X,146318430,115,MIR508,5,,146318545
17,37009115,133,SNORA21,5,,37009248
9,116971713,96,MIR455,5,,116971809
2,207026951,132,SNORA41,5,,207027083
18,39060235,40326,KC6,5,,39100561
11,124789145,1428,HEPN1,5,,124790573
2,38813,7775,FAM110C,5,,46588
8,144648362,6566,MROH6,5,,144654928
12,8286364,1084,POU5F1P3,5,,8287448
11,89764273,10920,TRIM49C,5,,89775193
10,48185838,17942,BMS1P6,5,,48203780
1,111023387,10504,CYMP,5,,111033891
12,116997185,17240,MAP1LC3B2,5,,117014425
7,65216091,12571,CCT6P1,5,,65228662
6,132029580,2577,CTAGE9,5,,132032157
14,24895739,2992,CBLN3,5,,24898731
9,69204537,58056,CBWD6,5,,69262593
22,50989540,11841,SYCE3,5,,51001381
15,96809615,60975,NR2F2-AS1,5,,96870590
7,65112766,70901,INTS4P2,5,,65183667
10,15001437,13413,MEIG1,5,,15014850
1,155402970,1083,POU5F1P4,5,,155404053
7,99578384,3476,AZGP1P1,5,,99581860
8,82437215,6410,FABP12,5,,82443625
14,74872595,20210,SYNDIG1L,5,,74892805
18,36786887,545072,LINC00669,5,,37331959
13,21872263,33947,MIPEPP3,5,,21906210
17,3143969,590,OR1D4,5,,3144559
17,39273433,1173,KRTAP4-11,5,,39274606
8,7705401,15918,SPAG11A,5,,7721319
10,18041226,48628,TMEM236,5,,18089854
19,49141295,44207,SEC1P,5,,49185502
X,72161567,2022,FAM226B,5,,72163589
7,149944300,76458,ACTR3C,5,,150020758
2,113993845,30755,PAX8-AS1,5,,114024600
14,101513657,78,MIR539,5,,101513735
14,101506405,80,MIR376A2,5,,101506485
14,101512791,84,MIR487B,5,,101512875
12,49048164,137,SNORA34,5,,49048301
3,52723255,76,SNORD19,5,,52723331
3,75470702,13564,FAM86DP,5,,75484266
11,62432893,149,SNORA57,5,,62433042
17,65467606,95,MIR548D2,5,,65467701
4,24521814,99,MIR573,5,,24521913
5,32394483,98,MIR579,5,,32394581
7,5535449,99,MIR589,5,,5535548
11,65211928,100,MIR612,5,,65212028
12,12917582,95,MIR613,5,,12917677
12,54427733,96,MIR615,5,,54427829
12,57912947,95,MIR616,5,,57913042
13,90883435,96,MIR622,5,,90883531
15,42491767,97,MIR627,5,,42491864
15,55665137,95,MIR628,5,,55665232
17,74732531,99,MIR636,5,,74732630
19,3961411,99,MIR637,5,,3961510
19,46178185,97,MIR642A,5,,46178282
17,79099075,98,MIR657,5,,79099173
8,145019358,89,MIR661,5,,145019447
5,138609440,5877,SNHG4,5,,138615317
X,52928084,9501,FAM156B,5,,52937585
1,32930657,22802,ZBTB8B,5,,32953459
9,139256351,1912,DNLZ,5,,139258263
15,41576200,15595,OIP5-AS1,5,,41591795
3,43020758,78449,FAM198A,5,,43099207
7,74800771,66738,GATSL2,5,,74867509
4,152330397,254387,FAM160A1,5,,152584784
17,36284002,10969,TBC1D3H,5,,36294971
19,24097683,19086,ZNF726,5,,24116769
16,86365455,13830,LINC00917,5,,86379285
11,62432778,2145,METTL12,5,,62434923
14,101492356,88,MIR758,5,,101492444
15,25296622,97,SNORD116-1,5,,25296719
19,52145805,4327,SIGLEC14,5,,52150132
19,10415478,4755,ZGLP1,5,,10420233
X,145076301,77,MIR888,5,,145076378
22,22007269,78,MIR301B,5,,22007347
2,56227848,82,MIR216B,5,,56227930
1,94312387,80,MIR760,5,,94312467
17,43920721,52158,MAPT-AS1,5,,43972879
10,77161285,7455,ZNF503-AS2,5,,77168740
X,148609131,12181,LINC00893,5,,148621312
9,67784943,1682,FAM27E3,5,,67786625
6,43858764,47180,LINC01512,5,,43905944
17,39240458,938,KRTAP4-7,5,,39241396
9,137029561,125,RNU6ATAC,5,,137029686
2,131174325,11794,FAR2P2,5,,131186119
7,102222764,34439,RASA4B,5,,102257203
8,6863802,2544,DEFT1P2,5,,6866346
12,106890187,278422,LOC100287944,5,,107168609
18,19263470,88,MIR320C1,5,,19263558
6,98472406,89,MIR2113,5,,98472495
8,10682882,71,MIR1322,5,,10682953
2,180725562,73,MIR1258,5,,180725635
8,129061397,87,MIR1207,5,,129061484
5,175794948,86,MIR1271,5,,175795034
6,31924615,102,MIR1236,5,,31924717
16,70064248,77,MIR1972-1,5,,70064325
7,100169852,1418,SAP25,5,,100171270
X,111119278,27935,TRPC5OS,5,,111147213
1,203766650,3550,ZBED6,5,,203770200
X,146331668,80,MIR514B,5,,146331748
9,18573303,74,MIR3152,5,,18573377
4,153410478,90,MIR3140,5,,153410568
2,69330813,74,MIR3126,5,,69330887
4,83814604,7465,THAP9-AS1,5,,83822069
3,158787040,828115,IQCJ-SCHIP1,5,,159615155
4,79567147,38508,LINC01094,5,,79605655
6,168394866,2891,KIF25-AS1,5,,168397757
7,79083275,13508,MAGI2-AS3,5,,79096783
5,87564698,167793,TMEM161B-AS1,5,,87732491
18,77827255,11951,RBFADN,5,,77839206
11,76092356,26819,LOC100506127,5,,76119175
2,12147241,571233,LOC100506457,5,,12718474
7,101208586,3700,LINC01007,5,,101212286
14,96343108,48800,TUNAR,5,,96391908
6,29979877,1822,HCG8,5,,29981699
7,140774031,406148,TMEM178B,5,,141180179
1,10490803,21257,APITD1-CORT,5,,10512060
7,99014361,49463,ATP5J2-PTCD1,5,,99063824
16,29466411,9890,SLX1A-SULT1A3,5,,29476301
7,150413644,27093,GIMAP1-GIMAP5,5,,150440737
14,23775970,19424,BCL2L2-PABPN1,5,,23795394
19,53430387,35777,ZNF816-ZNF321P,5,,53466164
2,198364720,53703,HSPE1-MOB4,5,,198418423
6,31497995,16630,ATP6V1G2-DDX39B,5,,31514625
6,32121775,14287,PPT2-EGFL8,5,,32136062
17,67095704,69,MIR4524A,5,,67095773
3,113313722,67,MIR4446,5,,113313789
1,85599476,80,MIR4423,5,,85599556
1,172106018,7957,DNM3OS,5,,172113975
16,21360683,36571,SNX29P1,5,,21397254
7,99282301,50522,CYP3A7-CYP3AP1,5,,99332823
3,125898907,30104,ALDH1L1-AS2,5,,125929011
12,68383224,31883,IFNG-AS1,5,,68415107
12,133696554,10505,ZNF891,5,,133707059
15,73859278,2606,NPTN-IT1,5,,73861884
2,179278385,26585,LOC101927027,5,,179304970
5,88185124,77972,MEF2C-AS1,5,,88263096
6,31323000,93,MIR6891,5,,31323093
1,101491401,61534,LOC102606465,5,,101552935
17,6756894,46774,ALOX12P2,4,,6803668
13,77502584,640,BTF3P11,4,,77503224
9,135957925,4553,CELP,4,,135962478
7,23624334,1812,CLK2P,4,,23626146
17,18569235,7259,FOXO3B,4,,18576494
7,150845675,18960,GBX1,4,,150864635
4,80327506,1866,GK2,4,,80329372
7,74601103,266538,GTF2IP1,4,,74867641
2,218923877,2136,CXCR2P1,4,,218926013
15,25361691,5932,IPW,4,,25367623
17,15690163,2856,MEIS3P1,4,,15693019
16,56669650,1348,MT1JP,4,,56670998
5,137136881,9558,NPY6R,4,,137146439
16,3405888,1036,OR2C1,4,,3406924
5,70671611,10209,PMCHL2,4,,70681820
7,74306886,15444,PMS2P5,4,,74322330
X,109763539,2710,TDGF1P3,4,,109766249
9,115804094,14977,ZFP37,4,,115819071
3,113953479,2946,ZNF80,4,,113956425
19,53099936,3469,ZNF137P,4,,53103405
Y,171416,9471,GTPBP6,4,,180887
1,28832454,4950,SNHG3,4,,28837404
X,47064246,1008,INE1,4,,47065254
14,106435817,2541,ADAM6,4,,106438358
12,112336866,2840,ADAM1A,4,,112339706
Y,20297334,1581,XKRY,4,,20298915
11,62620381,126,SNORD22,4,,62620507
1,87099958,21101,CLCA3P,4,,87121059
17,16593638,84675,CCDC144A,4,,16678313
12,57392616,7681,ZBTB39,4,,57400297
1,1656276,21162,SLC35E2,4,,1677438
11,64812294,13715,NAALADL1,4,,64826009
8,133073732,43780,HHLA1,4,,133117512
22,29833003,5115,RFPL1S,4,,29838118
X,152599612,18772,ZNF275,4,,152618384
4,74919754,1362,PPBPP2,4,,74921116
5,180415844,17883,BTNL3,4,,180433727
2,54080049,7121,GPR75,4,,54087170
5,69776869,104680,SMA5,4,,69881549
2,158114109,60892,GALNT5,4,,158175001
7,86954663,20145,TP53TG1,4,,86974808
17,5973933,53814,WSCD1,4,,6027747
5,76924536,9986,OTP,4,,76934522
19,48867650,11984,SYNGR4,4,,48879634
17,41994575,780,FAM215A,4,,41995355
17,26553588,1497,PYY2,4,,26555085
20,9495004,16167,LAMP5,4,,9511171
16,33262117,2602,TP53TG3,4,,33264719
X,37850069,501,HYPM,4,,37850570
2,232325078,75,SNORD82,4,,232325153
4,187070326,23491,FAM149A,4,,187093817
16,3265561,985,OR1F2P,4,,3266546
9,125281419,942,OR1J4,4,,125282361
16,67241041,19860,LRRC29,4,,67260901
1,248201473,1134,OR2L2,4,,248202607
18,77623667,36149,KCNG2,4,,77659816
8,67679567,702,PTTG3P,4,,67680269
11,124120422,15334,OR8G1,4,,124135756
14,22101991,1105,OR10G2,4,,22103096
19,15917816,1120,OR10H1,4,,15918936
11,124252297,942,OR8B2,4,,124253239
14,22133296,942,OR4E2,4,,22134238
8,99054313,132,SNORA72,4,,99054445
X,153628621,135,SNORA70,4,,153628756
9,130210780,136,SNORA65,4,,130210916
16,2012973,134,SNORA64,4,,2013107
6,31803039,64,SNORD48,4,,31803103
1,45241536,74,SNORD55,4,,45241610
9,136217700,67,SNORD36C,4,,136217767
9,136216948,71,SNORD36B,4,,136217019
9,136217310,72,SNORD36A,4,,136217382
4,17633708,149427,FAM184B,4,,17783135
7,149128453,29600,ZNF777,4,,149158053
19,58740046,34962,ZNF544,4,,58775008
19,49792891,35583,SLC6A16,4,,49828474
3,130732716,12982,ASTE1,4,,130745698
20,18768614,6614,LINC00652,4,,18775228
16,67261015,2167,TMEM208,4,,67263182
11,2316869,6274,C11orf21,4,,2323143
Y,9590764,21164,TTTY1,4,,9611928
17,44630121,26967,ARL17A,4,,44657088
16,30418734,11182,ZNF771,4,,30429916
3,48282595,29884,ZNF589,4,,48312479
X,88002225,7560,CPXCR1,4,,88009785
6,167704802,24700,UNC93A,4,,167729502
7,74988446,8639,STAG3L1,4,,74997085
5,172068268,50265,NEURL1B,4,,172118533
3,113616317,49704,GRAMD1C,4,,113666021
14,57046510,69722,TMEM260,4,,57116232
1,151020215,3057,C1orf56,4,,151023272
1,36787630,2125,EVA1B,4,,36789755
14,57936017,24564,C14orf105,4,,57960581
17,48556160,7181,RSAD1,4,,48563341
20,1161204,3913,TMEM74B,4,,1165117
X,134975784,19436,SAGE1,4,,134995220
19,11832079,17745,ZNF823,4,,11849824
12,2921786,12451,ITFG2,4,,2934237
10,1068576,21565,IDI2-AS1,4,,1090141
X,104463610,1767,TEX13A,4,,104465377
8,67579786,13591,C8orf44,4,,67593377
11,93211638,64908,SMCO4,4,,93276546
11,45168893,87782,PRDM11,4,,45256675
15,49913225,24108,DTWD1,4,,49937333
7,141356527,45426,KIAA1147,4,,141401953
8,142217264,21409,SLC45A4,4,,142238673
X,47917566,12942,ZNF630,4,,47930508
19,46994447,4722,PNMAL2,4,,46999169
11,67183148,9930,CARNS1,4,,67193078
9,100000707,138870,LOC100499484-C9ORF174,4,,100139577
19,36290891,13310,PRODH2,4,,36304201
Y,6114263,2790,TSPY2,4,,6117053
19,13906273,36771,ZSWIM4,4,,13943044
11,77726760,30477,KCTD14,4,,77757237
16,771141,1449,FAM173A,4,,772590
8,144448792,2013,RHPN1-AS1,4,,144450805
7,99816870,2241,PVRIG,4,,99819111
19,16756958,14010,SMIM7,4,,16770968
14,101361106,12199,MEG8,4,,101373305
17,46029333,5910,PRR15L,4,,46035243
11,5344527,1055,OR51B2,4,,5345582
14,100842754,153886,WDR25,4,,100996640
22,42086546,7594,C22orf46,4,,42094140
19,58637694,24454,ZNF329,4,,58662148
17,80347085,29428,OGFOD3,4,,80376513
4,40751913,61286,NSUN7,4,,40813199
3,166958076,140009,ZBBX,4,,167098085
12,18233802,9325,RERGL,4,,18243127
19,53666551,30068,ZNF665,4,,53696619
4,174451608,11475,HAND2-AS1,4,,174463083
8,99202053,104568,NIPAL2,4,,99306621
X,49019180,5315,MAGIX,4,,49024495
3,183533663,9730,MAP6D1,4,,183543393
6,72117566,12882,LINC00472,4,,72130448
8,144373558,8562,ZNF696,4,,144382120
18,18822202,280589,GREB1L,4,,19102791
5,178322894,37318,ZFP2,4,,178360212
3,133646989,1667,C3orf36,4,,133648656
2,135722060,60188,MAP3K19,4,,135782248
21,36410232,1491,RUNX1-IT1,4,,36411723
2,114464297,50103,SLC35F5,4,,114514400
6,31644460,3690,LY6G5C,4,,31648150
14,105992939,3600,TMEM121,4,,105996539
11,113558267,18828,TMPRSS5,4,,113577095
19,110678,918,OR4F17,4,,111596
11,51411377,1071,OR4A5,4,,51412448
13,49822046,45576,CDADC1,4,,49867622
Y,21094584,144849,TTTY14,4,,21239433
8,38846326,7715,TM2D2,4,,38854041
17,39182278,1176,KRTAP1-5,4,,39183454
11,100862810,1856,TMEM133,4,,100864666
14,94594117,1840,IFI27L2,4,,94595957
5,140619688,4624,PCDHB19P,4,,140624312
17,74270129,33632,QRICH2,4,,74303761
22,21055401,3490,TMEM191A,4,,21058891
17,4643309,6105,ZMYND15,4,,4649414
3,193116755,156156,ATP13A4,4,,193272911
2,113342013,4604,CHCHD5,4,,113346617
9,99708326,67536,HIATL2,4,,99775862
19,37862058,21908,ZNF527,4,,37883966
11,60163486,21742,MS4A14,4,,60185228
11,55650772,8512,TRIM51,4,,55659284
2,114356604,4690,DDX11L2,4,,114361294
1,168214818,1850,ANKRD36BP1,4,,168216668
19,59024896,6030,ZBTB45,4,,59030926
9,131799212,35149,FAM73B,4,,131834361
2,112812799,64096,TMEM87B,4,,112876895
12,110152186,56126,FAM222A,4,,110208312
11,12308446,72245,MICALCL,4,,12380691
11,101918168,28674,C11orf70,4,,101946842
5,150157507,18791,SMIM3,4,,150176298
17,39340351,796,KRTAP4-1,4,,39341147
17,39221367,764,KRTAP2-4,4,,39222131
19,15218174,7625,SYDE1,4,,15225799
8,87059339,22587,PSKH2,4,,87081926
3,197687070,83521,LMLN,4,,197770591
15,30918878,12135,ARHGAP11B,4,,30931013
19,55987698,8156,ZNF628,4,,55995854
6,83602116,173444,UBE3D,4,,83775560
10,102133332,14779,LINC00263,4,,102148111
17,27895661,4514,TP53I13,4,,27900175
19,52616344,26847,ZNF616,4,,52643191
17,41019161,2073,AOC4P,4,,41021234
19,20278022,33277,ZNF486,4,,20311299
1,201159952,38128,IGFN1,4,,201198080
22,23980674,78936,GUSBP11,4,,24059610
22,25747384,30160,LRP5L,4,,25777544
5,133737755,9843,CDKN2AIPNL,4,,133747598
2,130896855,5852,CCDC74B,4,,130902707
12,58335286,15766,XRCC6BP1,4,,58351052
12,47473385,157061,PCED1B,4,,47630446
22,42969265,8752,RRP7B,4,,42978017
4,1243227,3568,CTBP1-AS2,4,,1246795
X,106143292,3269,RIPPLY1,4,,106146561
2,159651828,20668,DAPL1,4,,159672496
17,62075710,5934,PRR29,4,,62081644
9,35860270,5245,LINC00950,4,,35865515
3,42695175,13897,ZBTB47,4,,42709072
2,97163379,7743,NEURL3,4,,97171122
1,12806133,14969,C1orf158,4,,12821102
1,205350505,40709,LEMD1,4,,205391214
7,116822734,27257,ST7-OT3,4,,116849991
X,70797873,35560,ACRC,4,,70833433
19,51020149,51153,LRRC4B,4,,51071302
6,83903031,5623,RWDD2A,4,,83908654
14,59939405,11668,L3HYPDH,4,,59951073
1,52497776,1696,KTI12,4,,52499472
22,21362495,6081,TUBA3FP,4,,21368576
5,139944149,4540,SLC35A4,4,,139948689
19,22235249,38654,ZNF257,4,,22273903
19,57645463,11107,ZIM3,4,,57656570
21,45937097,1763,TSPEAR-AS2,4,,45938860
21,47649144,22471,MCM3AP-AS1,4,,47671615
11,75115464,146,SNORD15B,4,,75115610
7,1609708,19553,PSMG3-AS1,4,,1629261
6,130758261,5949,TMEM200A,4,,130764210
X,152157367,3394,PNMA5,4,,152160761
5,159518346,28106,PWWP2A,4,,159546452
5,159774774,22874,C1QTNF2,4,,159797648
19,11594241,22497,ZNF653,4,,11616738
19,42724422,6783,ZNF526,4,,42731205
15,43568478,25975,TGM7,4,,43594453
17,27887688,6354,ABHD15,4,,27894042
3,150690464,108049,CLRN1-AS1,4,,150798513
3,51989329,2191,GPR62,4,,51991520
10,135122392,4274,ZNF511,4,,135126666
10,75013515,105102,CFAP70,4,,75118617
10,88730497,39463,AGAP11,4,,88769960
11,4566420,954,OR52M1,4,,4567374
11,7817520,969,OR5P2,4,,7818489
11,6912804,927,OR2D2,4,,6913731
13,31506833,42320,TEX26,4,,31549153
14,102973197,2931,ANKRD9,4,,102976128
16,2889573,3179,PRSS30P,4,,2892752
17,40950853,12752,CNTD1,4,,40963605
17,76183397,20385,AFMID,4,,76203782
19,45010210,23338,CEACAM20,4,,45033548
19,9203920,942,OR1M1,4,,9204862
19,7049350,2396,MBD3L2,4,,7051746
19,11485382,2245,SWSAP1,4,,11487627
19,50655804,10734,IZUMO2,4,,50666538
19,3544196,13386,MFSD12,4,,3557582
19,15121538,12545,CCDC105,4,,15134083
1,27276046,10855,KDF1,4,,27286901
1,229456751,21937,CCSAP,4,,229478688
1,248366369,939,OR2M3,4,,248367308
1,248737101,957,OR2T34,4,,248738058
1,40713572,3793,TMCO2,4,,40717365
1,54519244,48077,TCEANC2,4,,54567321
1,247614330,954,OR2B11,4,,247615284
1,18807423,5057,KLHDC7A,4,,18812480
1,20617411,63976,VWA5B1,4,,20681387
1,111889181,6458,PIFO,4,,111895639
1,158576228,942,OR10Z1,4,,158577170
1,158735533,939,OR6N1,4,,158736472
20,37075296,4268,SNHG11,4,,37079564
20,44515129,1109,SPATA25,4,,44516238
20,2795632,844,C20orf141,4,,2796476
2,85048790,59579,TRABD2A,4,,85108369
7,156431059,2289,C7orf13,4,,156433348
2,54558070,30644,C2orf73,4,,54588714
7,141618675,945,OR9A4,4,,141619620
2,103378489,55649,TMEM182,4,,103434138
3,97540883,122947,CRYBG3,4,,97663830
3,63805040,29272,C3orf49,4,,63834312
3,50316457,9088,LSMEM2,4,,50325545
4,130017281,16562,C4orf33,4,,130033843
5,121465207,24059,ZNF474,4,,121489266
5,6448735,48099,UBE2QL1,4,,6496834
5,93076014,1295,POU5F2,4,,93077309
5,150309997,16149,ZNF300P1,4,,150326146
5,132157832,8758,SHROOM1,4,,132166590
6,123317115,76949,CLVS2,4,,123394064
7,142723286,933,OR9A2,4,,142724219
7,142636602,1355,C7orf34,4,,142637957
7,143701089,936,OR6B1,4,,143702025
7,141536077,5144,PRSS37,4,,141541221
7,138279029,84761,SVOPL,4,,138363790
8,37791799,5848,GOT1L1,4,,37797647
8,88882970,3326,DCAF4L2,4,,88886296
9,138387025,4736,C9orf116,4,,138391761
9,139648839,3892,LCN8,4,,139652731
9,139607023,12147,FAM69B,4,,139619170
9,130683807,5963,PIP5KL1,4,,130689770
9,95571892,28847,ANKRD19P,4,,95600739
9,34621454,6557,ARID3C,4,,34628011
9,35042204,3784,C9orf131,4,,35045988
9,107360737,957,OR13C5,4,,107361694
9,107331448,963,OR13C8,4,,107332411
9,107298050,1044,OR13C3,4,,107299094
9,125315448,993,OR1N2,4,,125316441
X,69282340,1689,OTUD6A,4,,69284029
X,127184940,1442,ACTRT1,4,,127186382
20,18794369,666,SCP2D1,4,,18795035
20,34556502,62120,CNBD2,4,,34618622
20,42965797,13635,R3HDML,4,,42979432
11,4388492,1124,OR52B4,4,,4389616
12,64586418,29658,C12orf66,4,,64616076
12,14956505,20286,C12orf60,4,,14976791
14,65016619,39478,PPP1R36,4,,65056097
14,51338877,32811,ABHD12B,4,,51371688
15,38226807,16816,TMCO5A,4,,38243623
16,22103858,64429,VWA3A,4,,22168287
16,2016874,2102,RNF151,4,,2018976
17,60447578,46261,EFCAB3,4,,60493839
17,34087915,4183,C17orf50,4,,34092098
17,62745779,32338,LOC146880,4,,62778117
18,51851061,29882,STARD6,4,,51880943
18,29339658,1185,SLC25A52,4,,29340843
19,58417141,10837,ZNF417,4,,58427978
19,46651038,13523,IGFL2,4,,46664561
19,39220831,14283,CAPN12,4,,39235114
19,32896654,80145,DPY19L3,4,,32976799
19,36249043,11034,PROSER3,4,,36260077
19,21541734,29650,ZNF738,4,,21571384
19,23921996,19697,ZNF681,4,,23941693
1,11006529,35565,C1orf127,4,,11042094
1,84764048,52433,SAMD13,4,,84816481
1,202137178,21399,PTPRVP,4,,202158577
1,205538111,33935,MFSD4,4,,205572046
1,47011315,5572,KNCN,4,,47016887
1,32674694,7103,DCDC2B,4,,32681797
1,33722173,44147,ZNF362,4,,33766320
1,38259773,7505,MANEAL,4,,38267278
1,43747555,3733,C1orf210,4,,43751288
1,46085715,4016,CCDC17,4,,46089731
21,14410486,80085,ANKRD30BP2,4,,14490571
21,43442377,2652,ZNF295-AS1,4,,43445029
21,43522243,6401,UMODL1-AS1,4,,43528644
22,21899957,5793,RIMBP3C,4,,21905750
22,31318294,4346,MORC2-AS1,4,,31322640
22,40139048,150746,ENTHD1,4,,40289794
22,41625513,11422,CHADL,4,,41636935
22,46639909,6284,CDPF1,4,,46646193
2,6072818,47532,LINC01105,4,,6120350
2,178414880,2644,TTC30B,4,,178417524
2,132118064,3667,WTH3DI,4,,132121731
2,111132685,9428,LINC01106,4,,111142113
2,239133753,6565,LOC151174,4,,239140318
2,33951127,2157,MYADML,4,,33953284
2,230899689,34026,SLC16A14,4,,230933715
2,74729743,2449,LBX2-AS1,4,,74732192
3,19920965,54741,EFHB,4,,19975706
3,157261132,35548,PQLC2L,4,,157296680
3,28390639,177218,ZCWPW2,4,,28567857
3,196669493,1391,NCBP2-AS2,4,,196670884
4,141364528,55003,MGAT4D,4,,141419531
4,165878099,2174,FAM218A,4,,165880273
5,140372,49715,PLEKHG4B,4,,190087
5,180467224,21299,BTNL9,4,,180488523
5,156589343,3936,FAM71B,4,,156593279
7,151125917,11339,CRYGN,4,,151137256
7,148799877,23561,ZNF425,4,,148823438
8,125954249,9088,LINC00964,4,,125963337
9,213107,2786,C9orf66,4,,215893
9,139377946,2573,C9orf163,4,,139380519
9,37753799,25170,TRMT10B,4,,37778969
9,130478342,15537,TTC16,4,,130493879
9,96208781,7093,FAM120AOS,4,,96215874
X,57618268,5642,ZXDB,4,,57623910
X,119029935,24744,AKAP14,4,,119054679
X,119370308,8814,NKAPP1,4,,119379122
X,69454504,6007,AWAT1,4,,69460511
11,26688565,55009,SLC5A12,4,,26743574
14,77843761,13826,SAMD15,4,,77857587
14,89081173,177923,EML5,4,,89259096
17,30593194,58486,RHBDL3,4,,30651680
17,6944948,2294,SLC16A11,4,,6947242
17,6679551,11414,FBXO39,4,,6690965
19,9868150,11260,ZNF846,4,,9879410
19,12125531,21025,ZNF433,4,,12146556
19,37717365,17461,ZNF383,4,,37734826
1,47308766,57381,CYP4Z2P,4,,47366147
20,30458504,72354,TTLL9,4,,30530858
2,187558788,69724,FAM171B,4,,187628512
2,74745257,8151,DQX1,4,,74753408
3,161062579,27292,SPTSSB,4,,161089871
5,79783799,54583,FAM151B,4,,79838382
7,48964156,2893,CDC14C,4,,48967049
9,71151497,4286,TMEM252,4,,71155783
5,76145825,71231,S100Z,4,,76217056
X,52841227,6095,XAGE5,4,,52847322
19,49109999,972,SPACA4,4,,49110971
X,8758836,10542,FAM9A,4,,8769378
21,30565814,94712,LINC00189,4,,30660526
10,122216465,132911,PPAPDC1A,4,,122349376
3,39149151,31243,TTC21A,4,,39180394
19,7741942,2777,MCEMP1,4,,7744719
1,55446336,11630,TMEM61,4,,55457966
1,48688356,25960,SLC5A9,4,,48714316
1,145586492,2943,NUDT17,4,,145589435
2,101964815,39150,CREG2,4,,102003965
2,73872045,40649,ALMS1P,4,,73912694
2,88824168,4935,TEX37,4,,88829103
17,62962667,9036,AMZ2P1,4,,62971703
17,4337218,54281,SPNS3,4,,4391499
19,58920040,9652,ZNF584,4,,58929692
5,175490711,51090,FAM153B,4,,175541801
8,143293440,191170,TSNARE1,4,,143484610
8,23145604,8188,R3HCC1,4,,23153792
8,99076749,29089,ERICH5,4,,99105838
3,113367232,48261,KIAA2018,4,,113415493
11,55418379,936,OR4S2,4,,55419315
11,55746178,7703,OR7E5P,4,,55753881
11,56949220,9968,LRRC55,4,,56959188
7,88423419,1612,C7orf62,4,,88425031
11,128769459,6505,C11orf45,4,,128775964
11,124933012,27400,SLC37A2,4,,124960412
11,123813573,972,OR6T1,4,,123814545
11,59807747,7769,OOSP2,4,,59815516
13,46115431,74443,ERICH6B,4,,46189874
13,53063127,98098,TPTE2P3,4,,53161225
11,65122281,2801,TIGD3,4,,65125082
10,15137383,1935,C10orf111,4,,15139318
7,54610017,28756,VSTM2A,4,,54638773
7,75831210,85399,SRRM3,4,,75916609
7,6793739,44657,RSPH10B,4,,6838396
11,71544245,4363,DEFB108B,4,,71548608
8,12250792,7082,DEFB109P1,4,,12257874
6,49928004,3814,DEFB114,4,,49931818
20,29992647,1422,DEFB121,4,,29994069
20,30053308,7508,DEFB124,4,,30060816
20,68312,8902,DEFB125,4,,77214
17,34071529,8368,GAS2L2,4,,34079897
20,61141437,7331,C20orf166-AS1,4,,61148768
16,29912146,5231,ASPHD1,4,,29917377
X,23926122,31502,CXorf58,4,,23957624
9,124922186,40181,MORN5,4,,124962367
19,55738001,2631,TMEM86B,4,,55740632
2,219891269,15004,CCDC108,4,,219906273
16,21995185,17246,PDZD9,4,,22012431
14,94908800,10322,SERPINA11,4,,94919122
11,66059372,4763,TMEM151A,4,,66064135
10,23605519,28253,C10orf67,4,,23633772
19,5720687,58055,CATSPERD,4,,5778742
1,161334520,3153,CFAP126,4,,161337673
5,52405671,5285,LOC257396,4,,52410956
21,39578249,2489,DSCR10,4,,39580738
1,23953823,13233,MDS2,4,,23967056
7,1654105,2223,TFAMP1,4,,1656328
X,48160984,4630,SSX9,4,,48165614
11,124189157,936,OR8D2,4,,124190093
11,126872804,3149,KIRREL3-AS3,4,,126875953
11,62847411,64282,SLC22A24,4,,62911693
11,18725851,21926,IGSF22,4,,18747777
12,80603232,169638,OTOGL,4,,80772870
12,122089292,18268,MORN3,4,,122107560
12,121407640,2455,HNF1A-AS1,4,,121410095
13,46354415,71431,SIAH3,4,,46425846
14,75319735,10802,PROX2,4,,75330537
14,78227172,8913,C14orf178,4,,78236085
15,69373189,14974,EWSAT1,4,,69388163
15,73735498,116855,REC114,4,,73852353
16,616994,2501,NHLRC4,4,,619495
17,71745408,79268,LINC00469,4,,71824676
17,62461568,3192,MILR1,4,,62464760
17,8123947,3414,LINC00324,4,,8127361
17,18441114,87816,CCDC144B,4,,18528930
17,56618947,2786,C17orf47,4,,56621733
17,20353175,17673,LGALS9B,4,,20370848
17,81037566,15305,METRNL,4,,81052871
19,55999869,30597,SSC5D,4,,56030466
19,58258163,11364,ZNF776,4,,58269527
19,41246760,9068,C19orf54,4,,41255828
19,42817476,11738,TMEM145,4,,42829214
19,44037339,2945,ZNF575,4,,44040284
19,51670584,6196,SIGLEC17P,4,,51676780
19,51760963,11619,SIGLECL1,4,,51772582
19,52494586,16897,ZNF615,4,,52511483
19,52567718,31300,ZNF841,4,,52599018
19,8841315,1056,OR2Z1,4,,8842371
19,29777917,238742,LOC284395,4,,30016659
19,55866275,8345,FAM71E2,4,,55874620
19,6426047,7743,SLC25A41,4,,6433790
19,16830786,97988,NWD1,4,,16928774
1,113263188,6668,FAM19A3,4,,113269856
1,145470507,5140,ANKRD34A,4,,145475647
1,155290250,3688,RUSC1-AS1,4,,155293938
1,159804263,20874,C1orf204,4,,159825137
1,162343514,3130,C1orf111,4,,162346644
22,24235896,5221,MIF-AS1,4,,24241117
2,47314129,68388,C2orf61,4,,47382517
2,11239976,32326,FLJ33534,4,,11272302
3,116428634,7253,TUSC7,4,,116435887
3,48413708,22482,FBXW12,4,,48436190
3,40566368,14917,ZNF621,4,,40581285
3,126911973,5054,C3orf56,4,,126917027
3,151153777,4801,IGSF10,4,,151158578
3,44626455,11102,ZNF660,4,,44637557
4,41983712,4772,DCAF4L1,4,,41988484
4,90165428,63733,GPRIN3,4,,90229161
4,44624353,29305,YIPF7,4,,44653658
5,85578261,15104,NBPF22P,4,,85593365
5,150655925,27409,SLC36A3,4,,150683334
5,64013977,50519,SREK1IP1,4,,64064496
5,179068544,3503,C5orf60,4,,179072047
5,17130136,87395,LOC285696,4,,17217531
7,155293952,32587,CNPY1,4,,155326539
7,41733513,85463,INHBA-AS1,4,,41818976
7,45022626,3633,SNHG15,4,,45026259
7,150076405,19314,ZNF775,4,,150095719
7,96597826,45551,DLX6-AS1,4,,96643377
7,107296960,5283,SLC26A4-AS1,4,,107302243
8,8086091,16296,FAM86B3P,4,,8102387
8,16884746,95402,MICU3,4,,16980148
8,144328990,6771,ZFP41,4,,144335761
8,67900366,40420,PPP1R42,4,,67940786
9,91605777,5280,C9orf47,4,,91611057
9,90497771,6043,SPATA31E1,4,,90503814
9,70917782,2218,FOXD4L3,4,,70920000
X,139791923,5073,LINC00632,4,,139796996
X,103294515,2506,H2BFM,4,,103297021
X,130836677,127994,FIRRE,4,,130964671
Y,21617316,47723,BCORP1,4,,21665039
10,74927876,74063,FAM149B1,4,,75001939
7,130126897,4116,MESTIT1,4,,130131013
16,88744089,8793,SNAI3,4,,88752882
21,32185014,556,KRTAP8-1,4,,32185570
21,31743708,849,KRTAP13-2,4,,31744557
21,31874189,219,KRTAP19-5,4,,31874408
11,55761156,945,OR5F1,4,,55762101
13,24883715,12954,C1QTNF9,4,,24896669
16,31094744,5386,PRSS53,4,,31100130
16,85131957,14157,FAM92B,4,,85146114
17,79632065,1602,OXLD1,4,,79633667
18,5238098,8407,LINC00667,4,,5246505
19,35225479,8295,ZNF181,4,,35233774
1,173577474,61527,ANKRD45,4,,173639001
1,1470157,5583,TMEM240,4,,1475740
2,127941411,21932,CYP27C1,4,,127963343
2,234684324,57745,MROH2A,4,,234742069
8,124657914,7276,KLHL38,4,,124665190
11,60552820,15958,MS4A10,4,,60568778
13,52638899,64329,NEK5,4,,52703228
14,58030639,301953,SLC35F4,4,,58332592
17,33875143,9967,SLFN14,4,,33885110
19,30017490,37736,VSTM2B,4,,30055226
1,12998504,3849,PRAMEF9,4,,13002353
1,13629924,5375,PRAMEF10,4,,13635299
1,247875130,927,OR6F1,4,,247876057
1,248058888,945,OR2W3,4,,248059833
1,45271581,1376,TCTEX1D4,4,,45272957
3,106959538,8181,LINC00883,4,,106967719
4,87744620,25796,SLC10A6,4,,87770416
5,54515424,7719,MCIDAS,4,,54523143
5,99871008,51436,FAM174A,4,,99922444
6,27356496,15190,ZNF391,4,,27371686
7,142749437,942,OR6V1,4,,142750379
9,125239236,969,OR1J1,4,,125240205
X,69397332,28221,DGAT2L6,4,,69425553
12,132568827,42058,EP400NL,4,,132610885
13,114462215,52684,TMEM255B,4,,114514899
19,58111252,10214,ZNF530,4,,58121466
2,10281508,70348,C2orf48,4,,10351856
3,196281049,14496,WDR53,4,,196295545
3,100120036,55134,LNP1,4,,100175170
7,55954969,54949,ZNF713,4,,56009918
7,102815461,105298,DPY19L2P2,4,,102920759
Y,14517914,15475,GYG2P1,4,,14533389
19,21688436,32643,ZNF429,4,,21721079
1,152784446,1139,LCE1B,4,,152785585
1,152769226,1431,LCE1D,4,,152770657
1,152758752,2149,LCE1E,4,,152760901
1,152748847,598,LCE1F,4,,152749445
1,152647790,1259,LCE2C,4,,152649049
1,152635886,1249,LCE2D,4,,152637135
17,15635590,12508,TBC1D26,4,,15648098
6,24357130,1382,KAAG1,4,,24358512
Y,20297334,1581,XKRY2,4,,20298915
10,27687116,16181,PTCHD3,4,,27703297
10,118083939,55602,CCDC172,4,,118139541
11,62554873,2999,TMEM179B,4,,62557872
11,73661363,19969,DNAJB13,4,,73681332
15,90544722,80710,ZNF710,4,,90625432
19,7562444,10892,C19orf45,4,,7573336
2,24337678,8669,PFN4,4,,24346347
2,219221578,11239,CATIP,4,,219232817
2,238707387,44064,RBM44,4,,238751451
3,44283377,90213,TOPAZ1,4,,44373590
7,49813256,143090,VWC2,4,,49956346
8,145086581,15434,SPATC1,4,,145102015
2,239047362,14185,KLHL30,4,,239061547
13,45766987,8188,KCTD4,4,,45775175
5,153769328,56054,SAP30L-AS1,4,,153825382
21,46047039,1256,KRTAP10-9,4,,46048295
21,45970239,1149,KRTAP10-2,4,,45971388
21,46031995,876,KRTAP10-8,4,,46032871
21,46074129,447,KRTAP12-4,4,,46074576
6,127759550,80950,SOGA3,4,,127840500
13,27844463,3364,RASL11A,4,,27847827
9,46687556,59264,KGFLP1,4,,46746820
10,21414691,20797,C10orf113,4,,21435488
11,6734375,8735,GVINP1,4,,6743110
11,64937706,2982,SPDYC,4,,64940688
11,74201555,3203,LIPT2,4,,74204758
13,39612447,11797,NHLRC3,4,,39624244
14,58862643,12776,TOMM20L,4,,58875419
19,10152031,32782,C3P1,4,,10184813
19,23157684,28326,ZNF728,4,,23186010
19,23945815,65104,RPSAP58,4,,24010919
1,182376755,7193,LINC00272,4,,182383948
2,209030070,24703,C2orf80,4,,209054773
2,233734803,8611,C2orf82,4,,233743414
3,49828166,9102,CDHR4,4,,49837268
3,51895644,1796,IQCF2,4,,51897440
7,99746521,5314,LAMTOR4,4,,99751835
8,23082733,5706,LOC389641,4,,23088439
9,41952398,2779,GLIDR,4,,41955177
10,4913858,44607,AKR1C6P,4,,4958465
11,4510108,1030,OR52K1,4,,4511138
11,5410606,1058,OR51M1,4,,5411664
11,59244902,936,OR4D10,4,,59245838
11,123676115,942,OR6M1,4,,123677057
15,102358389,939,OR4F15,4,,102359328
19,1753661,21783,ONECUT3,4,,1775444
19,9236687,939,OR7G3,4,,9237626
1,13607699,3834,PRAMEF8,4,,13611533
1,100174258,57091,FRRS1,4,,100231349
1,248486931,939,OR2M7,4,,248487870
9,35869459,939,OR13J1,4,,35870398
9,107366951,957,OR13C2,4,,107367908
7,1748797,38793,ELFN1,4,,1787590
7,143747494,936,OR2A5,4,,143748430
19,53430387,15460,ZNF321P,4,,53445847
7,77976558,12212,RPL13AP17,4,,77988770
11,109292845,7048,C11orf87,4,,109299893
11,125703210,6757,PATE4,4,,125709967
14,69951470,43745,PLEKHD1,4,,69995215
15,39542869,4174,C15orf54,4,,39547043
15,93160678,38353,FAM174B,4,,93199031
17,260117,4340,C17orf97,4,,264457
17,80317122,4530,TEX19,4,,80321652
19,685520,9941,PRSS57,4,,695461
19,5904851,5412,VMAC,4,,5910263
19,40170013,7000,LGALS17A,4,,40177013
19,52873169,15877,ZNF880,4,,52889046
1,24882566,53252,NCMAP,4,,24935818
1,67557858,42796,C1orf141,4,,67600654
22,46481876,27932,MIRLET7BHG,4,,46509808
2,71409867,44366,PAIP2B,4,,71454233
4,2043776,1921,C4orf48,4,,2045697
5,6310553,26852,FLJ33360,4,,6337405
6,170188885,10036,LINC00242,4,,170198921
7,96110937,21898,C7orf76,4,,96132835
9,65487272,7114,FAM74A4,4,,65494386
9,112961845,8568,C9orf152,4,,112970413
Y,2477305,47965,CD99P1,4,,2525270
10,99609994,21341,GOLGA7B,4,,99631335
12,52211675,14026,FIGNL2,4,,52225701
17,43697694,17635,MGC57346,4,,43715329
1,248616098,975,OR2T2,4,,248617073
7,128281294,19758,LINC01000,4,,128301052
7,100054237,7657,C7orf61,4,,100061894
4,85887970,40198,WDFY3-AS2,4,,85928168
10,120863576,33920,FAM45A,4,,120897496
5,12574968,230327,LINC01194,4,,12805295
7,34758473,115470,NPSR1-AS1,4,,34873943
X,151560690,81,MIR105-1,4,,151560771
X,151562883,81,MIR105-2,4,,151562964
9,123007256,72,MIR147A,4,,123007328
5,156768606,4123,FNDC9,4,,156772729
17,34797171,10921,TBC1D3B,4,,34808092
10,695887,2708,PRR26,4,,698595
9,86237963,21082,IDNK,4,,86259045
3,93733214,14240,STX19,4,,93747454
1,192286121,50293,RGS21,4,,192336414
17,29036625,60443,SUZ12P1,4,,29097068
1,2976180,8109,LINC00982,4,,2984289
1,231298673,58641,TRIM67,4,,231357314
22,25115000,55687,PIWIL3,4,,25170687
2,31395921,44490,CAPN14,4,,31440411
2,111133764,8338,LINC01123,4,,111142102
3,52570620,3966,SMIM4,4,,52574586
4,14911584,92085,CPEB2-AS1,4,,15003669
4,186350487,20495,C4orf47,4,,186370982
5,69782327,5287,LOC441081,4,,69787614
5,92877577,39449,NR2F1-AS1,4,,92917026
6,116782532,2402,FAM26F,4,,116784934
7,6774935,16297,PMS2CL,4,,6791232
7,99905324,14495,SPDYE3,4,,99919819
X,134883487,8032,CT45A3,4,,134891519
X,142113703,8363,SPANXN4,4,,142122066
1,1353799,3025,ANKRD65,4,,1356824
1,247654369,1342,OR2W5,4,,247655711
6,29274466,966,OR14J1,4,,29275432
7,143806675,957,OR2A2,4,,143807632
7,419390,3455,LOC442497,4,,422845
7,72467817,8649,STAG3L3,4,,72476466
Y,24636543,24241,PRY2,4,,24660784
4,113569159,68,MIR302D,4,,113569227
7,143883175,9616,ARHGEF35,4,,143892791
1,160287054,1206,SUMO1P3,4,,160288260
8,49984899,3743,C8orf22,4,,49988642
11,32623625,192579,CCDC73,4,,32816204
11,8986221,11609,TMEM9B-AS1,4,,8997830
17,37092684,30971,FBXO47,4,,37123655
16,74442528,12840,CLEC18B,4,,74455368
X,134847184,44355,CT45A1,4,,134891539
13,24463027,3215,C1QTNF9B-AS1,4,,24466242
22,30752623,22021,CCDC157,4,,30774644
3,39449881,149,SNORA6,4,,39450030
14,101522555,82,MIR323B,4,,101522637
14,101526909,102,MIR496,4,,101527011
19,54188262,83,MIR515-1,4,,54188345
19,54200786,85,MIR525,4,,54200871
19,54204480,61,MIR520B,4,,54204541
19,54214255,87,MIR524,4,,54214342
X,49773038,84,MIR500A,4,,49773122
X,49774329,84,MIR501,4,,49774413
X,146342049,94,MIR509-1,4,,146342143
6,133138357,133,SNORA33,4,,133138490
15,66795148,100,SNORD16,4,,66795248
15,66795582,70,SNORD18A,4,,66795652
15,66794359,70,SNORD18B,4,,66794429
15,66793589,67,SNORD18C,4,,66793656
13,27829537,126,SNORA27,4,,27829663
11,8705773,130,SNORA45A,4,,8705903
11,811680,134,SNORA52,4,,811814
16,22448328,55213,SMG1P1,4,,22503541
14,74083547,3045,ACOT6,4,,74086592
8,128958804,2165,TMEM75,4,,128960969
10,120819524,126,SNORA19,4,,120819650
8,67834708,76,SNORD87,4,,67834784
4,206388,43385,ZNF876P,4,,249773
12,9436252,30432,LOC642846,4,,9466684
17,73629513,7973,SMIM5,4,,73637486
9,141044564,27321,TUBBP5,4,,141071885
1,39875175,6979,KIAA0754,4,,39882154
10,91589249,11369,LINC00865,4,,91600618
18,65183782,383074,LOC643542,4,,65566856
7,149535508,29060,ZNF862,4,,149564568
15,84904524,9596,GOLGA6L4,4,,84914120
6,111804674,118823,TRAF3IP2-AS1,4,,111923497
1,762970,31856,LINC01128,4,,794826
17,8294022,7122,RNF222,4,,8301144
1,19934300,838,RPS14P3,4,,19935138
16,56710027,1762,MT1IP,4,,56711789
X,103357216,3322,ZCCHC18,4,,103360538
4,9446259,5981,DEFB131,4,,9452240
11,113650517,690,CLDN25,4,,113651207
1,146571065,14863,NBPF13P,4,,146585928
5,127357243,61523,LINC01184,4,,127418766
3,28616768,183060,LINC00693,4,,28799828
11,67559237,13570,FAM86C2P,4,,67572807
17,26691289,884,SEBOX,4,,26692173
22,24834244,56798,ADORA2A-AS1,4,,24891042
3,129931662,60987,COL6A4P2,4,,129992649
13,41025070,30073,LINC00598,4,,41055143
15,82632349,385849,GOLGA6L10,4,,83018198
7,135347220,13940,C7orf73,4,,135361160
5,70370029,18868,LOC647859,4,,70388897
11,3402190,28188,TSSC2,4,,3430378
16,2390922,85778,ABCA17P,4,,2476700
13,114518582,27232,GAS6-AS1,4,,114545814
16,2653384,27111,LOC652276,4,,2680495
17,7478030,135,SNORA48,4,,7478165
18,44757493,18061,SKOR2,4,,44775554
2,24397911,16656,FAM228A,4,,24414567
9,69199479,2725,FOXD4L6,4,,69202204
16,33262119,2040,TP53TG3C,4,,33264159
1,14361,15009,WASH7P,4,,29370
11,93465526,139,SNORA8,4,,93465665
2,232320510,137,SNORA75,4,,232320647
5,111497181,133,SNORA13,4,,111497314
2,91824708,23267,LOC654342,4,,91847975
12,1929432,16486,LRTM2,4,,1945918
2,228085767,104113,LOC654841,4,,228189880
14,101514994,91,MIR544A,4,,101515085
X,73506938,106,MIR545,4,,73507044
19,20578625,29146,ZNF826P,4,,20607771
7,45144504,137,SNORA5C,4,,45144641
10,101996912,147,SNORA12,4,,101997059
6,31590855,132,SNORA38,4,,31590987
1,155889699,134,SNORA80E,4,,155889833
9,139620555,134,SNORA43,4,,139620689
11,2985000,123,SNORA54,4,,2985123
20,37078011,136,SNORA60,4,,37078147
20,37062504,138,SNORA71D,4,,37062642
5,172447728,204,SNORA74B,4,,172447932
3,186504463,178,SNORA81,4,,186504641
17,19460872,152,SNORA59A,4,,19461024
9,35752987,1287,MSMP,4,,35754274
14,101489661,96,MIR411,4,,101489757
6,135560297,97,MIR548A2,4,,135560394
6,119390211,97,MIR548B,4,,119390308
12,65016288,97,MIR548C,4,,65016385
8,124360273,97,MIR548D1,4,,124360370
1,35135199,96,MIR552,4,,35135295
3,195426271,97,MIR570,4,,195426368
5,36147993,97,MIR580,4,,36148090
6,45165410,97,MIR586,4,,45165507
7,127721912,100,MIR593,4,,127722012
8,9599181,97,MIR597,4,,9599278
8,10892715,97,MIR598,4,,10892812
9,126164803,79,MIR601,4,,126164882
14,31483851,97,MIR624,4,,31483948
15,70371710,97,MIR629,4,,70371807
15,72879557,97,MIR630,4,,72879654
15,75645951,75,MIR631,4,,75646026
X,8095005,97,MIR651,4,,8095102
X,109298556,98,MIR652,4,,109298654
7,93112071,96,MIR653,4,,93112167
14,101533060,78,MIR656,4,,101533138
18,109064,13158,ROCK1P1,4,,122222
3,195384909,30826,SDHAP2,4,,195415735
17,39253233,1142,KRTAP4-8,4,,39254375
Y,9236075,132210,TSPY4,4,,9368285
21,34537775,4766,LINC01548,4,,34542541
1,39987951,37419,PPIEL,4,,40025370
9,43684884,237589,CNTNAP3B,4,,43922473
X,72064875,3761,DMRTC1B,4,,72068636
5,76382622,61554,ZBED3-AS1,4,,76444176
6,22134830,12592,CASC14,4,,22147422
8,133036466,35161,OC90,4,,133071627
15,20767673,13353,GOLGA8CP,4,,20781026
15,79484048,92239,ANKRD34C-AS1,4,,79576287
19,55940104,14126,SHISA7,4,,55954230
16,14916288,2271,ABCC6P2,4,,14918559
19,58380746,19696,ZNF814,4,,58400442
16,21807950,22545,RRN3P1,4,,21830495
16,22019455,76517,C16orf52,4,,22095972
1,177975274,31868,LOC730102,4,,178007142
17,39215492,852,KRTAP2-3,4,,39216344
2,102013822,77343,RFX8,4,,102091165
14,101459572,74,SNORD114-31,4,,101459646
21,37093012,94,MIR802,4,,37093106
4,7432020,4680,PSAPL1,4,,7436700
15,24803303,29623,PWRN1,4,,24832926
3,101395273,2784,ZBTB11-AS1,4,,101398057
15,25330530,94,SNORD116-18,4,,25330624
15,25335068,94,SNORD116-22,4,,25335162
15,25339182,94,SNORD116-24,4,,25339276
15,25351666,85,SNORD116-29,4,,25351751
4,119199916,1062,SNHG8,4,,119200978
16,70563401,101,SNORD111B,4,,70563502
9,119943344,136,SNORA70C,4,,119943480
X,146342052,91,MIR509-2,4,,146342143
14,101530831,84,MIR541,4,,101530915
17,11985215,98,MIR744,4,,11985313
6,30552108,86,MIR877,4,,30552194
14,101341369,72,MIR665,4,,101341441
12,24365354,75,MIR920,4,,24365429
20,62551025,99,MIR941-1,4,,62551124
20,62551220,72,MIR941-4,4,,62551292
14,101498323,78,MIR543,4,,101498401
20,62551220,72,MIR941-2,4,,62551292
5,15935290,79,MIR887,4,,15935369
8,145619363,82,MIR939,4,,145619445
20,62551220,72,MIR941-3,4,,62551292
9,115867002,6955,FAM225B,4,,115873957
18,19746858,2071,GATA6-AS1,4,,19748929
3,47053031,1926,NRADDP,4,,47054957
1,99469831,144577,LOC100129620,4,,99614408
8,65285774,5617,MIR124-2HG,4,,65291391
22,17517459,22223,CECR7,4,,17539682
18,77905806,23810,PARD6G-AS1,4,,77929616
7,105205579,16397,EFCAB10,4,,105221976
12,58120022,2117,AGAP2-AS1,4,,58122139
7,6676952,20958,ZNF316,4,,6697910
19,48471302,24125,BSPH1,4,,48495427
X,84189156,740,UBE2DNL,4,,84189896
16,31711933,6812,CLUHP3,4,,31718745
8,72756350,212197,LOC100132891,4,,72968547
X,154051622,11315,SMIM9,4,,154062937
15,83023840,60501,UBE2Q2P2,4,,83084341
20,61665568,2812,LINC00029,4,,61668380
11,125658005,3490,PATE3,4,,125661495
3,183959192,85,MIR1224,4,,183959277
19,53547990,6390,ERVV-2,4,,53554380
X,149106765,78253,LINC00894,4,,149185018
12,50222325,12612,BCDIN3D-AS1,4,,50234937
15,22051852,30951,POTEB2,4,,22082803
15,74209808,10319,LOXL1-AS1,4,,74220127
11,102654406,53091,WTAPP1,4,,102707497
15,32698811,28439,ULK4P2,4,,32727250
11,77850838,34185,KCTD21-AS1,4,,77885023
12,133498018,34874,ZNF605,4,,133532892
19,58341661,15945,ZNF587B,4,,58357606
1,117214370,79,MIR320B1,4,,117214449
6,33967748,80,MIR1275,4,,33967828
17,16185327,75,MIR1288,4,,16185402
1,236016299,61,MIR1537,4,,236016360
X,113949649,112,MIR1298,4,,113949761
10,105154009,149,MIR1307,4,,105154158
13,54886106,77,MIR1297,4,,54886183
15,52569313,84,MIR1266,4,,52569397
14,77732560,73,MIR1260A,4,,77732633
17,19247818,69,MIR1180,4,,19247887
8,129162361,73,MIR1208,4,,129162434
5,154065335,86,MIR1303,4,,154065421
12,97885686,70,MIR1251,4,,97885756
2,53897449,189721,GPR75-ASB3,4,,54087170
20,18118498,5314,PET117,4,,18123812
1,224444705,138,MIR320B2,4,,224444843
X,94318139,86,MIR548M,4,,94318225
11,43581205,98,MIR670,4,,43581303
13,53384184,91,MIR759,4,,53384275
16,30905223,83,MIR762,4,,30905306
X,113873917,85,MIR764,4,,113874002
13,41301963,48,MIR320D1,4,,41302011
11,117162061,825,BACE1-AS,4,,117162886
17,925715,84,MIR3183,4,,925799
3,69098108,78,MIR3136,4,,69098186
16,18496034,94,MIR3180-1,4,,18496128
1,67094122,78,MIR3117,4,,67094200
20,18451258,77,MIR3192,4,,18451335
1,249120575,67,MIR3124,4,,249120642
1,172107947,81,MIR3120,4,,172108028
10,103361173,81,MIR3158-1,4,,103361254
2,189997761,76,MIR3129,4,,189997837
17,79099676,79,MIR3065,4,,79099755
11,126858353,85,MIR3167,4,,126858438
16,70064248,77,MIR1972-2,4,,70064325
16,18505750,84,MIR3179-1,4,,18505834
14,95604255,68,MIR3173,4,,95604323
11,96074601,89,MIR1260B,4,,96074690
2,207647957,75,MIR3130-1,4,,207648032
15,93447628,77,MIR3175,4,,93447705
2,207647957,75,MIR3130-2,4,,207648032
16,1784985,82,MIR3177,4,,1785067
1,180407448,77,MIR3121,4,,180407525
17,66097695,34375,LINC00674,4,,66132070
17,54968630,86,MIR3614,4,,54968716
5,131701181,110,MIR3936,4,,131701291
2,134884695,68,MIR3679,4,,134884763
X,69242706,67,MIR676,4,,69242773
19,6416420,102,MIR3940,4,,6416522
22,31556047,58,MIR3928,4,,31556105
15,35664456,109,MIR3942,4,,35664565
8,96085138,86,MIR3150B,4,,96085224
3,177159708,310784,LINC00578,4,,177470492
17,39463951,1554,KRTAP16-1,4,,39465505
10,104209573,6477,RPARP-AS1,4,,104216050
9,132250938,25027,LINC00963,4,,132275965
17,180995,2284,LOC100506388,4,,183279
6,11044923,34454,ELOVL2-AS1,4,,11079377
21,37504064,24542,CBR3-AS1,4,,37528606
5,43067124,26536,LOC100506639,4,,43093660
1,234859788,7602,LINC01132,4,,234867390
17,74553845,7585,SNHG16,4,,74561430
3,194304996,6565,TMEM44-AS1,4,,194311561
16,2708389,15051,ERVK13-1,4,,2723440
6,30973728,29451,MUC22,4,,31003179
2,170550963,57433,PHOSPHO2-KLHL23,4,,170608396
6,7881482,183165,BLOC1S5-TXNDC5,4,,8064647
1,95583478,127031,TMEM56-RWDD3,4,,95710509
10,104613966,47689,C10orf32-ASMT,4,,104661655
16,66586465,26573,CKLF-CMTM1,4,,66613038
19,41284123,30223,RAB4B-EGLN2,4,,41314346
6,31707724,24900,MSH5-SAPCD1,4,,31732624
8,124238428,48299,ZHX1-C8orf76,4,,124286727
12,10998447,325777,PRH1-PRR4,4,,11324224
13,103459495,68856,BIVM-ERCC5,4,,103528351
17,15339331,127614,TVP23C-CDRT4,4,,15466945
11,62457733,37123,HNRNPUL2-BSCL2,4,,62494856
X,105883043,83,MIR548AN,4,,105883126
X,55477927,88,MIR4536-1,4,,55478015
7,93346239,78,MIR4652,4,,93346317
8,125834226,67,MIR4662A,4,,125834293
4,77496703,76,MIR548AH,4,,77496779
4,40504056,80,MIR4802,4,,40504136
10,106028093,70,MIR4482,4,,106028163
1,243509477,80,MIR4677,4,,243509557
7,29720349,95,MIR550A3,4,,29720444
15,51534386,75,MIR4713,4,,51534461
3,23375625,273257,MIR548AC,4,,23648882
17,6558758,70,MIR4520-1,4,,6558828
9,20502262,78,MIR4474,4,,20502340
1,98510798,109,MIR2682,4,,98510907
4,7312176,75,MIR4798,4,,7312251
2,202937975,131949,KIAA2012,4,,203069924
14,62147758,14783,HIF1A-AS1,4,,62162541
14,62213756,2051,HIF1A-AS2,4,,62215807
3,87138429,9423,LINC00506,4,,87147852
5,180256953,1665,HEIH,4,,180258618
16,30751511,5006,LOC100862671,4,,30756517
7,1200009,5585,LOC101927021,4,,1205594
17,67590127,309014,LINC01483,4,,67899141
2,166938040,220253,LOC101929680,4,,167158293
7,17414540,92340,LOC102659288,4,,17506880
19,42125343,8099,CEACAM4,3,,42133442
9,90459659,2680,CTSLP8,3,,90462339
2,83083926,967,LOC1720,3,,83084893
4,166198943,2232,GK3P,3,,166201175
10,75490319,1210,GLUD1P3,3,,75491529
14,31952149,5002,GPR33,3,,31957151
9,21277686,876,IFNA22P,3,,21278562
11,75111434,148,SNORD15A,3,,75111582
2,232321154,80,SNORD20,3,,232321234
1,93302845,95,SNORD21,3,,93302940
6,80451635,34,RNY4,3,,80451669
12,45580873,379,RNY5,3,,45581252
15,99797729,2752,HSP90B2P,3,,99800481
19,11998598,26767,ZNF69,3,,12025365
19,58125586,10499,ZNF134,3,,58136085
6,27325601,13703,ZNF204P,3,,27339304
4,152024978,65,SNORD73A,3,,152025043
11,62621375,65,SNORD29,3,,62621440
11,62620797,68,SNORD31,3,,62620865
11,62621134,70,SNORD30,3,,62621204
11,62622092,75,SNORD28,3,,62622167
11,62622483,72,SNORD27,3,,62622555
11,62622763,75,SNORD26,3,,62622838
11,62623036,67,SNORD25,3,,62623103
5,104435174,625,RAB9BP1,3,,104435799
1,229440128,1122,SPHAR,3,,229441250
22,32755892,11171,RFPL3S,3,,32767063
11,3411936,1209,OR7E12P,3,,3413145
1,17081128,9847,MST1L,3,,17090975
3,49190291,1543,LAMB2P1,3,,49191834
1,51752929,35011,TTC39A,3,,51787940
19,3851810,17217,ZFR2,3,,3869027
1,92634414,15868,KIAA1107,3,,92650282
9,34958191,24350,KIAA1045,3,,34982541
22,22974027,12985,POM121L1P,3,,22987012
7,123454192,5292,HYALP1,3,,123459484
11,61521500,3636,DKFZP434K028,3,,61525136
6,168185218,12321,LINC01558,3,,168197539
11,55594694,936,OR5L2,3,,55595630
3,98188323,1097,OR5K1,3,,98189420
19,11406814,19831,TSPAN16,3,,11426645
1,248569295,1110,OR2T1,3,,248570405
9,125437408,975,OR1L3,3,,125438383
20,47895481,79,SNORD12C,3,,47895560
1,28835069,158,SNORA73B,3,,28835227
1,173833312,43,SNORD81,3,,173833355
1,173834487,81,SNORD79,3,,173834568
17,27049599,72,SNORD4A,3,,27049671
1,173833970,71,SNORD80,3,,173834041
20,37053842,136,SNORA71B,3,,37053978
20,37055948,138,SNORA71A,3,,37056086
19,17973396,133,SNORA68,3,,17973529
1,93306275,133,SNORA66,3,,93306408
5,137896731,68,SNORD63,3,,137896799
X,135961357,73,SNORD61,3,,135961430
8,56986397,63,SNORD54,3,,56986460
6,31804852,64,SNORD52,3,,31804916
22,39715056,62,SNORD43,3,,39715118
17,27050446,63,SNORD42A,3,,27050509
19,49994431,86,SNORD35A,3,,49994517
19,49994163,66,SNORD34,3,,49994229
19,49993873,83,SNORD33,3,,49993956
19,49993222,82,SNORD32A,3,,49993304
1,28975111,135,RNU11,3,,28975246
15,60296420,1722,FOXB1,3,,60298142
7,127637561,2569,SND1-IT1,3,,127640130
14,90042559,1261,FOXN3-AS2,3,,90043820
15,83776323,29788,TM6SF1,3,,83806111
21,38378862,13096,RIPPLY3,3,,38391958
1,101003727,3856,GPR88,3,,101007583
5,111755279,1398,EPB41L4A-AS2,3,,111756677
17,33448630,9121,FNDC8,3,,33457751
17,8091650,1914,C17orf59,3,,8093564
2,70377016,41135,C2orf42,3,,70418151
1,55246751,20190,TTC22,3,,55266941
19,49621653,744,C19orf73,3,,49622397
16,67381257,37852,LRRC36,3,,67419109
4,159131400,45039,TMEM144,3,,159176439
19,10196794,7134,C19orf66,3,,10203928
14,24407939,15467,DHRS4-AS1,3,,24423406
12,109301904,157141,SVOP,3,,109459045
19,58082933,7310,ZNF416,3,,58090243
1,32681797,6175,TMEM234,3,,32687972
X,107224093,1507,TEX13B,3,,107225600
19,19976713,27580,ZNF253,3,,20004293
19,44220213,3956,IRGC,3,,44224169
5,140105743,88,VTRNA1-3,3,,140105831
6,138743180,77399,NHSL1,3,,138820579
19,57862641,8624,ZNF304,3,,57871265
X,118212597,71945,KIAA1210,3,,118284542
4,37246689,204398,NWD2,3,,37451087
3,113682983,92477,KIAA1407,3,,113775460
3,138823026,20979,BPESC1,3,,138844005
20,61640734,75689,LOC63930,3,,61716423
1,50883222,5897,DMRTA2,3,,50889119
14,102018559,3454,DIO3OS,3,,102022013
12,58013692,6242,SLC26A10,3,,58019934
11,55029657,8938,TRIM48,3,,55038595
19,56732671,9097,ZSCAN5A,3,,56741768
17,74733582,41754,MFSD11,3,,74775336
19,55219699,5256,LILRP2,3,,55224955
10,45798101,12955,OR13A1,3,,45811056
14,20388765,972,OR4K5,3,,20389737
11,4944603,966,OR51G1,3,,4945569
14,20403766,1076,OR4K1,3,,20404842
5,159678658,60949,CCNJL,3,,159739607
19,36229702,3649,IGFLR1,3,,36233351
1,249132376,11340,ZNF672,3,,249143716
19,52430687,18324,ZNF613,3,,52449011
1,26485510,3609,FAM110D,3,,26489119
19,40728114,4483,CNTD2,3,,40732597
4,419223,48775,ABCA11P,3,,467998
19,12460184,16291,ZNF442,3,,12476475
17,18427879,2281,FAM106A,3,,18430160
15,72668453,2676,HEXA-AS1,3,,72671129
8,22497883,1839,BIN3-IT1,3,,22499722
7,47834888,24556,C7orf69,3,,47859444
6,29892368,2624,HCG4B,3,,29894992
11,4935948,945,OR51G2,3,,4936893
11,55135359,1035,OR4A15,3,,55136394
11,58034263,1469,OR10W1,3,,58035732
7,99473684,972,OR2AE1,3,,99474656
1,247768887,930,OR2G3,3,,247769817
17,47787686,53832,FAM117A,3,,47841518
6,27878962,1212,OR2B2,3,,27880174
15,77516249,1497,LINC00597,3,,77517746
17,39202795,773,KRTAP2-1,3,,39203568
8,11225910,70256,FAM167A-AS1,3,,11296166
5,139739786,14936,SLC4A9,3,,139754722
17,39164773,593,KRTAP3-1,3,,39165366
17,39382899,1005,KRTAP9-2,3,,39383904
17,39394269,987,KRTAP9-8,3,,39395256
17,46799081,801,PRAC1,3,,46799882
X,106765679,82795,FRMPD3,3,,106848474
3,107096187,1294,CCDC54,3,,107097481
14,32544624,1281,ARHGAP5-AS1,3,,32545905
19,3769088,3131,RAX2,3,,3772219
7,47801073,5297,LINC00525,3,,47806370
X,133677406,3254,MIR503HG,3,,133680660
10,42970938,19847,LINC00839,3,,42990785
19,36500021,5120,ALKBH6,3,,36505141
12,110172013,39279,FAM222A-AS1,3,,110211292
1,28905049,3317,SNHG12,3,,28908366
17,39405938,967,KRTAP9-4,3,,39406905
17,39305175,879,KRTAP4-5,3,,39306054
17,39333697,763,KRTAP4-2,3,,39334460
22,44639556,69175,KIAA1644,3,,44708731
2,74724643,5800,LBX2,3,,74730443
20,642239,14584,SCRT2,3,,656823
15,32698811,28439,ULK4P1,3,,32727250
3,183948216,11901,VWA5B2,3,,183960117
1,24683488,58099,STPG1,3,,24741587
19,12035882,25706,ZNF700,3,,12061588
6,166352947,48580,LINC00473,3,,166401527
2,173587917,13017,RAPGEF4-AS1,3,,173600934
1,153965167,162425,NUP210L,3,,154127592
19,896502,16723,R3HDM4,3,,913225
22,25714223,1970,IGLL3P,3,,25716193
3,16306666,40928,OXNAD1,3,,16347594
16,70695106,24848,MTSS1L,3,,70719954
12,120427647,104652,CCDC64,3,,120532299
16,57546089,24388,CCDC102A,3,,57570477
3,194308401,45749,TMEM44,3,,194354150
1,45242163,98,SNORD46,3,,45242261
21,44881973,16130,LINC00313,3,,44898103
1,28919006,2082,RAB42,3,,28921088
11,537521,17395,LRRC56,3,,554916
12,64660762,123583,C12orf56,3,,64784345
3,10145818,4097,FANCD2OS,3,,10149915
3,196050416,14875,TM4SF19,3,,196065291
17,27051365,2584,TLCD1,3,,27053949
19,16272178,12158,CIB3,3,,16284336
5,178286953,24471,ZNF354B,3,,178311424
21,29911639,1038,LINC00161,3,,29912677
11,48266655,912,OR4X2,3,,48267567
11,7846583,936,OR5P3,3,,7847519
11,114392436,38181,NXPE1,3,,114430617
11,6942232,993,OR2D3,3,,6943225
11,6220453,963,OR52W1,3,,6221416
12,48596121,954,OR10AD1,3,,48597075
12,55614808,951,OR10A7,3,,55615759
14,20896969,6832,KLHL33,3,,20903801
16,67918780,1491,NRN1L,3,,67920271
16,29973350,11023,TMEM219,3,,29984373
17,56247016,924,OR4D2,3,,56247940
17,7761044,4557,CYB5D1,3,,7765601
17,4981753,17916,ZFP3,3,,4999669
18,72102962,21541,FAM69C,3,,72124503
19,33622997,43706,WDR88,3,,33666703
19,15197876,1068,OR1I1,3,,15198944
19,16126443,11829,LINC00661,3,,16138272
19,405442,3728,C2CD4C,3,,409170
1,45959597,6154,CCDC163P,3,,45965751
1,36179476,5314,C1orf216,3,,36184790
1,60456065,83377,C1orf87,3,,60539442
1,120106502,8697,HSD3BP4,3,,120115199
1,43735664,4009,TMEM125,3,,43739673
1,158368311,945,OR10T2,3,,158369256
1,158532440,954,OR6P1,3,,158533394
1,158548708,981,OR10X1,3,,158549689
1,158724605,1032,OR6K6,3,,158725637
20,30776948,1215,TSPY26P,3,,30778163
20,32250091,1630,C20orf144,3,,32251721
20,33421377,888,HMGB3P1,3,,33422265
22,17442826,46286,GAB4,3,,17489112
2,170501934,48997,CCDC173,3,,170550931
2,220408727,6590,TMEM198,3,,220415317
2,11273178,13738,C2orf50,3,,11286916
3,150377671,44087,ERICH6,3,,150421758
3,51928891,8495,IQCF1,3,,51937386
3,129101676,16606,RPL32P3,3,,129118282
5,56205086,19640,SETD9,3,,56224726
5,180166122,936,OR2Y1,3,,180167058
5,145894416,1260,GPR151,3,,145895676
7,73275488,4735,WBSCR28,3,,73280223
7,143826205,933,OR2A14,3,,143827138
7,48075107,25787,C7orf57,3,,48100894
8,133722191,50723,TMEM71,3,,133772914
9,74666296,9225,C9orf57,3,,74675521
9,107266543,960,OR13F1,3,,107267503
9,125329826,930,OR1L8,3,,125330756
9,125288636,936,OR1N1,3,,125289572
X,140926101,59517,MAGEC3,3,,140985618
X,26576453,2716,VENTXP1,3,,26579169
X,35816458,5394,MAGEB16,3,,35821852
21,31768391,747,KRTAP13-1,3,,31769138
10,96953956,34730,ACSM6,3,,96988686
11,4608020,1115,OR52I2,3,,4609135
11,5535622,2334,UBQLNL,3,,5537956
11,118398147,3765,TTC36,3,,118401912
12,85408093,21962,TSPAN19,3,,85430055
14,58470773,148184,C14orf37,3,,58618957
14,77292724,43921,LRRC74A,3,,77336645
15,45248899,22522,C15orf43,3,,45271421
15,95976321,74755,LINC00924,3,,96051076
15,37156643,22091,LOC145845,3,,37178734
15,67813521,6120,C15orf61,3,,67819641
15,88120159,2758,LINC00052,3,,88122917
16,69377148,8564,TMED6,3,,69385712
17,14139172,978,CDRT15,3,,14140150
17,33519538,1874,SLC35G3,3,,33521412
17,26684603,6102,TMEM199,3,,26690705
17,27030214,8711,PROCA1,3,,27038925
17,79910382,8675,NOTUM,3,,79919057
17,18625401,14030,TRIM16L,3,,18639431
18,24445271,70639,AQP4-AS1,3,,24515910
19,52196592,11851,SPACA6P,3,,52208443
19,46001730,4034,PPM1N,3,,46005764
19,55888203,1409,TMEM190,3,,55889612
19,56879467,11729,ZNF542P,3,,56891196
19,38893774,5954,FAM98C,3,,38899728
19,1267469,2790,CIRBP-AS1,3,,1270259
19,37959959,19595,ZNF570,3,,37979554
1,1334909,2517,LOC148413,3,,1337426
1,108765962,20741,NBPF4,3,,108786703
1,247687980,6126,GCSAML-AS1,3,,247694106
1,78695282,139865,MGC27382,3,,78835147
1,31971838,2329,LINC01225,3,,31974167
1,170115187,21736,METTL11B,3,,170136923
1,156890423,12457,LRRC71,3,,156902880
1,111823145,5585,CHIAP2,3,,111828730
20,37209837,7269,ADIG,3,,37217106
20,57090434,104514,APCDD1L-AS1,3,,57194948
4,103806204,134692,SLC9B1,3,,103940896
2,105050804,78411,LINC01102,3,,105129215
2,132250385,28764,LOC150776,3,,132279149
2,165754708,57327,SLC38A11,3,,165812035
2,97749322,11297,FAHD2B,3,,97760619
3,125687986,14310,ROPN1B,3,,125702296
3,126268518,9290,C3orf22,3,,126277808
3,191178951,294,PYDC2,3,,191179245
3,131080688,3278,NUDT16P1,3,,131083966
3,101659702,57068,LOC152225,3,,101716770
3,118864996,5306,C3orf30,3,,118870302
4,48018788,23402,NIPAL1,3,,48042190
4,76481257,9846,C4orf26,3,,76491103
4,159814683,141650,C4orf45,3,,159956333
5,2752244,3267,C5orf38,3,,2755511
6,134758853,66305,LINC01010,3,,134825158
6,22569677,2214,HDGFL1,3,,22571891
6,105585561,32258,BVES-AS1,3,,105617819
7,139208673,21058,CLEC2L,3,,139229731
7,138482738,8031,TMEM213,3,,138490769
1,9063358,23046,SLC2A7,3,,9086404
8,125058311,125452,FER1L6-AS2,3,,125183763
9,139746818,8433,MAMDC4,3,,139755251
9,35909479,2138,LINC00961,3,,35911617
9,35406751,76275,ATP8B5P,3,,35483026
X,49641326,2633,USP27X-AS1,3,,49643959
X,137696891,2908,LINC00889,3,,137699799
X,70323738,2900,CXorf65,3,,70326638
Y,24455005,7347,RBMY2FP,3,,24462352
14,24600674,1384,FITM1,3,,24602058
15,81426643,14873,C15orf26,3,,81441516
15,34394273,2318,PGBD4,3,,34396591
15,43622553,19062,ADAL,3,,43641615
15,41474930,48025,EXD1,3,,41522955
16,19125253,7699,ITPRIPL2,3,,19132952
17,8700427,2240,MFSD6L,3,,8702667
17,16690205,17614,USP32P1,3,,16707819
19,48773355,17510,ZNF114,3,,48790865
19,38158649,24567,ZNF781,3,,38183216
19,40534166,27949,ZNF780B,3,,40562115
1,55271735,36202,C1orf177,3,,55307937
2,232457574,1420,C2orf57,3,,232458994
2,29204163,70933,FAM179A,3,,29275096
2,119913818,2653,C1QL2,3,,119916471
5,54408798,60207,CDC20B,3,,54469005
9,115759399,15073,ZNF883,3,,115774472
X,24328978,2454,SUPT20HL2,3,,24331432
10,47658232,43211,ANTXRL,3,,47701443
12,31824070,58038,AMN1,3,,31882108
12,91345991,2962,CCER1,3,,91348953
13,103338096,8775,METTL21C,3,,103346871
13,32420919,112802,EEF1DP3,3,,32533721
15,100330360,16772,DNM1P46,3,,100347132
15,71402582,5257,CT62,3,,71407839
15,44957929,11157,PATL2,3,,44969086
16,85316563,5122,LINC00311,3,,85321685
19,17634109,28726,FAM129C,3,,17662835
19,50191941,2306,ADM5,3,,50194247
1,67218139,26591,TCTEX1D1,3,,67244730
1,15438310,40650,TMEM51-AS1,3,,15478960
3,58727736,307979,C3orf67,3,,59035715
17,9674750,19864,DHRS7C,3,,9694614
17,26205339,15070,LYRM9,3,,26220409
5,68576518,52025,CCDC125,3,,68628543
5,57787261,4924,GAPT,3,,57792185
6,159262157,16507,OSTCP1,3,,159278664
6,30297087,17548,TRIM39-RPP21,3,,30314635
7,148287656,25296,C7orf33,3,,148312952
8,10530146,27957,C8orf74,3,,10558103
11,55578942,936,OR5L1,3,,55579878
11,55587105,942,OR5D18,3,,55588047
11,56127690,1074,OR8J1,3,,56128764
11,56236963,1051,OR5M3,3,,56238014
11,56257910,936,OR5M8,3,,56258846
11,56309815,918,OR5M11,3,,56310733
11,56431161,933,OR5AR1,3,,56432094
11,124964265,17339,TMEM218,3,,124981604
11,124412617,933,OR8B12,3,,124413550
11,123847402,996,OR10S1,3,,123848398
11,120195837,8551,TMEM136,3,,120204388
11,57798424,954,OR6Q1,3,,57799378
11,57791352,157686,OR9Q1,3,,57949038
11,59189451,975,OR5A2,3,,59190426
11,59210641,948,OR5A1,3,,59211589
11,120081746,18904,OAF,3,,120100650
13,46786077,64861,LRRC63,3,,46850938
13,50464544,2972,CTAGE10P,3,,50467516
17,18414575,9991,USP32P2,3,,18424566
10,28808845,12438,WAC-AS1,3,,28821283
10,45306471,148666,TMEM72-AS1,3,,45455137
11,62453873,3498,LRRN4CL,3,,62457371
16,58313900,15051,PRSS54,3,,58328951
18,61747242,69018,LINC00305,3,,61816260
6,56819772,72370,BEND6,3,,56892142
6,44310396,34508,SPATS1,3,,44344904
6,43474702,3379,LRRC73,3,,43478081
6,3722835,29411,PXDC1,3,,3752246
6,2854890,21854,SERPINB9P1,3,,2876744
7,30409665,2745,DKFZP586I1420,3,,30412410
6,36358328,52338,PXT1,3,,36410666
6,49986555,3139,DEFB110,3,,49989694
20,29845466,1969,DEFB115,3,,29847435
20,29891014,5374,DEFB116,3,,29896388
1,113465971,1324,AKR7A2P1,3,,113467295
21,29385681,9847,LINC00314,3,,29395528
10,77056140,65296,ZNF503-AS1,3,,77121436
12,104237526,86463,GNN,3,,104323989
12,122667666,20352,LRRC43,3,,122688018
11,65336690,1194,SSSCA1-AS1,3,,65337884
17,18538841,8899,TBC1D28,3,,18547740
8,67405490,25269,C8orf46,3,,67430759
12,55641071,939,OR6C74,3,,55642010
12,55725484,936,OR6C3,3,,55726420
21,31812645,453,KRTAP15-1,3,,31813098
7,44078647,3435,LINC00957,3,,44082082
10,119806331,163334,CASC2,3,,119969665
1,20008705,117705,TMCO4,3,,20126410
5,6582248,6365,LINC01018,3,,6588613
X,120111460,3318,CT47A11,3,,120114778
22,25331207,4107,TMEM211,3,,25335314
12,106696568,27078,TCP11L2,3,,106723646
11,6190584,972,OR52B2,3,,6191556
5,74364121,168582,ANKRD31,3,,74532703
6,108023360,122161,SCML4,3,,108145521
15,52015260,28390,LYSMD2,3,,52043650
X,19930979,57403,CXorf23,3,,19988382
11,4790208,939,OR51F1,3,,4791147
17,34181949,13946,HEATR9,3,,34195895
1,26688124,11161,ZNF683,3,,26699285
5,169758396,3708,LINC01366,3,,169762104
16,2833953,2755,PRSS33,3,,2836708
9,136890560,6159,LINC00094,3,,136896719
1,249200441,12904,PGBD2,3,,249213345
22,43035808,799,ATP5L2,3,,43036607
X,52673110,10840,SSX7,3,,52683950
10,80703082,124123,ZMIZ1-AS1,3,,80827205
10,29135336,35490,C10orf126,3,,29170826
11,49973942,1029,OR4C13,3,,49974971
11,50003008,1063,OR4C12,3,,50004071
11,115626050,4868,LINC00900,3,,115630918
11,124179735,927,OR8D1,3,,124180662
11,124293837,930,OR8B4,3,,124294767
11,56510303,984,OR9G4,3,,56511287
11,3239561,4800,MRGPRG-AS1,3,,3244361
12,6993144,624,RPL13P5,3,,6993768
12,129594234,3609,LOC283352,3,,129597843
12,72656326,10963,TRHDE-AS1,3,,72667289
12,52599364,5275,C12orf80,3,,52604639
12,51236700,44963,TMPRSS12,3,,51281663
13,103046927,1128,FGF14-AS2,3,,103048055
13,64311567,5134,OR7E156P,3,,64316701
14,53019865,84566,GPR137C,3,,53104431
14,95999248,1961,SNHG10,3,,96001209
14,101123604,15477,LINC00523,3,,101139081
14,21668237,5425,LINC00641,3,,21673662
15,80215112,2084,ST20-AS1,3,,80217196
15,22382381,1434,OR4N4,3,,22383815
15,74418713,2906,LOC283731,3,,74421619
15,28623783,13388,GOLGA8G,3,,28637171
15,98980390,77221,FAM169B,3,,99057611
15,23255241,7502,GOLGA8IP,3,,23262743
16,3313767,3799,LINC00921,3,,3317566
16,73126247,1425,HCCAT5,3,,73127672
16,74366303,35850,LOC283922,3,,74402153
16,30930639,3951,FBXL19-AS1,3,,30934590
16,31446884,7464,ZNF843,3,,31454348
16,70010201,89650,PDXDC2P,3,,70099851
16,70208075,12723,CLEC18C,3,,70220798
Y,231384,670,LINC00685,3,,232054
17,72873441,16468,FADS6,3,,72889909
17,74261285,6094,UBALD2,3,,74267379
17,12453284,87220,LINC00670,3,,12540504
17,42431100,10135,FAM171A2,3,,42441235
17,42733761,19404,C17orf104,3,,42753165
17,36202572,41791,YWHAEP7,3,,36244363
17,21825369,1130,FAM27L,3,,21826499
18,54814292,3347,BOD1L2,3,,54817639
18,43405544,16977,SIGLEC15,3,,43422521
18,73121430,18228,SMIM21,3,,73139658
18,61616587,11058,HMSD,3,,61627645
18,61771324,319503,LOC284294,3,,62090827
19,57874802,16123,ZNF547,3,,57890925
19,58095343,9915,ZIK1,3,,58105258
19,45653007,10401,NKPD1,3,,45663408
19,48304499,2362,TPRX1,3,,48306861
19,8807746,1434,ACTL9,3,,8809180
19,12175513,13118,ZNF844,3,,12188631
19,35081529,3961,SCGB2B2,3,,35085490
19,15904858,948,OR10H5,3,,15905806
1,51567905,45849,C1orf185,3,,51613754
1,204001574,8818,LINC00303,3,,204010392
1,205523400,2363,LOC284578,3,,205525763
20,26035249,32304,FAM182A,3,,26067553
21,31802593,483,KRTAP13-4,3,,31803076
21,44869903,3868,LINC00319,3,,44873771
22,51195513,42552,RPL23AP82,3,,51238065
2,197504355,93175,CCDC150,3,,197597530
2,33050509,103697,LINC00486,3,,33154206
2,87257797,45739,LOC285074,3,,87303536
2,27498288,6010,DNAJC5G,3,,27504298
3,40518603,13125,ZNF619,3,,40531728
3,72084669,64937,LINC00877,3,,72149606
3,13692220,95912,LINC00620,3,,13788132
4,109459345,82268,RPL34-AS1,3,,109541613
4,89630939,20315,FAM13A-AS1,3,,89651254
5,94955979,1305,GPR150,3,,94957284
5,60933607,68755,C5orf64,3,,61002362
7,156230482,7800,LOC285889,3,,156238282
7,141404137,33893,WEE2-AS1,3,,141438030
7,150130741,14487,LINC00996,3,,150145228
8,146198974,29311,ZNF252P,3,,146228285
8,66439242,35659,LINC01299,3,,66474901
9,130469270,7033,C9orf117,3,,130476303
9,139846767,3182,LCN12,3,,139849949
9,100153118,5855,LOC286359,3,,100158973
X,92929011,38262,FAM133A,3,,92967273
4,70933102,17886,CSN1S2AP,3,,70950988
21,31852363,273,KRTAP19-1,3,,31852636
21,31797710,520,KRTAP13-3,3,,31798230
21,31986004,219,KRTAP6-1,3,,31986223
21,31869173,255,KRTAP19-4,3,,31869428
21,31933416,192,KRTAP19-7,3,,31933608
21,31988773,171,KRTAP20-1,3,,31988944
21,32007582,198,KRTAP20-2,3,,32007780
21,32127456,240,KRTAP21-1,3,,32127696
21,31973439,147,KRTAP22-1,3,,31973586
10,76797593,20679,DUPD1,3,,76818272
11,118868842,17660,CCDC84,3,,118886502
11,123777138,945,OR8D4,3,,123778083
11,6007121,1094,OR52L1,3,,6008215
11,6789237,951,OR2AG2,3,,6790188
12,93096618,5707,C12orf74,3,,93102325
15,23187728,20629,WHAMMP3,3,,23208357
16,731666,2773,JMJD8,3,,734439
17,7258454,2084,TMEM95,3,,7260538
17,20766707,32746,CCDC144NL,3,,20799453
19,46393280,12582,MYPOP,3,,46405862
1,151772739,5179,LINGO4,3,,151777918
1,1849028,1712,TMEM52,3,,1850740
1,32697260,10051,MTMR9LP,3,,32707311
1,244080703,129916,LOC339529,3,,244210619
20,37842423,10968,LOC339568,3,,37853391
20,11247306,6725,LOC339593,3,,11254031
22,31031801,12079,SLC35E4,3,,31043880
22,37387159,16718,TEX33,3,,37403877
2,27359714,2618,PRR30,3,,27362332
2,61368726,3384,LOC339803,3,,61372110
3,30767691,168462,GADL1,3,,30936153
5,134571923,11944,C5orf66-AS2,3,,134583867
6,35748830,7011,CLPSL1,3,,35755841
7,23719732,22537,FAM221A,3,,23742269
8,146024260,10269,ZNF517,3,,146034529
8,43147584,70744,POTEA,3,,43218328
9,93224713,120315,LINC01501,3,,93345028
X,72297176,2175,PABPC1L2A,3,,72299351
X,107288199,34215,VSIG1,3,,107322414
X,84347291,16683,SATL1,3,,84363974
X,125297481,2599,DCAF12L2,3,,125300080
X,15693038,28436,CA5BP1,3,,15721474
10,85980248,5097,LRIT2,3,,85985345
11,93754377,92997,HEPHL1,3,,93847374
11,7711154,16787,OVCH2,3,,7727941
12,7456927,24042,ACSM4,3,,7480969
12,55845997,939,OR6C2,3,,55846936
12,48919414,2472,OR8S1,3,,48921886
16,25247321,21534,ZKSCAN2,3,,25268855
17,4487833,23781,SMTNL2,3,,4511614
19,39693470,1436,SYCN,3,,39694906
19,40267233,9542,LEUTX,3,,40276775
19,44376514,7774,ZNF404,3,,44384288
19,44576296,17470,ZNF284,3,,44593766
19,14164178,5793,PALM3,3,,14169971
1,13359818,9239,PRAMEF5,3,,13369057
1,93646272,98015,CCDC18,3,,93744287
1,158449667,1008,OR10R2,3,,158450675
1,91177578,5216,BARHL2,3,,91182794
2,99410308,142376,KIAA1211L,3,,99552684
2,55509454,2153,PRORSD1P,3,,55511607
3,169629359,27597,SAMD7,3,,169656956
3,151451703,23853,AADACL2,3,,151475556
6,139117247,107960,ECT2L,3,,139225207
7,144015217,933,OR2A1,3,,144016150
7,128312319,15607,FAM71F2,3,,128327926
7,139138087,30370,KLRG2,3,,139168457
9,125390857,957,OR1B1,3,,125391814
2,233250459,1295,ECEL1P2,3,,233251754
17,72931896,14191,OTOP3,3,,72946087
17,20224486,81018,CCDC144CP,3,,20305504
3,132441185,151865,NPHP3-AS1,3,,132593050
7,136583519,265569,LOC349160,3,,136849088
1,152799948,625,LCE1A,3,,152800573
21,46057272,1100,KRTAP10-10,3,,46058372
7,55748766,23494,FKBP9P1,3,,55772260
12,9800642,10368,LOC374443,3,,9811010
19,2274630,7551,C19orf35,3,,2282181
1,78245308,99917,FAM73A,3,,78345225
1,231154703,21292,FAM89A,3,,231175995
3,9540044,55442,LHFPL4,3,,9595486
9,72324437,50439,PTAR1,3,,72374876
1,201489031,689,RPS10P7,3,,201489720
14,58732082,32773,PSMA3-AS1,3,,58764855
21,46066330,1236,KRTAP10-11,3,,46067566
21,46117086,873,KRTAP10-12,3,,46117959
6,26839265,85068,GUSBP2,3,,26924333
6,109072856,18289,LINC00222,3,,109091145
16,21529229,2536,SLC7A5P2,3,,21531765
11,1605571,942,KRTAP5-1,3,,1606513
6,27292539,1202,VN1R10P,3,,27293741
10,82300574,105742,SH2D4B,3,,82406316
10,85933553,11497,C10orf99,3,,85945050
11,5757677,1091,OR56B1,3,,5758768
12,120031263,48100,TMEM233,3,,120079363
14,98391946,52515,LINC01550,3,,98444461
15,74027771,16045,C15orf59,3,,74043816
15,100884661,6262,SPATA41,3,,100890923
17,4692253,1631,GLTPD2,3,,4693884
17,16345318,50187,LRRC75A,3,,16395505
17,28643365,17712,TMIGD1,3,,28661077
18,14511736,31863,POTEC,3,,14543599
19,7943516,1601,LYPLA2P2,3,,7945117
1,27320194,7183,TRNP1,3,,27327377
1,54472970,10889,LDLRAD1,3,,54483859
1,89597433,44290,GBP7,3,,89641723
1,154171561,7280,C1orf189,3,,154178841
20,18548072,2131,LINC00493,3,,18550203
21,15963712,51716,LOC388813,3,,16015428
22,42665758,5110,OGFRP1,3,,42670868
2,24232952,14193,MFSD2B,3,,24247145
2,220192130,5769,RESP18,3,,220197899
2,240968907,939,OR6B2,3,,240969846
3,149479225,31385,ANKUB1,3,,149510610
4,25915813,15688,SMIM20,3,,25931501
5,147272270,13831,C5orf46,3,,147286101
5,148961134,53393,ARHGEF37,3,,149014527
6,55192266,75025,GFRAL,3,,55267291
6,147829827,61330,SAMD5,3,,147891157
9,88835179,39393,C9orf153,3,,88874572
X,47986602,5393,SPACA5,3,,47991995
X,55101488,3848,PAGE2B,3,,55105336
10,114067935,48418,GUCY2GP,3,,114116353
11,4615268,975,OR52I1,3,,4616243
11,4660944,1124,OR51D1,3,,4662068
11,5372737,939,OR51B6,3,,5373676
11,5862185,942,OR52E6,3,,5863127
11,5877978,954,OR52E8,3,,5878932
11,55681125,933,OR5W2,3,,55682058
11,56043114,981,OR5T1,3,,56044095
11,56113514,960,OR8K1,3,,56114474
11,56344249,948,OR5M10,3,,56345197
11,58189737,1049,OR5B2,3,,58190786
11,58206592,1054,OR5B12,3,,58207646
11,59131931,936,OR5AN1,3,,59132867
11,89443466,7574,TRIM77,3,,89451040
11,94758421,2339,KDM4E,3,,94760760
11,123624287,939,OR6X1,3,,123625226
11,123886281,936,OR10G4,3,,123887217
11,124439964,981,OR8A1,3,,124440945
14,21623095,1089,OR5AU1,3,,21624184
15,65385341,13356,UBAP1L,3,,65398697
16,1138225,8019,C1QTNF8,3,,1146244
16,1535939,2529,PTX4,3,,1538468
18,56702910,17536,OACYLP,3,,56720446
19,14951759,930,OR7A10,3,,14952689
19,39574944,27184,PAPL,3,,39602128
1,12834990,3058,PRAMEF12,3,,12838048
1,13716091,2998,PRAMEF17,3,,13719089
1,158435351,942,OR10K1,3,,158436293
1,158516917,978,OR6Y1,3,,158517895
1,248004229,969,OR11L1,3,,248005198
1,248436153,963,OR2T33,3,,248437116
2,25013135,3116,PTRHD1,3,,25016251
3,21447217,960,VENTXP7,3,,21448177
7,143771312,933,OR2A25,3,,143772245
9,125562401,951,OR1K1,3,,125563352
X,48620153,11911,GLOD5,3,,48632064
X,134555857,6142,LINC00086,3,,134561999
10,48927373,25256,BMS1P5,3,,48952629
10,124457224,2114,C10orf120,3,,124459338
10,135380437,3025,SPRNP1,3,,135383462
13,44974385,5735,TUSC8,3,,44980120
14,105046020,10164,C14orf180,3,,105056184
15,80191181,16417,ST20,3,,80207598
16,11913691,8998,BCAR4,3,,11922689
17,32901141,5247,C17orf102,3,,32906388
18,72259009,6062,LINC00909,3,,72265071
1,162348695,4806,C1orf226,3,,162353501
1,165446078,105314,LOC400794,3,,165551392
1,178511930,6094,C1orf220,3,,178518024
22,21457304,19271,BCRP2,3,,21476575
2,20068614,16194,LINC00954,3,,20084808
2,54952148,247008,EML6,3,,55199156
2,61074894,33555,LINC01185,3,,61108449
2,132199733,2734,LOC401010,3,,132202467
2,145425533,408758,TEX41,3,,145834291
3,151980404,7011,MBNL1-AS1,3,,151987415
4,120326677,5138,LINC01061,3,,120331815
6,2988200,3205,LINC01011,3,,2991405
6,43273210,3320,CRIP3,3,,43276530
7,30587972,29423,LOC401320,3,,30617395
7,140103842,22208,RAB19,3,,140126050
7,143955788,933,OR2A7,3,,143956721
7,149564782,6169,ATP6V0E2-AS1,3,,149570951
9,2535654,86719,VLDLR-AS1,3,,2622373
9,21003622,28052,PTPLAD2,3,,21031674
9,39371061,5852,FAM74A1,3,,39376913
9,89763558,11083,C9orf170,3,,89774641
9,140138034,4210,FAM166A,3,,140142244
X,46404924,2986,ZNF674-AS1,3,,46407910
X,103343897,57811,SLC25A53,3,,103401708
1,248651889,948,OR2T5,3,,248652837
3,98216524,951,OR5K2,3,,98217475
4,54851665,1784,RPL21P44,3,,54853449
X,100168430,15468,XKRX,3,,100183898
1,248801587,972,OR2T35,3,,248802559
10,122357460,2175,LINC01561,3,,122359635
6,4079439,51560,C6orf201,3,,4130999
2,132552533,6701,C2orf27B,3,,132559234
10,75007124,29618,DNAJC9-AS1,3,,75036742
9,132083294,1588,C9orf106,3,,132084882
9,139632618,4793,LCN10,3,,139637411
6,32358286,3182,HCG23,3,,32361468
6,30255173,39760,HCG18,3,,30294933
10,6622386,4937,PRKCQ-AS1,3,,6627323
10,91137812,7150,IFIT1B,3,,91144962
11,1618406,1118,KRTAP5-2,3,,1619524
12,56223391,6639,TMEM198B,3,,56230030
12,93130264,35604,PLEKHG7,3,,93165868
14,21500978,1966,RNASE13,3,,21502944
15,22133180,12622,NF1P2,3,,22145802
15,23403865,175492,GOLGA6L22,3,,23579357
15,28982728,20780,WHAMMP2,3,,29003508
15,74753605,20028,UBL7-AS1,3,,74773633
15,83098709,9402,GOLGA6L9,3,,83108111
16,29875154,4220,CDIPT-AS1,3,,29879374
17,20771745,36798,CCDC144NL-AS1,3,,20808543
17,62780958,52344,PLEKHM1P,3,,62833302
17,79002932,5587,BAIAP2-AS1,3,,79008519
18,14179095,47954,ANKRD20A5P,3,,14227049
18,77724581,6241,HSBP1L1,3,,77730822
1,43613593,8474,FAM183A,3,,43622067
1,53308182,52065,ZYG11A,3,,53360247
1,226250427,9276,H3F3AP4,3,,226259703
4,83405603,77523,TMEM150C,3,,83483126
5,16067473,112424,11-Mar,3,,16179897
6,74078279,1236,OOEP,3,,74079515
6,166401038,2065,LINC00602,3,,166403103
7,5013615,24185,RNF216P1,3,,5037800
7,26443107,92879,LOC441204,3,,26535986
7,102290771,11076,SPDYE2,3,,102301847
9,42858151,34986,AQP7P3,3,,42893137
X,134866213,8348,CT45A5,3,,134874561
10,135438602,1697,FRG2B,3,,135440299
12,31079837,69700,TSPAN11,3,,31149537
12,55523552,1008,OR9K2,3,,55524560
6,112668531,3967,RFPL4B,3,,112672498
8,57287276,15993,SDR16C6P,3,,57303269
7,89748713,6201,DPY19L2P4,3,,89754914
X,154687145,1116,F8A3,3,,154688261
14,21058239,743,RNASE12,3,,21058982
5,134784557,3532,TIFAB,3,,134788089
8,47752507,14900,LINC00293,3,,47767407
X,134883487,8032,CT45A6,3,,134891519
2,111965349,287389,MIR4435-1HG,3,,112252738
9,114393631,23000,DNAJC25,3,,114416631
4,68566995,21227,UBA6-AS1,3,,68588222
16,25043061,1037,LOC554206,3,,25044098
X,114058016,111,MIR448,3,,114058127
2,132905163,14362,ANKRD30BL,3,,132919525
19,51014856,3091,ASPDH,3,,51017947
1,200311671,31249,LINC00862,3,,200342920
9,70970079,2703,PGM5-AS1,3,,70972782
16,2012334,133,SNORA10,3,,2012467
14,101531783,91,MIR412,3,,101531874
19,54178964,87,MIR520E,3,,54179051
19,54183193,84,MIR519E,3,,54183277
19,54185412,87,MIR520F,3,,54185499
19,54188262,83,MIR515-2,3,,54188345
19,54194134,85,MIR520A,3,,54194219
19,54197646,83,MIR526B,3,,54197729
19,54201638,87,MIR523,3,,54201725
19,54203268,87,MIR518F,3,,54203355
19,54209505,85,MIR526A1,3,,54209590
19,54211988,101,MIR518C,3,,54212089
19,54219847,87,MIR521-2,3,,54219934
19,54224329,67,MIR517B,3,,54224396
19,54228695,85,MIR516B2,3,,54228780
19,54230175,65,MIR526A2,3,,54230240
19,54233091,88,MIR518E,3,,54233179
19,54234259,85,MIR518A1,3,,54234344
19,54238130,87,MIR518D,3,,54238217
19,54240098,90,MIR516B1,3,,54240188
19,54242586,87,MIR518A2,3,,54242673
19,54251889,87,MIR521-1,3,,54251976
19,54257271,85,MIR527,3,,54257356
19,54259994,90,MIR516A1,3,,54260084
19,54264386,90,MIR516A2,3,,54264476
X,146294980,129,MIR513A1,3,,146295109
X,146307343,127,MIR513A2,3,,146307470
X,146312501,94,MIR507,3,,146312595
X,146360764,98,MIR514A1,3,,146360862
X,146366158,88,MIR514A2,3,,146366246
X,146366158,88,MIR514A3,3,,146366246
16,30296338,50357,SMG1P5,3,,30346695
9,69080243,67611,PGM5P2,3,,69147854
16,89627837,72,SNORD68,3,,89627909
8,11618764,1968,C8orf49,3,,11620732
12,51347781,16508,HIGD1C,3,,51364289
15,44086371,5924,SERINC4,3,,44092295
7,76099336,4981,FDPSP2,3,,76104317
10,135267431,14518,SCART1,3,,135281949
1,173836811,72,SNORD74,3,,173836883
3,186502584,70,SNORD2,3,,186502654
3,186505401,137,SNORA4,3,,186505538
5,180670313,63,SNORD95,3,,180670376
9,129170053,2730,NRON,3,,129172783
1,202789384,6957,MGAT4EP,3,,202796341
19,76219,1471,FAM138F,3,,77690
13,88096241,226977,MIR4500HG,3,,88323218
22,21521191,25254,FAM230B,3,,21546445
17,71244587,13432,CPSF4L,3,,71258019
9,136443536,1832,FAM163B,3,,136445368
5,60453535,4767,SMIM15,3,,60458302
10,88780045,4442,FAM25A,3,,88784487
7,64498731,36360,CCT6P3,3,,64535091
10,90521162,16837,LIPN,3,,90537999
1,219254316,92814,LYPLAL1-AS1,3,,219347130
1,1533387,2089,C1orf233,3,,1535476
8,158344,23974,RPL23AP53,3,,182318
17,10725791,15627,PIRT,3,,10741418
22,25028881,20446,BCRP3,3,,25049327
10,50574160,29902,DRGX,3,,50604062
17,44270938,3151,KANSL1-AS1,3,,44274089
20,21376004,2043,NKX2-4,3,,21378047
17,20404826,2985,KRT16P3,3,,20407811
4,17516787,11940,CLRN2,3,,17528727
1,148930404,22650,LOC645166,3,,148953054
19,2289773,18383,LINGO3,3,,2308156
6,139790131,5602,LOC645434,3,,139795733
4,119437494,37865,CEP170P1,3,,119475359
3,126290621,36777,TXNRD3NB,3,,126327398
2,21910305,23219,LOC645949,3,,21933524
1,158101833,8597,LOC646268,3,,158110430
8,82370617,3141,FABP9,3,,82373758
19,56041099,7336,SBK2,3,,56048435
2,227007509,37269,LOC646736,3,,227044778
2,131193234,6020,CYP4F62P,3,,131199254
1,92539992,1037,SETSIP,3,,92541029
9,39884941,6269,SPATA31A1,3,,39891210
3,162895030,126059,LINC01192,3,,163021089
1,121107151,27534,SRGAP2B,3,,121134685
3,190570525,9940,GMNC,3,,190580465
12,133794897,17525,ANHX,3,,133812422
5,43016149,2764,LOC648987,3,,43018913
7,56491396,24672,LOC650226,3,,56516068
6,28129538,7835,ZNF192P1,3,,28137373
17,7480128,148,SNORD10,3,,7480276
9,114365110,10723,LRRC37A5P,3,,114375833
15,30375157,13747,GOLGA8J,3,,30388904
15,32681785,13708,GOLGA8K,3,,32695493
1,108992903,20357,NBPF6,3,,109013260
9,79013514,1440,RPSAP9,3,,79014954
16,18582569,27038,ABCC6P1,3,,18609607
5,69711196,34993,GTF2H2B,3,,69746189
10,52499447,17499,ASAH2B,3,,52516946
5,177433966,42122,FAM153C,3,,177476088
8,12283123,10729,FAM86B2,3,,12293852
16,29086162,41876,RRN3P2,3,,29128038
9,70175706,3109,FOXD4L5,3,,70178815
1,202976535,16133,TMEM183B,3,,202992668
15,28943840,13727,GOLGA8M,3,,28957567
1,120839004,16677,FAM72B,3,,120855681
4,264463,25481,ZNF732,3,,289944
7,45143947,134,SNORA5A,3,,45144081
2,114334958,1471,FAM138B,3,,114336429
8,124864226,268076,FER1L6,3,,125132302
9,41958801,60783,KGFLP2,3,,42019584
12,54674532,4131,HNRNPA1P10,3,,54678663
1,109642814,420,SCARNA2,3,,109643234
X,24762557,130,SCARNA23,3,,24762687
12,7076499,270,SCARNA12,3,,7076769
11,93465169,130,SNORA1,3,,93465299
12,49050430,135,SNORA2A,3,,49050565
12,49061239,137,SNORA2B,3,,49061376
7,45145566,132,SNORA5B,3,,45145698
3,129116052,139,SNORA7B,3,,129116191
7,45024976,133,SNORA9,3,,45025109
X,54840802,131,SNORA11,3,,54840933
7,75573100,134,SNORA14A,3,,75573234
1,235291117,135,SNORA14B,3,,235291252
7,56128162,133,SNORA15,3,,56128295
9,139621198,133,SNORA17,3,,139621331
11,93466631,132,SNORA18,3,,93466763
6,160201281,132,SNORA20,3,,160201413
7,65220512,134,SNORA22,3,,65220646
11,9450312,189,SNORA23,3,,9450501
4,119200344,131,SNORA24,3,,119200475
4,53579415,122,SNORA26,3,,53579537
14,103804185,126,SNORA28,3,,103804311
6,160206625,140,SNORA29,3,,160206765
16,30721857,129,SNORA30,3,,30721986
13,45911614,130,SNORA31,3,,45911744
X,113865258,128,SNORA35,3,,113865386
X,153996802,130,SNORA36A,3,,153996932
1,220373887,131,SNORA36B,3,,220374018
18,51748653,129,SNORA37,3,,51748782
20,37076725,136,SNORA71E,3,,37076861
11,93468275,127,SNORA40,3,,93468402
1,28906892,132,SNORA44,3,,28907024
11,8706985,131,SNORA45B,3,,8707116
16,58582402,135,SNORA46,3,,58582537
5,76376258,138,SNORA47,3,,76376396
12,132515768,137,SNORA49,3,,132515905
16,58593699,136,SNORA76A,3,,58593835
20,2635712,132,SNORA51,3,,2635844
12,98993412,250,SNORA53,3,,98993662
1,40033045,137,SNORA55,3,,40033182
X,154003272,129,SNORA56,3,,154003401
3,131197841,236,SNORA58,3,,131198077
1,28906275,130,SNORA61,3,,28906405
20,37058309,138,SNORA71C,3,,37058447
17,62223698,133,SNORA76C,3,,62223831
1,203698708,125,SNORA77,3,,203698833
16,2015184,127,SNORA78,3,,2015311
14,81669038,140,SNORA79,3,,81669178
21,33749495,136,SNORA80A,3,,33749631
17,74554873,78,SNORD1C,3,,74554951
17,19460872,152,SNORA59B,3,,19461024
11,93463680,132,SNORA25,3,,93463812
11,93464144,121,SNORA32,3,,93464265
1,28907431,134,SNORA16A,3,,28907565
17,33900675,97,SNORD7,3,,33900772
6,86387306,71,SNORD50B,3,,86387377
3,52726751,77,SNORD69,3,,52726828
1,212526159,133,SNORA16B,3,,212526292
1,173836016,60,SNORD75,3,,173836076
1,173835772,81,SNORD76,3,,173835853
1,173835448,61,SNORD77,3,,173835509
1,173834770,54,SNORD78,3,,173834824
6,31508877,78,SNORD84,3,,31508955
1,31441009,75,SNORD85,3,,31441084
19,51305581,97,SNORD88C,3,,51305678
6,31504150,76,SNORD117,3,,31504226
6,18572014,97,MIR548A1,3,,18572111
3,103903475,42630,MIR548A3,3,,103946105
7,30329409,97,MIR550A1,3,,30329506
7,32772592,97,MIR550A2,3,,32772689
1,3477259,95,MIR551A,3,,3477354
3,168269641,96,MIR551B,3,,168269737
1,162312335,95,MIR556,3,,162312430
2,32757219,94,MIR558,3,,32757313
2,47604813,96,MIR559,3,,47604909
2,189162218,97,MIR561,3,,189162315
3,44903379,94,MIR564,3,,44903473
3,50210758,94,MIR566,3,,50210852
3,114035321,95,MIR568,3,,114035416
4,343945,96,MIR571,3,,344041
4,115577914,96,MIR577,3,,115578010
5,53247333,96,MIR581,3,,53247429
5,168690604,94,MIR585,3,,168690698
6,126805776,83,MIR588,3,,126805859
7,95848973,95,MIR591,3,,95849068
7,126698141,97,MIR592,3,,126698238
8,1765396,77,MIR596,3,,1765473
9,140732870,98,MIR602,3,,140732968
10,24564613,97,MIR603,3,,24564710
11,28078361,96,MIR610,3,,28078457
11,61559966,67,MIR611,3,,61560033
12,81329514,98,MIR618,3,,81329612
12,109230683,99,MIR619,3,,109230782
17,30677127,94,MIR632,3,,30677221
19,19545871,96,MIR640,3,,19545967
20,33054129,94,MIR644A,3,,33054223
20,58883531,94,MIR646,3,,58883625
20,62573983,96,MIR647,3,,62574079
14,101506555,81,MIR654,3,,101506636
22,38243684,97,MIR659,3,,38243781
X,49777848,97,MIR660,3,,49777945
15,25331672,94,SNORD116-19,3,,25331766
18,2943212,3409,LOC727896,3,,2946621
21,46490869,2257,SSR4P1,3,,46493126
4,185262183,12947,LOC728175,3,,185275130
7,6793739,44657,RSPH10B2,3,,6838396
22,20377668,2772,TMEM191B,3,,20380440
22,20383730,14965,PI4KAP1,3,,20398695
17,39185928,449,KRTAP1-4,3,,39186377
5,148786407,25992,MIR143HG,3,,148812399
16,19297104,25165,CLEC19A,3,,19322269
17,39210750,713,KRTAP2-2,3,,39211463
5,68856050,32679,GTF2H2C,3,,68888729
7,143956088,27008,ARHGEF34P,3,,143983096
15,30896232,13797,GOLGA8H,3,,30910029
10,97512962,337030,ENTPD1-AS1,3,,97849992
12,104343980,7013,C12orf73,3,,104350993
13,36804911,67081,CCDC169,3,,36871992
18,24267584,16018,PCAT18,3,,24283602
1,143896451,16692,FAM72D,3,,143913143
1,149576466,42668,LINC00623,3,,149619134
20,25750233,31694,FAM182B,3,,25781927
X,134866213,8036,CT45A2,3,,134874249
10,105005643,2130,RPEL1,3,,105007773
12,16341418,89201,SLC15A5,3,,16430619
7,66274979,34834,GTF2IRD1P1,3,,66309813
6,147162524,363226,STXBP5-AS1,3,,147525750
X,47990038,1957,SPACA5B,3,,47991995
17,18561741,23831,ZNF286B,3,,18585572
4,123651343,2270,CETN4P,3,,123653613
16,33262117,2602,TP53TG3B,3,,33264719
X,49178508,116080,GAGE12J,3,,49294588
1,16160709,13933,FLJ37453,3,,16174642
5,180257956,4770,LINC00847,3,,180262726
8,12394587,128533,LOC729732,3,,12523120
3,156465131,69720,LINC00886,3,,156534851
7,123670969,2554,TMEM229A,3,,123673523
13,77526623,6153,IRG1,3,,77532776
7,63667580,13088,ZNF735,3,,63680668
4,185764449,3751,LOC731424,3,,185768200
6,40346162,1469,TDRG1,3,,40347631
20,43991808,47442,SYS1-DBNDD2,3,,44039250
14,101419685,74,SNORD114-3,3,,101419759
20,61732643,3094,HAR1A,3,,61735737
14,101521594,66,MIR668,3,,101521660
17,57215118,115,MIR454,3,,57215233
X,118780700,111,MIR766,3,,118780811
3,54666150,7734,ESRG,3,,54673884
15,25310171,98,SNORD116-2,3,,25310269
15,25318252,97,SNORD116-3,3,,25318349
15,25304683,98,SNORD116-4,3,,25304781
15,25312933,97,SNORD116-5,3,,25313030
15,25310171,98,SNORD116-6,3,,25310269
15,25312933,97,SNORD116-7,3,,25313030
15,25315577,97,SNORD116-8,3,,25315674
15,25318252,97,SNORD116-9,3,,25318349
15,25319259,104,SNORD116-10,3,,25319363
15,25321074,94,SNORD116-11,3,,25321168
15,25322196,94,SNORD116-12,3,,25322290
15,25324203,94,SNORD116-13,3,,25324297
15,25325287,94,SNORD116-14,3,,25325381
15,25326432,94,SNORD116-15,3,,25326526
15,25327913,94,SNORD116-16,3,,25328007
15,25331672,94,SNORD116-17,3,,25331766
15,25332807,94,SNORD116-20,3,,25332901
15,25333949,94,SNORD116-21,3,,25334043
15,25336931,94,SNORD116-23,3,,25337025
15,25342808,94,SNORD116-25,3,,25342902
15,25344644,98,SNORD116-26,3,,25344742
15,25346720,94,SNORD116-27,3,,25346814
15,25349787,93,SNORD116-28,3,,25349880
5,70516052,39070,GUSBP9,3,,70555122
3,52724753,93,SNORD19B,3,,52724846
5,9548938,88,SNORD123,3,,9549026
20,62584736,3602,UCKL1-AS1,3,,62588338
14,20794599,99,SNORD126,3,,20794698
18,47015604,90,SNORD58C,3,,47015694
3,125635443,13424,FAM86JP,3,,125648867
20,57393280,88,MIR298,3,,57393368
X,133674214,78,MIR450B,3,,133674292
9,28888876,77,MIR873,3,,28888953
3,197401366,81,MIR922,3,,197401447
10,29891192,83,MIR938,3,,29891275
1,117637264,86,MIR942,3,,117637350
X,145109311,79,MIR891A,3,,145109390
X,145078186,75,MIR892A,3,,145078261
14,101514237,79,MIR889,3,,101514316
1,166123979,56,MIR921,3,,166124035
21,44742088,9831,LINC00322,3,,44751919
3,4790877,2397,EGOT,3,,4793274
20,61294378,3595,SLCO4A1-AS1,3,,61297973
9,94895115,5796,LOC100128076,3,,94900911
15,76020010,12408,DNM1P35,3,,76032418
2,40144773,337576,SLC8A1-AS1,3,,40482349
15,26147506,150761,LOC100128714,3,,26298267
9,98632565,5694,LINC00476,3,,98638259
8,19041185,61847,LOC100128993,3,,19103032
9,92254697,79977,UNQ6494,3,,92334674
1,155715558,4921,MSTO2P,3,,155720479
9,24543212,2462,IZUMO3,3,,24545674
16,90106168,7865,URAHP,3,,90114033
1,852197,2875,LOC100130417,3,,855072
19,17546317,13059,TMEM221,3,,17559376
X,125953746,2022,PRR32,3,,125955768
8,92114846,116618,LRRC69,3,,92231464
19,56052022,4887,SBK3,3,,56056909
15,63879908,13118,USP3-AS1,3,,63893026
4,1189570,13180,LOC100130872,3,,1202750
20,45085131,1151,ZNF663P,3,,45086282
17,5095378,43553,LOC100130950,3,,5138931
7,50135681,63171,C7orf72,3,,50198852
1,59250822,114562,LINC01135,3,,59365384
15,40331511,28199,SRP14-AS1,3,,40359710
9,139698378,4922,CCDC183-AS1,3,,139703300
2,191371618,27850,TMEM194B,3,,191399468
2,130724164,13881,RAB6C-AS1,3,,130738045
17,655572,3004,DBIL5P,3,,658576
1,159165774,6438,CADM3-AS1,3,,159172212
5,169288309,119452,FAM196B,3,,169407761
16,22430866,18170,RRN3P3,3,,22449036
16,22524843,22998,NPIPB5,3,,22547841
22,42486936,34418,NDUFA6-AS1,3,,42521354
2,131437622,5813,CYP4F30P,3,,131443435
19,23437855,19198,IPO5P1,3,,23457053
9,44990235,1257,FAM27C,3,,44991492
15,22702284,13444,GOLGA8DP,3,,22715728
10,80008381,4021,LINC00856,3,,80012402
9,43027662,5650,FAM95B1,3,,43033312
11,71576554,62939,LOC100133315,3,,71639493
19,36802244,1326,LOC100134317,3,,36803570
17,76142433,19931,C17orf99,3,,76162364
7,143963766,3111,CTAGE8,3,,143966877
15,93111047,4446,LINC00930,3,,93115493
19,57323847,1314,PEG3-AS1,3,,57325161
19,47333841,120,SNAR-E,3,,47333961
19,44116252,2398,SRRM5,3,,44118650
16,2140195,90,MIR1225,3,,2140285
10,93066718,304499,HECTD2-AS1,3,,93371217
17,40905946,7329,RAMP2-AS1,3,,40913275
20,22034727,20565,LINC01432,3,,22055292
22,46435786,4962,LINC00899,3,,46440748
2,111160495,70157,LIMS3-LOC440895,3,,111230652
8,6261076,2993,LOC100287015,3,,6264069
12,116971226,2100,LINC00173,3,,116973326
1,2572806,133424,TTC34,3,,2706230
16,15457480,14671,NPIPA5,3,,15472151
11,113140253,4370,NCAM1-AS1,3,,113144623
21,34637936,629,IL10RB-AS1,3,,34638565
2,111222627,8025,LIMS3L,3,,111230652
3,75713486,2882,FRG2C,3,,75716368
10,81664653,26904,LOC100288974,3,,81691557
9,46385603,1770,FAM27E2,3,,46387373
7,99195901,12555,GS1-259H13.2,3,,99208456
1,146853913,135786,LINC00624,3,,146989699
9,139979397,1872,MAN1B1-AS1,3,,139981269
13,99848627,4384,UBAC2-AS1,3,,99853011
20,1754010,6382,LOC100289473,3,,1760392
16,32181363,18071,HERC2P4,3,,32199434
12,79813036,65,MIR1252,3,,79813101
20,62572817,80,MIR1914,3,,62572897
2,177465707,73,MIR1246,3,,177465780
X,113886018,80,MIR1912,3,,113886098
14,102026623,136,MIR1247,3,,102026759
1,21314806,119,MIR1256,3,,21314925
14,101509313,85,MIR1185-1,3,,101509398
1,201777738,92,MIR1231,3,,201777830
15,34674269,82,MIR1233-1,3,,34674351
20,60528601,117,MIR1257,3,,60528718
8,129021143,59,MIR1206,3,,129021202
12,69666936,62,MIR1279,3,,69666998
8,128808207,67,MIR1204,3,,128808274
10,56367633,84,MIR548F1,3,,56367717
14,101510534,85,MIR1185-2,3,,101510619
19,1816157,80,MIR1909,3,,1816237
19,10514133,81,MIR1181,3,,10514214
12,100583661,66,MIR1827,3,,100583727
2,189842817,69,MIR1245A,3,,189842886
11,90602288,82,MIR1261,3,,90602370
17,79106995,113,MIR1250,3,,79107108
3,47891044,75,MIR1226,3,,47891119
1,220373883,78,MIR664A,3,,220373961
15,89151337,91,MIR1179,3,,89151428
X,113887129,69,MIR1264,3,,113887198
19,54175221,73,MIR1323,3,,54175294
6,156267930,83,MIR1202,3,,156268013
16,85775226,80,MIR1910,3,,85775306
19,54191734,87,MIR1283-1,3,,54191821
4,126428413,49,MIR2054,3,,126428462
4,183090445,86,MIR1305,3,,183090531
10,70519074,97,MIR1254-1,3,,70519171
2,28112322,1659,BRE-AS1,3,,28113981
X,118599995,3088,SLC25A5-AS1,3,,118603083
17,1420212,1178,PITPNA-AS1,3,,1421390
X,153285370,70,MIR718,3,,153285440
X,149396238,80,MIR2114,3,,149396318
3,48357849,100,MIR2115,3,,48357949
13,24736554,89,MIR2276,3,,24736643
5,92956401,93,MIR2277,3,,92956494
1,52302015,59,MIR761,3,,52302074
22,26951177,112,MIR548J,3,,26951289
5,54468089,92,MIR449C,3,,54468181
4,1108984,7968,TMED11P,3,,1116952
9,127420714,40193,MIR181A2HG,3,,127460907
6,155174493,77,MIR1273C,3,,155174570
2,178120672,66,MIR3128,3,,178120738
11,46473356,81,MIR3160-2,3,,46473437
11,46473354,85,MIR3160-1,3,,46473439
18,42550046,85,MIR4319,3,,42550131
9,97848295,81,MIR3074,3,,97848376
15,34820490,82,MIR1233-2,3,,34820572
7,147626684,417243,MIR548T,3,,148043927
19,813583,70,MIR3187,3,,813653
11,113320744,66,MIR4301,3,,113320810
1,23370797,68,MIR3115,3,,23370865
8,29814787,77,MIR3148,3,,29814864
11,59362549,82,MIR3162,3,,59362631
13,98860777,77,MIR3170,3,,98860854
16,18505750,84,MIR3179-2,3,,18505834
20,50069441,73,MIR3194,3,,50069514
10,97824071,85,MIR3157,3,,97824156
19,47730198,80,MIR3190,3,,47730278
18,14830164,77,MIR3156-2,3,,14830241
9,130548196,90,MIR2861,3,,130548286
X,49775279,79,MIR500B,3,,49775358
19,47212549,53,MIR320E,3,,47212602
22,48670175,52,MIR3201,3,,48670227
2,97464014,76,MIR3127,3,,97464090
2,10332739,58,MIR4261,3,,10332797
12,123495213,62,MIR4304,3,,123495275
6,27115404,63,MIR3143,3,,27115467
19,18497371,73,MIR3189,3,,18497444
17,79418129,85,MIR3186,3,,79418214
1,62544460,68,MIR3116-2,3,,62544528
6,120336324,79,MIR3144,3,,120336403
11,71783273,75,MIR3165,3,,71783348
16,16403735,88,MIR3180-2,3,,16403823
2,219923409,63,MIR3131,3,,219923472
8,96085141,80,MIR3150A,3,,96085221
7,19744980,79,MIR3146,3,,19745059
10,45659461,75,MIR3156-1,3,,45659536
3,15738804,74,MIR3134,3,,15738878
6,138756349,82,MIR3145,3,,138756431
16,18505750,84,MIR3179-3,3,,18505834
4,10080234,82,MIR3138,3,,10080316
21,14778704,77,MIR3156-3,3,,14778781
1,154948168,91,MIR4258,3,,154948259
22,18246945,80,MIR3198-1,3,,18247025
10,103361173,81,MIR3158-2,3,,103361254
16,593276,90,MIR3176,3,,593366
11,87909669,92,MIR3166,3,,87909761
17,70399462,189481,LINC00673,3,,70588943
1,38554902,99,MIR3659,3,,38555001
16,2320713,60,MIR3677,3,,2320773
5,89312437,100,MIR3660,3,,89312537
22,35731632,119,MIR3909,3,,35731751
22,46486923,83,MIR3619,3,,46487006
5,170813659,105,MIR3912,3,,170813764
7,70772657,99,MIR3914-1,3,,70772756
8,12584745,63,MIR3926-2,3,,12584808
12,104985410,84,MIR3922,3,,104985494
11,70718374,99,MIR3664,3,,70718473
9,137741020,1470,MIR3689A,3,,137742490
2,54076258,84,MIR3682,3,,54076342
1,33797993,100,MIR3605,3,,33798093
6,167411294,106,MIR3939,3,,167411400
8,27559193,83,MIR3622A,3,,27559276
13,78272146,105,MIR3665,3,,78272251
9,130452965,109,MIR3911,3,,130453074
6,33665904,107,MIR3934,3,,33666011
4,160049953,93,MIR3688-1,3,,160050046
6,36590212,77,MIR3925,3,,36590289
10,118927188,97,MIR3663,3,,118927285
7,114293399,111,MIR3666,3,,114293510
20,44333740,79,MIR3617,3,,44333819
9,112273754,71,MIR3927,3,,112273825
6,5148466,90,MIR3691,3,,5148556
12,69978501,102,MIR3913-1,3,,69978603
5,133561447,96,MIR3661,3,,133561543
10,135185059,108,MIR3944,3,,135185167
9,95054739,90,MIR3651,3,,95054829
7,70772659,95,MIR3914-2,3,,70772754
4,147030606,12459,LINC01095,3,,147043065
18,55297533,38975,LOC100505549,3,,55336508
17,38097726,3261,LRRC3C,3,,38100987
15,83419315,6643,SNHG21,3,,83425958
3,14984285,5663,FGD5-AS1,3,,14989948
3,15295690,10315,SH3BP5-AS1,3,,15306005
20,42839725,14942,OSER1-AS1,3,,42854667
5,9546311,4098,SNHG18,3,,9550409
19,48758931,2519,CARD8-AS1,3,,48761450
21,18811207,10296,LINC01549,3,,18821503
5,90598802,11417,LUCAT1,3,,90610219
19,46984044,120413,PPP5D1,3,,47104457
7,16566504,54610,LRRC72,3,,16621114
2,166713985,14466,LOC100506124,3,,166728451
1,35447126,3822,ZMYM6NB,3,,35450948
14,36988482,3739,NKX2-1-AS1,3,,36992221
11,7458867,28199,LOC100506258,3,,7487066
7,156264792,131097,LINC01006,3,,156395889
21,36744804,208258,LOC100506403,3,,36953062
12,26107587,2931,RASSF8-AS1,3,,26110518
12,114182381,29107,LINC01234,3,,114211488
21,41755009,2276,DSCAM-AS1,3,,41757285
7,29019582,33403,LOC100506497,3,,29052985
15,67695948,118234,IQCH-AS1,3,,67814182
2,179387917,97027,TTN-AS1,3,,179484944
3,62247493,57129,PTPRG-AS1,3,,62304622
10,3183792,7029,PITRM1-AS1,3,,3190821
12,133179735,7302,LRCOL1,3,,133187037
2,74375107,4409,BOLA3-AS1,3,,74379516
6,131148544,9732,SMLR1,3,,131158276
14,101536247,3026,MEG9,3,,101539273
4,4543857,168807,STX18-AS1,3,,4712664
19,56124958,4949,ZNF865,3,,56129907
8,30496116,7353,SMIM18,3,,30503469
9,98225890,6411,LOC100507346,3,,98232301
6,29497182,4163,LINC01015,3,,29501345
20,1305986,53393,SDCBP2-AS1,3,,1359379
10,29078239,6740,LINC00837,3,,29084979
6,2245986,167839,GMDS-AS1,3,,2413825
13,36742344,129648,CCDC169-SOHLH2,3,,36871992
2,86730552,217693,RNF103-CHMP3,3,,86948245
3,52867130,64467,TMEM110-MUSTN1,3,,52931597
2,18735988,34858,NT5C1B-RDH14,3,,18770846
7,30791750,140252,INMT-FAM188B,3,,30932002
1,55107412,100916,MROH7-TTC4,3,,55208328
1,180238797,5019,LHX4-AS1,3,,180243816
12,56109817,8709,BLOC1S1-RDH5,3,,56118526
15,44084173,10596,SERF2-C15ORF63,3,,44094769
X,100645877,23251,RPL36A-HNRNPH2,3,,100669128
17,6915735,5108,RNASEK-C17orf49,3,,6920843
14,70791797,92010,SYNJ2BP-COX16,3,,70883807
19,41281441,21408,MIA-RAB4B,3,,41302849
3,132276981,164322,NPHP3-ACAD11,3,,132441303
2,74682149,5869,INO80B-WBP1,3,,74688018
11,117690789,56957,FXYD6-FXYD2,3,,117747746
17,7465308,17016,SENP3-EIF4A1,3,,7482324
19,45445494,7328,APOC4-APOC2,3,,45452822
X,151282520,24530,MAGEA10-MAGEA5,3,,151307050
7,43906156,40075,URGCP-MRPS24,3,,43946231
8,42751339,79,MIR4469,3,,42751418
18,13611112,87,MIR4526,3,,13611199
12,81552166,74,MIR4699,3,,81552240
3,50712510,84,MIR4787,3,,50712594
8,94928249,98,MIR378D2,3,,94928347
14,104583754,86,MIR203B,3,,104583840
2,114478866,79,MIR4782,3,,114478945
9,35608090,66,MIR4667,3,,35608156
14,100575755,96,MIR151B,3,,100575851
16,2183119,86,MIR4516,3,,2183205
2,64567892,81,MIR4433A,3,,64567973
5,14826037,84,MIR4637,3,,14826121
1,55691313,83,MIR4422,3,,55691396
11,65416662,62,MIR4489,3,,65416724
18,53146451,78,MIR4529,3,,53146529
12,121160995,74,MIR4700,3,,121161069
9,131154899,88,MIR219B,3,,131154987
20,60907542,71,MIR4758,3,,60907613
8,8905954,74,MIR4660,3,,8906028
2,169439452,76,MIR4774,3,,169439528
2,240273418,81,MIR2467,3,,240273499
18,46196970,69,MIR4743,3,,46197039
7,102111915,63,MIR4467,3,,102111978
15,66011583,87,MIR4511,3,,66011670
17,26687676,81,MIR4723,3,,26687757
1,23046009,82,MIR4684,3,,23046091
3,175087328,82,MIR4789,3,,175087410
2,89111883,85,MIR4436A,3,,89111968
12,54625180,80,MIR3198-2,3,,54625260
20,32636924,72,MIR4755,3,,32636996
11,34963383,84,MIR1343,3,,34963467
3,24562852,74,MIR4792,3,,24562926
8,101394990,83,MIR4471,3,,101395073
2,66585380,80,MIR4778,3,,66585460
1,224585928,85,MIR4742,3,,224586013
2,35696470,82,MIR548AD,3,,35696552
8,96281063,541308,C8orf37-AS1,3,,96822371
13,41371120,124766,TPTE2P5,3,,41495886
20,61405472,2736,LINC00659,3,,61408208
5,108063525,437,LINC01023,3,,108063962
15,33528676,11080,TMCO5B,3,,33539756
17,77681074,5007,HP09025,3,,77686081
Y,24462824,3707,LOC100652931,3,,24466531
8,128025398,7861,PCAT1,3,,128033259
4,3064972,11269,HTT-AS,3,,3076241
2,75317938,103,MIR5000,3,,75318041
13,55748588,95,MIR5007,3,,55748683
11,9111858,68,MIR5691,3,,9111926
13,42142421,110,MIR5006,3,,42142531
17,40646790,58,MIR548AT,3,,40646848
6,6169566,76,MIR5683,3,,6169642
2,233415183,100,MIR5001,3,,233415283
17,40666205,120,MIR5010,3,,40666325
16,88535325,114,MIR5189,3,,88535439
17,45050382,84,MIR5089,3,,45050466
19,50185373,79,MIR5088,3,,50185452
15,86368865,96,MIR548AP,3,,86368961
10,687628,90,MIR5699,3,,687718
1,161196975,76,MIR5187,3,,161197051
8,95439939,9241,FSBP,3,,95449180
X,22211121,1100142,PTCHD1-AS,3,,23311263
1,221006104,47378,HLX-AS1,3,,221053482
3,186569675,4237,ADIPOQ-AS1,3,,186573912
13,78628989,562471,RNF219-AS1,3,,79191460
9,71911596,10376,BANCR,3,,71921972
17,41120104,12441,PTGES3L,3,,41132545
7,139025877,82326,C7orf55-LUC7L2,3,,139108203
17,38183795,103,SNORD124,3,,38183898
20,33864135,1825,MMP24-AS1,3,,33865960
13,80585211,15587,LINC01080,3,,80600798
1,205404013,21201,BLACAT1,3,,205425214
7,99933701,5250,STAG3L5P,3,,99938951
2,241522166,3567,CAPN10-AS1,3,,241525733
8,76135351,55365,CASC9,3,,76190716
7,74103270,39986,LOC101926943,3,,74143256
2,47441087,131126,LOC101927043,3,,47572213
7,2477397,10088,LOC101927181,3,,2487485
7,7589734,15962,LOC101927391,3,,7605696
9,84304627,87187,LOC101927502,3,,84391814
7,19958603,221446,LOC101927668,3,,20180049
5,157747711,89070,LOC101927697,3,,157836781
2,77970821,547036,LOC101927967,3,,78517857
21,45834474,10972,TRPM2-AS,3,,45845446
3,180425377,162589,LOC101928882,3,,180587966
10,25940640,81224,LINC00836,3,,26021864
5,1887444,13160,CTD-2194D22.4,3,,1900604
3,64547021,28739,ADAMTS9-AS1,3,,64575760
6,31902250,7251,C2-AS1,3,,31909501
4,153258806,442,DEAR,3,,153259248
7,134891746,84,MIR6509,3,,134891830
1,1247881,65,MIR6727,3,,1247946
7,2297149,63,MIR6836,3,,2297212
8,27468117,151,MIR6843,3,,27468268
9,126247807,94,MIR7150,3,,126247901
19,13051297,57,MIR6515,3,,13051354
6,1390548,98,MIR6720,3,,1390646
16,18437869,67,MIR6511A2,3,,18437936
6,6169536,132,MIR7853,3,,6169668
4,172107334,109,MIR6082,3,,172107443
4,154228620,1343,ANXA2P1,2,,154229963
10,66585284,1350,ANXA2P3,2,,66586634
3,55691242,2255,ERC2-IT1,2,,55693497
2,27615489,954,FTH1P3,2,,27616443
1,70385004,996,PIN1P1,2,,70386000
17,28951335,2490,SH3GL1P2,2,,28953825
1,220439520,1537,AURKAPS1,2,,220441057
15,76551629,864,TYRO3P,2,,76552493
19,22934984,31989,ZNF99,2,,22966973
6,125229391,54782,RNF217-AS1,2,,125284173
11,86567972,1024,OR7E2P,2,,86568996
16,5008317,60839,SEC14L5,2,,5069156
11,17073432,1159,OR7E14P,2,,17074591
17,26574469,846,PPY2,2,,26575315
6,118822535,2461,BRD7P3,2,,118824996
9,111892572,36999,FRRS1L,2,,111929571
15,90889762,2917,GABARAPL3,2,,90892679
22,24340594,6664,GSTTP1,2,,24347258
22,32329506,11842,C22orf24,2,,32341348
5,470624,2456,PP7080,2,,473080
3,33191536,69171,SUSD5,2,,33260707
17,28886583,3926,TBC1D29,2,,28890509
8,58192101,5189,LINC00588,2,,58197290
14,93651374,2051,TMEM251,2,,93653425
22,19010136,927,DGCR10,2,,19011063
11,7870597,521,OR5E1P,2,,7871118
5,180794287,939,OR4F3,2,,180795226
13,27829200,72,SNORD102,2,,27829272
17,27050698,74,SNORD4B,2,,27050772
9,134365872,86,SNORD62A,2,,134365958
16,2205023,83,SNORD60,2,,2205106
12,57038810,75,SNORD59A,2,,57038885
18,47018033,66,SNORD58B,2,,47018099
18,47017652,65,SNORD58A,2,,47017717
20,2637584,72,SNORD57,2,,2637656
20,2637269,71,SNORD56,2,,2637340
2,29149932,76,SNORD53,2,,29150008
2,207026604,70,SNORD51,2,,207026674
17,16343349,71,SNORD49A,2,,16343420
1,173833506,77,SNORD47,2,,173833583
1,76255161,71,SNORD45B,2,,76255232
1,76253573,84,SNORD45A,2,,76253657
1,173835105,61,SNORD44,2,,173835166
17,27047567,67,SNORD42B,2,,27047634
19,12817262,70,SNORD41,2,,12817332
19,3982504,66,SNORD37,2,,3982570
1,22351683,6034,LINC00339,2,,22357717
17,72983726,18166,CDR2L,2,,73001892
12,112277572,3134,MAPKAPK5-AS1,2,,112280706
5,74323288,3436,GCNT4,2,,74326724
4,156750880,36545,ASIC5,2,,156787425
21,15215453,5232,CYP4F29P,2,,15220685
21,26758132,45881,LINC00158,2,,26804013
21,19207988,49937,CHODL-AS1,2,,19257925
21,45925926,10532,TSPEAR-AS1,2,,45936458
21,43136595,1147,LINC00112,2,,43137742
7,6655526,8395,ZNF853,2,,6663921
17,48838394,6482,LINC00483,2,,48844876
15,50641134,5942,FLJ10038,2,,50647076
17,43583248,14641,LRRC37A4P,2,,43597889
22,46446338,3686,PRR34,2,,46450024
X,101804892,21729,NXF4,2,,101826621
18,1268311,91319,LINC00470,2,,1359630
14,70036530,5070,CCDC177,2,,70041600
15,90234027,52842,WDR93,2,,90286869
2,54756358,620,RPL23AP32,2,,54756978
11,71249070,1183,KRTAP5-8,2,,71250253
Y,6274284,22201,TTTY2,2,,6296485
6,88106841,2618,C6orf164,2,,88109459
17,80015747,7950,DUS1L,2,,80023697
7,156333184,611,LINC00244,2,,156333795
Y,9448329,4433,RBMY3AP,2,,9452762
19,59086765,8997,CENPBD1P1,2,,59095762
20,43285091,15289,LINC01260,2,,43300380
3,97983128,978,OR5H6,2,,97984106
3,98001731,945,OR5H2,2,,98002676
2,71251204,5856,OR7E91P,2,,71257060
6,71998144,20618,OGFRL1,2,,72018762
12,117151124,24751,C12orf49,2,,117175875
12,31477249,1630,FLJ13224,2,,31478879
2,241825464,10109,C2orf54,2,,241835573
19,53471503,25281,ZNF702P,2,,53496784
15,69096159,3281,ANP32A-IT1,2,,69099440
19,33793762,2201,CEBPA-AS1,2,,33795963
1,170904611,129295,MROH9,2,,171033906
X,1519423,13056,ASMTL-AS1,2,,1532479
19,7933604,5722,PRR36,2,,7939326
3,97806016,930,OR5AC2,2,,97806946
22,16448823,981,OR11H1,2,,16449804
14,20443677,1047,OR4K15,2,,20444724
11,55904246,948,OR8J3,2,,55905194
11,55110676,987,OR4A16,2,,55111663
5,180794287,939,OR4F16,2,,180795226
1,158669467,975,OR6K2,2,,158670442
1,247751661,954,OR2G2,2,,247752615
1,182868997,53663,SHCBP1L,2,,182922660
17,39295684,1055,KRTAP4-6,2,,39296739
3,46598887,2291,LRRC2-AS1,2,,46601178
8,11434043,4807,LINC00208,2,,11438850
Y,24442944,2079,TTTY5,2,,24445023
12,45456400,2794,RACGAP1P,2,,45459194
X,64770501,1800,FRMD8P1,2,,64772301
1,85623355,43373,SYDE2,2,,85666728
10,134598319,1218,NKX6-2,2,,134599537
17,39315905,1078,KRTAP4-4,2,,39316983
Y,9528708,2600,TTTY8,2,,9531308
6,90604187,1632,GJA10,2,,90605819
4,7755816,24838,AFAP1-AS1,2,,7780654
3,192959567,2194,MGC2889,2,,192961761
19,36378853,12711,NFKBID,2,,36391564
1,16944750,12651,CROCCP2,2,,16957401
9,3898645,2603,GLIS3-AS1,2,,3901248
2,121221910,2015,LINC01101,2,,121223925
19,4343523,16560,MPND,2,,4360083
9,139619683,2953,SNHG7,2,,139622636
21,33765441,825,URB1-AS1,2,,33766266
17,39323482,942,KRTAP4-3,2,,39324424
22,30764799,9095,KIAA1656,2,,30773894
15,32698800,28265,ULK4P3,2,,32727065
7,142759380,1502,OR6W1P,2,,142760882
3,128226677,2752,LOC90246,2,,128229429
2,86247338,3653,LOC90784,2,,86250991
7,57187325,20246,ZNF479,2,,57207571
9,139971952,7038,UAP1L1,2,,139978990
15,25227140,75,SNORD107,2,,25227215
X,62646438,134435,LINC01278,2,,62780873
5,81575280,39185,ATP6AP1L,2,,81614465
5,122424840,98905,PRDM6,2,,122523745
4,6675820,1954,LOC93622,2,,6677774
19,51293671,4810,ACPT,2,,51298481
7,116752345,33301,ST7-AS2,2,,116785646
6,27276841,3170,POM121L2,2,,27280011
9,140098534,1556,TMEM203,2,,140100090
17,13927814,1101,CDRT15P1,2,,13928915
1,45243513,71,SNORD38A,2,,45243584
1,45244061,69,SNORD38B,2,,45244130
19,50970041,9962,FAM71E1,2,,50980003
Y,25082601,36830,TTTY4,2,,25119431
1,16793930,25266,CROCCP3,2,,16819196
1,2481358,7092,LOC115110,2,,2488450
1,166573152,21321,FMO9P,2,,166594473
12,131649555,47921,LINC01257,2,,131697476
22,39711217,95,SNORD83A,2,,39711312
22,39709823,93,SNORD83B,2,,39709916
10,131904272,2829,CTAGE7P,2,,131907101
10,118187423,50045,PNLIPRP3,2,,118237468
11,5020212,948,OR51L1,2,,5021160
11,4928599,939,OR51A7,2,,4929538
11,4869466,972,OR51S1,2,,4870438
11,4842615,1029,OR51F2,2,,4843644
11,51515281,930,OR4C46,2,,51516211
11,48238361,930,OR4B1,2,,48239291
11,4470524,1067,OR52K2,2,,4471591
11,89701671,5569,TRIM64,2,,89707240
11,20177759,4111,DBX1,2,,20181870
11,6023280,1098,OR56A4,2,,6024378
11,6047900,1071,OR56A1,2,,6048971
12,100646041,14816,DEPDC4,2,,100660857
12,50721094,69311,FAM186A,2,,50790405
12,48876285,14012,C12orf54,2,,48890297
13,103532448,15935,METTL21EP,2,,103548383
14,20482419,933,OR4K14,2,,20483352
16,46503248,99761,ANKRD26P1,2,,46603009
17,56497527,68235,HSF5,2,,56565762
17,8271970,2888,KRBA2,2,,8274858
17,47325604,10423,FLJ40194,2,,47336027
19,51870351,1906,CLDND2,2,,51872257
19,9225503,936,OR7G1,2,,9226439
19,49164663,11675,NTN5,2,,49176338
19,16059817,951,OR10H4,2,,16060768
1,116654375,23486,MAB21L3,2,,116677861
1,109648572,7907,C1orf194,2,,109656479
1,248457917,963,OR2T12,2,,248458880
1,248512076,939,OR14C36,2,,248513015
1,248756130,939,OR2T10,2,,248757069
1,248789478,951,OR2T11,2,,248790429
1,75033794,105628,ERICH3,2,,75139422
1,33772366,14333,A3GALT2,2,,33786699
1,145477066,24603,LIX1L,2,,145501669
1,112016490,4644,C1orf162,2,,112021134
20,45169669,9544,OCSTAMP,2,,45179213
2,207602488,27785,MDH1B,2,,207630273
3,63638343,12548,SNTN,2,,63650891
4,57371374,18684,ARL9,2,,57390058
4,4190529,38092,OTOP1,2,,4228621
5,7830490,21113,C5orf49,2,,7851603
9,136519708,2822,DBH-AS1,2,,136522530
X,125683365,3477,DCAF12L1,2,,125686842
X,72744110,38811,MAP2K4P1,2,,72782921
X,27996109,3457,DCAF8L1,2,,27999566
X,152683780,3306,ZFP92,2,,152687086
11,573807,2078,LOC143666,2,,575885
12,93959403,5771,SOCS2-AS1,2,,93965174
12,94853778,2566,CEP83-AS1,2,,94856344
12,119721629,19556,LINC00934,2,,119741185
13,91543207,35644,LINC00410,2,,91578851
14,70712469,2049,ADAM21P1,2,,70714518
14,52116235,2227,FRMD6-AS1,2,,52118462
15,57178367,32330,LOC145783,2,,57210697
15,99511458,37427,PGPEP1L,2,,99548885
15,69854058,9721,LOC145837,2,,69863779
16,67323392,37269,KCTD19,2,,67360661
16,1114081,14650,SSTR5-AS1,2,,1128731
16,3077867,7675,CCDC64B,2,,3085542
16,86320036,6959,LOC146513,2,,86326995
18,5236722,1306,LINC00526,2,,5238028
19,57154526,14088,SMIM17,2,,57168614
19,45116939,23142,IGSF23,2,,45140081
19,10762537,2011,ILF3-AS1,2,,10764548
19,53935226,12699,TPM3P9,2,,53947925
19,40721964,2342,TTC9B,2,,40724306
19,28281400,3448,LINC00662,2,,28284848
1,6296299,3203,LINC00337,2,,6299502
1,246952918,1870,LINC01341,2,,246954788
1,231319844,3529,LOC149373,2,,231323373
1,213003484,17507,SPATA45,2,,213020991
20,5476712,8530,LINC00654,2,,5485242
20,26084051,10626,NCOR1P1,2,,26094677
22,19553652,710,LINC00895,2,,19554362
22,20193854,2206,LINC00896,2,,20196060
22,32545518,9725,C22orf42,2,,32555243
22,46691039,1518,GTSE1-AS1,2,,46692557
2,200332820,4661,SATB2-AS1,2,,200337481
2,240984493,996,OR6B3,2,,240985489
2,96472799,19930,LINC00342,2,,96492729
2,240684553,37803,LOC150935,2,,240722356
2,239419330,44810,LINC01107,2,,239464140
2,108938693,31561,SULT1C2P1,2,,108970254
2,219841005,1639,LINC00608,2,,219842644
2,232373136,5914,LINC00471,2,,232379050
2,234774089,2966,MSL3P1,2,,234777055
3,20026835,26930,PP2D1,2,,20053765
4,42399855,4649,SHISA3,2,,42404504
4,184018173,2179,WWC2-AS2,2,,184020352
4,14113591,28085,LINC01085,2,,14141676
5,43042235,3135,LOC153684,2,,43045370
6,142847591,111382,LOC153910,2,,142958973
6,144185572,73911,ZC2HC1B,2,,144259483
6,134142284,32846,LINC01312,2,,134175130
6,170563421,8236,LOC154449,2,,170571657
7,143509060,24750,LOC154761,2,,143533810
7,158801044,17885,LINC00689,2,,158818929
8,104145190,8380,BAALC-AS2,2,,104153570
8,67783736,33863,MCMDC2,2,,67817599
8,41502696,2182,NKX6-3,2,,41504878
9,38621084,2193,FAM201A,2,,38623277
9,96938851,27997,MIRLET7DHG,2,,96966848
9,94903748,18142,LINC00475,2,,94921890
9,98828120,36074,LOC158435,2,,98864194
Y,23557033,6415,RBMY2EP,2,,23563448
11,6226797,5568,C11orf42,2,,6232365
15,76016318,3709,ODF3L1,2,,76020027
16,27078218,2269,C16orf82,2,,27080487
19,52658124,16772,ZNF836,2,,52674896
19,5782970,1806,PRR22,2,,5784776
1,109255555,29812,FNDC7,2,,109285367
1,53904042,1651,SLC25A3P1,2,,53905693
20,23499782,22873,CST13P,2,,23522655
4,155702423,47542,RBM46,2,,155749965
10,50362768,33677,C10orf128,2,,50396445
10,86039735,14680,LINC00858,2,,86054415
20,32254303,2028,ACTL10,2,,32256331
7,73149398,932,ABHD11-AS1,2,,73150330
11,6128913,1152,OR56B4,2,,6130065
14,105287537,2518,LINC00638,2,,105290055
16,88729780,23814,SNAI3-AS1,2,,88753594
1,54604667,14012,CDCP2,2,,54618679
20,23105704,7569,LINC00656,2,,23113273
22,18260055,2192,LINC00528,2,,18262247
3,125648117,7770,ALG1L,2,,125655887
17,40177593,12451,ZNF385C,2,,40190044
18,3878179,18890,DLGAP1-AS3,2,,3897069
5,36247020,54991,RANBP3L,2,,36302011
5,177045500,53778,LOC202181,2,,177099278
5,95187935,7901,LINC01554,2,,95195836
4,189012425,14316,TRIML2,2,,189026741
6,88054570,20611,C6orf163,2,,88075181
6,7986334,4243,PIP5K1P1,2,,7990577
10,10826401,10476,SFTA1P,2,,10836877
7,141968100,3968,TRY2P,2,,141972068
10,81805988,32961,TMEM254-AS1,2,,81838949
11,55339603,933,OR4C16,2,,55340536
11,55370829,1045,OR4C11,2,,55371874
11,55432642,930,OR4C6,2,,55433572
11,55563031,945,OR5D14,2,,55563976
11,55926869,924,OR8K5,2,,55927793
11,55999581,1080,OR5T2,2,,56000661
11,56057602,936,OR8H1,2,,56058538
11,56805008,927,OR5AK4P,2,,56805935
11,124134722,1041,OR8G5,2,,124135763
11,123900329,936,OR10G8,2,,123901265
11,123810323,957,OR4D5,2,,123811280
11,57885971,945,OR9I1,2,,57886916
11,57970675,978,OR1S2,2,,57971653
11,57995353,1037,OR10Q1,2,,57996390
11,59271048,936,OR4D11,2,,59271984
11,70708894,2326,SHANK2-AS3,2,,70711220
11,82443045,1861,FAM181B,2,,82444906
3,197340897,13855,LOC220729,2,,197354752
10,31605456,2568,ZEB1-AS1,2,,31608024
6,43968336,7016,C6orf223,2,,43975352
6,28058584,4909,ZSCAN12P1,2,,28063493
6,10428017,7038,LINC00518,2,,10435055
7,20866916,523,RPL23P8,2,,20867439
6,50011287,5077,DEFB112,2,,50016364
6,49936389,949,DEFB113,2,,49937338
20,30009241,7742,DEFB122,2,,30016983
8,11921897,7359,DEFB130,2,,11929256
9,123605319,11332,PSMD5-AS1,2,,123616651
12,9208184,9482,LINC00612,2,,9217666
3,186172769,38681,LOC253573,2,,186211450
17,48633567,5902,CACNA1G-AS1,2,,48639469
1,1072396,7038,LINC01342,2,,1079434
2,122407564,1550,NIFK-AS1,2,,122409114
11,65713114,14320,TSGA10IP,2,,65727434
10,10976902,17224,LINC00710,2,,10994126
15,89921272,20446,LINC00925,2,,89941718
1,248550909,927,OR2T6,2,,248551836
8,22941867,19203,LOC254896,2,,22961070
9,125486268,936,OR1L4,2,,125487204
3,126380923,9859,NUP210P1,2,,126390782
7,99724316,1805,MBLAC1,2,,99726121
12,114845999,4638,TBX5-AS1,2,,114850637
11,1330937,1000,TOLLIP-AS1,2,,1331937
19,47778141,839,INAFM1,2,,47778980
3,196233747,8490,SMCO1,2,,196242237
19,10959105,21255,C19orf38,2,,10980360
3,195686791,30359,SDHAP1,2,,195717150
12,92378751,156738,C12orf79,2,,92535489
7,19758937,53467,TMEM196,2,,19812404
11,48346492,990,OR4C3,2,,48347482
11,48327774,930,OR4S1,2,,48328704
7,22478037,61864,STEAP1B,2,,22539901
11,554849,5930,LMNTD2,2,,560779
7,23530006,1025,RPS2P32,2,,23531031
9,34723049,6486,FAM205A,2,,34729535
22,21043842,2167,POM121L4P,2,,21046009
22,43011250,149,RNU12,2,,43011399
X,52651984,11014,SSX8,2,,52662998
11,55735033,906,OR10AG1,2,,55735939
11,55944093,939,OR5J2,2,,55945032
10,91451056,6629,FLJ37201,2,,91457685
10,44404743,60612,LINC00841,2,,44465355
10,122521323,89368,WDR11-AS1,2,,122610691
11,9779839,53027,SBF2-AS1,2,,9832866
11,5220964,966,OR51V1,2,,5221930
11,49053151,6378,TRIM49B,2,,49059529
11,64705701,33862,C11orf85,2,,64739563
11,130542850,44397,C11orf44,2,,130587247
11,134306375,69180,LOC283177,2,,134375555
11,60383223,71398,LINC00301,2,,60454621
11,695590,8541,TMEM80,2,,704131
12,7260903,13544,C1RL-AS1,2,,7274447
12,50302665,2981,LOC283332,2,,50305646
12,40019968,95752,C12orf40,2,,40115720
13,102944669,102200,FGF14-IT1,2,,103046869
13,111516333,6322,LINC00346,2,,111522655
13,41486024,9886,SUGT1P3,2,,41495910
13,52387482,31804,LINC00282,2,,52419286
15,57592562,7405,LINC00926,2,,57599967
15,80555409,78738,LINC00927,2,,80634147
15,83316520,45052,CPEB1-AS1,2,,83361572
15,90048160,19105,LINC00928,2,,90067265
15,22736245,9757,GOLGA6L1,2,,22746002
16,66788878,46645,CCDC79,2,,66835523
16,65318401,291802,LINC00922,2,,65610203
16,2259253,1816,BRICD5,2,,2261069
16,1469744,1057,C16orf91,2,,1470801
17,76227390,9678,TMEM235,2,,76237068
17,2310274,8456,LOC284009,2,,2318730
17,65987214,2551,C17orf58,2,,65989765
17,7816639,2626,LOC284023,2,,7819265
17,39782578,13873,KRT42P,2,,39796451
17,21904061,9009,FLJ36000,2,,21913070
17,79213110,1988,C17orf89,2,,79215098
17,79276623,6425,LINC00482,2,,79283048
18,4264601,31399,DLGAP1-AS5,2,,4296000
18,52258389,8335,DYNAP,2,,52266724
18,74240611,31173,LINC00908,2,,74271784
19,42806283,8690,PRR19,2,,42814973
19,51320936,1198,MGC45922,2,,51322134
19,37756840,3072,LOC284412,2,,37759912
1,173469603,102630,SLC9C2,2,,173572233
1,31984035,5811,LINC01226,2,,31989846
1,803450,8732,FAM41C,2,,812182
1,4472110,12634,LOC284661,2,,4484744
1,170240545,12804,LINC01142,2,,170253349
1,17017712,28940,ESPNP,2,,17046652
20,62665696,5619,LINC00176,2,,62671315
20,46988653,10728,LINC00494,2,,46999381
20,48909256,22200,LINC01270,2,,48931456
20,58713547,183767,MIR646HG,2,,58897314
20,25121433,7993,LOC284798,2,,25129426
20,26167654,22215,MIR663AHG,2,,26189869
21,45225638,6810,LOC284837,2,,45232448
22,20186252,6189,LOC284865,2,,20192441
2,279560,8748,FAM150B,2,,288308
2,96874153,34209,STARD7-AS1,2,,96908362
2,242811885,3597,RTP5,2,,242815482
2,130887195,9791,MED15P9,2,,130896986
2,162355577,8836,AHCTF1P1,2,,162364413
2,218933737,21567,RUFY4,2,,218955304
2,241499470,3961,DUSP28,2,,241503431
3,107602051,45702,LINC00636,2,,107647753
3,47205859,79747,KIF9-AS1,2,,47285606
3,184795837,74965,C3orf70,2,,184870802
4,1203907,8472,CTBP1-AS,2,,1212379
4,3578595,14117,LINC00955,2,,3592712
5,3417265,118943,LINC01019,2,,3536208
5,171621175,9283,EFCAB9,2,,171630458
5,173006636,5435,LOC285593,2,,173012071
5,160358785,6848,LOC285629,2,,160365633
5,180581942,948,OR2V2,2,,180582890
5,9641426,262510,LOC285692,2,,9903936
6,143875251,15225,LOC285740,2,,143890476
6,114189178,5334,LINC01268,2,,114194512
6,114225550,17256,FLJ34503,2,,114242806
6,163731016,14489,PACRG-AS1,2,,163745505
6,166719167,2704,PRR18,2,,166721871
6,35694538,10186,LOC285847,2,,35704724
7,54624662,14757,VSTM2A-OT1,2,,54639419
7,44040488,9235,SPDYE1,2,,44049723
10,38671997,19783,SEPT7P9,2,,38691780
7,143104905,115635,EPHA1-AS1,2,,143220540
7,143318044,104132,FAM115C,2,,143422176
8,22925741,15391,LOC286059,2,,22941132
8,146220250,4033,TMED10P1,2,,146224283
8,146228196,3236,ZNF252P-AS1,2,,146231432
8,144120625,15095,C8orf31,2,,144135720
8,64681987,16067,LINC01289,2,,64698054
8,69215702,28024,LOC286189,2,,69243726
9,91262093,4982,LOC286238,2,,91267075
9,115875175,6951,FAM225A,2,,115882126
9,107379528,957,OR13C9,2,,107380485
9,107456702,1041,OR13D1,2,,107457743
Y,9154669,5814,RBMY1A3P,2,,9160483
X,153860738,710,FAM223B,2,,153861448
4,2937272,15528,NOP14-AS1,2,,2952800
5,94982582,10267,RFESD,2,,94992849
14,21865451,109,SNORD8,2,,21865560
21,32201357,694,KRTAP7-1,2,,32202051
21,31720716,208,KRTAP23-1,2,,31720924
21,31964758,616,KRTAP6-3,2,,31965374
21,31863781,494,KRTAP19-3,2,,31864275
21,31913853,330,KRTAP19-6,2,,31914183
21,32015182,273,KRTAP20-3,2,,32015455
14,106938444,13085,LINC00221,2,,106951529
7,116593952,5915,ST7-OT4,2,,116599867
15,25232071,69,SNORD108,2,,25232140
15,25523489,67,SNORD109A,2,,25523556
15,25523489,67,SNORD109B,2,,25523556
7,155149682,10946,BLACE,2,,155160628
11,1593970,26444,KRTAP5-AS1,2,,1620414
11,123753632,2717,TMEM225,2,,123756349
11,56408964,951,OR5AP2,2,,56409915
11,33183202,29940,CSTF3-AS1,2,,33213142
12,90102731,2998,LINC00936,2,,90105729
12,49726199,4772,C1QL4,2,,49730971
12,131832014,20086,LOC338797,2,,131852100
12,122233172,8218,LINC01089,2,,122241390
13,75126979,4278,LINC00347,2,,75131257
15,83379222,3523,LOC338963,2,,83382745
17,54869273,41983,C17orf67,2,,54911256
17,18325494,3153,KRT17P5,2,,18328647
1,38674705,5734,LINC01343,2,,38680439
1,228003417,30754,PRSS38,2,,228034171
1,20686293,68994,LINC01141,2,,20755287
1,238643683,5634,LINC01139,2,,238649317
1,45140393,50870,C1orf228,2,,45191263
22,42348190,6756,LINC00634,2,,42354946
2,239008950,32978,ESPNL,2,,239041928
2,26785426,16974,C2orf70,2,,26802400
3,49236932,58605,CCDC36,2,,49295537
3,18004063,306347,LOC339862,2,,18310410
3,156799455,41336,LINC00880,2,,156840791
3,46871893,3692,PRSS42,2,,46875585
4,188225236,201531,LOC339975,2,,188426767
5,118965253,6264,FAM170A,2,,118971517
5,79852573,13731,ANKRD34B,2,,79866304
6,29718583,342,IFITM4P,2,,29718925
7,38724945,1744,FAM183B,2,,38726689
7,143452181,2662,CTAGE6,2,,143454843
X,102942211,5273,MORF4L2-AS1,2,,102947484
Y,20551155,15777,FAM41AY1,2,,20566932
10,90562486,17817,LIPM,2,,90580303
10,5196654,30496,AKR1C8P,2,,5227150
10,22497742,1170,EBLN1,2,,22498912
11,74799795,963,OR2AT4,2,,74800758
12,29580488,70131,OVCH1,2,,29650619
14,21108854,996,OR6S1,2,,21109850
16,4606490,43828,C16orf96,2,,4650318
19,37234379,29337,ZNF850,2,,37263716
19,56701057,3364,ZSCAN5B,2,,56704421
1,12704565,22532,AADACL4,2,,12727097
1,248636651,957,OR2T3,2,,248637608
2,17997785,582,MSGN1,2,,17998367
2,73429385,8955,NOTO,2,,73438340
2,88747725,4328,FOXI3,2,,88752053
2,39405687,50986,CDKL4,2,,39456673
3,154055460,92044,GPR149,2,,154147504
3,192992830,103684,ATP13A5,2,,193096514
4,152198324,14281,PRSS48,2,,152212605
4,77816081,2921,SOWAHB,2,,77819002
7,55861236,69246,14-Sep,2,,55930482
9,84528351,6491,SPATA31D5P,2,,84534842
X,37430821,105929,LANCL3,2,,37536750
X,27764925,2013,DCAF8L2,2,,27766938
X,118892575,1590,SOWAHD,2,,118894165
X,133371076,8732,CCDC160,2,,133379808
X,139037883,9794,CXorf66,2,,139047677
15,25230246,67,SNORD64,2,,25230313
15,65204100,46941,ANKDD1A,2,,65251041
15,21145766,52867,LINC01193,2,,21198633
1,53099015,23722,FAM159A,2,,53122737
3,197784403,23139,ANKRD18DP,2,,197807542
7,151078206,28918,WDR86,2,,151107124
8,7141006,2874,LINC00965,2,,7143880
11,112118875,12708,PLET1,2,,112131583
4,100081750,1054,PCNAP1,2,,100082804
15,40824082,667,MRPL42P5,2,,40824749
4,21844963,9848,KCNIP4-IT1,2,,21854811
1,157098153,310,CYCSP52,2,,157098463
16,58010338,11679,TEPP,2,,58022017
18,14748238,104499,ANKRD30B,2,,14852737
1,16725137,38782,SPATA21,2,,16763919
2,241631261,6639,AQP12A,2,,241637900
7,128516918,33855,KCP,2,,128550773
9,67270214,19278,AQP7P1,2,,67289492
22,30877276,467,SDC4P,2,,30877743
3,46783580,2665,PRSS45,2,,46786245
21,46419121,5521,LINC00162,2,,46424642
5,54824669,5701,RNF138P1,2,,54830370
21,46077848,410,KRTAP12-3,2,,46078258
11,3239173,870,MRGPRG,2,,3240043
6,134435110,3708,HMGA1P7,2,,134438818
6,86386724,1727,SNHG5,2,,86388451
11,71276608,1058,KRTAP5-10,2,,71277666
21,22114907,60519,LINC00320,2,,22175426
10,27220134,10796,LINC00202-1,2,,27230930
12,13028410,660,RPL13AP20,2,,13029070
12,27849427,1139,REP15,2,,27850566
12,113587662,9419,CCDC42B,2,,113597081
12,127215246,41562,LINC00944,2,,127256808
14,29241909,22091,LINC01551,2,,29264000
14,105057200,13897,TMEM179,2,,105071097
15,51348798,48675,TNFAIP8L3,2,,51397473
15,84867599,31321,GOLGA2P7,2,,84898920
16,855442,8419,PRR25,2,,863861
16,73160536,17810,C16orf47,2,,73178346
17,6555058,1559,C17orf100,2,,6556617
17,10616638,17008,TMEM220,2,,10633646
17,41026690,24061,LINC00671,2,,41050751
19,15870143,20655,CYP4F24P,2,,15890798
1,16068986,5306,TMEM82,2,,16074292
1,92683572,27795,C1orf146,2,,92711367
1,143717587,26932,LINC01138,2,,143744519
1,205052256,1332,TMEM81,2,,205053588
1,248285437,645,OR2M1P,2,,248286082
22,44965219,3110,LINC00207,2,,44968329
2,54480314,3095,TSPYL6,2,,54483409
2,84517805,1519,FUNDC2P2,2,,84519324
2,115901624,17296,DPP10-AS1,2,,115918920
2,132160473,5328,LINC01120,2,,132165801
3,42947657,13168,ZNF662,2,,42960825
3,51907736,1864,IQCF5,2,,51909600
3,138737872,1896,PRR23B,2,,138739768
3,146303624,20379,PLSCR5,2,,146324003
4,42112869,42026,BEND4,2,,42154895
5,135527155,1696,LOC389332,2,,135528851
6,35744370,2959,CLPSL2,2,,35747329
6,36283534,21128,C6orf222,2,,36304662
7,5111690,1164,RBAKDN,2,,5112854
8,12272029,3512,FAM90A25P,2,,12275541
8,53446596,31425,FAM150A,2,,53478021
8,71581599,66578,XKR9,2,,71648177
8,94146323,32756,C8orf87,2,,94179079
9,84558414,6595,SPATA31D3,2,,84565009
9,88420916,36878,LOC389765,2,,88457794
9,130890807,2106,PTGES2-AS1,2,,130892913
9,139654085,4880,LCN15,2,,139658965
10,126135997,2553,NKX1-2,2,,126138550
11,5152921,951,OR52A5,2,,5153872
11,5443340,1096,OR51Q1,2,,5444436
11,5565790,963,OR52H1,2,,5566753
11,5775922,1037,OR52N4,2,,5776959
11,5798863,1034,OR52N5,2,,5799897
11,5841565,966,OR52N2,2,,5842531
11,5905522,939,OR52E4,2,,5906461
11,48285412,918,OR4X1,2,,48286330
11,55606227,987,OR5D16,2,,55607214
11,55872518,939,OR8H2,2,,55873457
11,56019675,1023,OR5T3,2,,56020698
11,56229944,933,OR5M9,2,,56230877
11,56380030,948,OR5M1,2,,56380978
11,56467863,918,OR9G1,2,,56468781
11,56756388,930,OR5AK2,2,,56757318
11,59282385,945,OR4D9,2,,59283330
11,59480388,930,OR10V1,2,,59481318
11,61276271,2219,LRRC10B,2,,61278490
11,67380994,2141,DOC2GP,2,,67383135
11,94038802,2056,IZUMO1R,2,,94040858
14,20271928,24603,OR4N2,2,,20296531
14,20344426,945,OR4K2,2,,20345371
14,20665494,1038,OR11G2,2,,20666532
14,20710950,975,OR11H4,2,,20711925
15,22368477,1084,OR4M2,2,,22369561
17,37313146,9268,ARL5C,2,,37322414
19,9212944,1038,OR7G2,2,,9213982
19,37997840,36399,ZNF793,2,,38034239
19,57752052,22054,ZNF805,2,,57774106
1,48567386,80714,SKINTL,2,,48648100
1,158389717,939,OR10K2,2,,158390656
1,158686957,948,OR6K3,2,,158687905
1,248112159,939,OR2L8,2,,248113098
1,248128633,1008,OR2AK2,2,,248129641
1,248343287,1044,OR2M2,2,,248344331
1,248684947,951,OR2G6,2,,248685898
20,44350987,3348,SPINT4,2,,44354335
21,15316095,36670,ANKRD20A11P,2,,15352765
9,35817013,11731,FAM221B,2,,35828744
9,90387829,13970,CTSL3P,2,,90401799
9,125512126,936,OR1L6,2,,125513062
9,125551211,963,OR5C1,2,,125552174
9,138555167,2588,LCN9,2,,138557755
X,100224696,21124,ARL13A,2,,100245820
1,29445936,4485,TMEM200B,2,,29450421
10,1205707,4905,LINC00200,2,,1210612
10,124639148,19082,LOC399815,2,,124658230
10,129535537,3913,FOXI2,2,,129539450
11,126211611,13871,ST3GAL4-AS1,2,,126225482
12,54519854,6772,LOC400043,2,,54526626
12,110478981,26519,C12orf76,2,,110505500
12,126443233,24687,LINC00939,2,,126467920
12,128366161,17023,FLJ37505,2,,128383184
14,90921573,3676,LINC00642,2,,90925249
14,95624024,22246,DICER1-AS1,2,,95646270
15,95822518,47811,LINC01197,2,,95870329
17,18314472,3230,FLJ35934,2,,18317702
17,19030781,31367,GRAPL,2,,19062148
17,70076078,40856,SOX9-AS1,2,,70116934
17,70594179,42432,LINC00511,2,,70636611
18,6925472,4396,LINC00668,2,,6929868
18,70821292,110441,LOC400655,2,,70931733
19,21666516,19524,LINC00664,2,,21686040
19,32880955,15490,LOC400684,2,,32896445
19,35307057,16716,LOC400685,2,,35323773
19,57980953,7985,ZNF772,2,,57988938
1,12939032,6993,PRAMEF4,2,,12946025
1,45769581,1710,LINC01144,2,,45771291
20,1184097,4821,C20orf202,2,,1188918
21,40110948,34453,LINC00114,2,,40145401
22,48016791,10527,LINC00898,2,,48027318
22,50432941,18114,IL17REL,2,,50451055
2,6122109,6255,LOC400940,2,,6128364
2,45401479,80601,LINC01121,2,,45482080
2,70189394,124753,PCBP1-AS1,2,,70314147
2,197669138,5862,C2orf66,2,,197675000
3,51860898,3976,IQCF3,2,,51864874
3,108855560,13391,FLJ22763,2,,108868951
3,109128836,85178,LINC01205,2,,109214014
3,159943422,2578,C3orf80,2,,159946000
3,187896330,2266,FLJ42393,2,,187898596
3,194207868,1406,LINC00884,2,,194209274
4,189376731,146331,LINC01060,2,,189523062
6,36665627,35333,RAB44,2,,36700960
6,40312083,11662,LINC00951,2,,40323745
7,5862790,31276,ZNF815P,2,,5894066
7,44068485,11737,RASA4CP,2,,44080222
7,47694841,6405,C7orf65,2,,47701246
7,91774197,20393,LRRD1,2,,91794590
7,143947766,930,OR2A20P,2,,143948696
8,65486865,2955,LOC401463,2,,65489820
9,13406378,24950,LINC01235,2,,13431328
9,32783496,5703,TMEM215,2,,32789199
9,139921915,9319,C9orf139,2,,139931234
19,11784812,12572,ZNF833P,2,,11797384
1,248844669,936,OR14I1,2,,248845605
7,144015217,933,OR2A42,2,,144016150
19,51815101,19001,IGLON5,2,,51834102
2,28607275,10264,FLJ31356,2,,28617539
11,48366899,7100,OR4C45,2,,48373999
3,97868229,933,OR5H14,2,,97869162
12,55794312,939,OR6C65,2,,55795251
19,3607244,6684,CACTIN-AS1,2,,3613928
7,128766324,1726,LOC407835,2,,128768050
10,49218158,21500,CTGLF12P,2,,49239658
10,44340753,5317,LINC00619,2,,44346070
9,105281918,137873,LINC00587,2,,105419791
6,30201815,92096,HCG17,2,,30293911
Y,20891767,9316,TTTY9B,2,,20901083
1,85093912,6791,LINC01555,2,,85100703
22,21356210,8453,THAP7-AS1,2,,21364663
8,124996377,56646,FER1L6-AS1,2,,125053023
10,11113505,33946,CELF2-AS2,2,,11147451
11,1718424,561,KRTAP5-6,2,,1718985
11,9776316,4764,LOC440028,2,,9781080
11,31838113,70474,DKFZp686K1684,2,,31908587
11,71238312,898,KRTAP5-7,2,,71239210
11,71292900,1021,KRTAP5-11,2,,71293921
11,104963195,8963,CARD17,2,,104972158
11,129872518,2863,LINC00167,2,,129875381
12,8325149,7493,ZNF705A,2,,8332642
12,8332804,20792,FAM66C,2,,8353596
12,45408538,36344,DBX2,2,,45444882
12,54452037,63981,FLJ12825,2,,54516018
12,127354039,5197,LOC440117,2,,127359236
13,31456698,834,LINC00545,2,,31457532
9,89623365,33676,LOC440173,2,,89657041
15,90792763,9557,TTLL13,2,,90802320
16,29313607,62773,SNX29P2,2,,29376380
17,60342066,10950,TBC1D3P2,2,,60353016
19,7852369,3529,CLEC4GP1,2,,7855898
1,12884617,6647,PRAMEF11,2,,12891264
1,13359832,9104,PRAMEF6,2,,13368936
1,111030301,2579,LOC440602,2,,111032880
12,93771745,24307,NUDT4P1,2,,93796052
22,21738039,5416,RIMBP3B,2,,21743455
9,69174213,6828,LOC440896,2,,69181041
2,130783571,25133,FAR2P1,2,,130808704
3,9430528,8650,THUMPD3-AS1,2,,9439178
3,40214637,136552,EIF1B-AS1,2,,40351189
3,48658274,915,TMEM89,2,,48659189
4,144480624,1989,GUSBP5,2,,144482613
5,55290994,8481,FLJ31104,2,,55299475
7,32767561,2034,ZNRF2P1,2,,32769595
7,65111923,123874,LOC441242,2,,65235797
7,143268893,2587,CTAGE15,2,,143271480
8,7421309,10611,FAM90A7P,2,,7431920
8,7627105,1730,FAM90A10P,2,,7628835
8,75512100,158487,FLJ39080,2,,75670587
8,117950463,5776,AARD,2,,117956239
9,33504534,6630,SUGT1P1,2,,33511164
9,67926794,43499,ANKRD20A3,2,,67970293
9,43090424,43120,ANKRD20A2,2,,43133544
9,90532876,5696,SPATA31C1,2,,90538572
9,33524410,48591,ANKRD18B,2,,33573001
9,102648599,20284,STX17-AS1,2,,102668883
9,140145712,2223,C9orf173,2,,140147935
X,70917045,6211,LINC00891,2,,70923256
X,102962271,21281,GLRA4,2,,102983552
Y,24585736,1848,TTTY6B,2,,24587584
14,20215586,942,OR4Q3,2,,20216528
14,20248481,942,OR4M1,2,,20249423
15,101087956,11532,PRKXP1,2,,101099488
1,13607699,3834,PRAMEF7,2,,13611533
1,151990753,4232,NBPF18P,2,,151994985
2,95534429,78658,LOC442028,2,,95613087
3,10028576,20111,EMC3-AS1,2,,10048687
X,56763220,797,UQCRBP1,2,,56764017
19,46543005,1269,IGFL4,2,,46544274
1,152815329,1130,LCE6A,2,,152816459
8,6808247,874,DEFA8P,2,,6809121
8,6816810,873,DEFA9P,2,,6817683
X,154687145,1116,F8A2,2,,154688261
9,119160436,2449,PAPPA-AS1,2,,119162885
X,144329106,8622,SPANXN1,2,,144337728
X,142795134,8628,SPANXN2,2,,142803762
X,52825185,1203,SPANXN5,2,,52826388
X,76139697,88,MIR384,2,,76139785
11,60282885,27306,MS4A13,2,,60310191
15,26360959,10559,LINC00929,2,,26371518
5,98105321,3467,RGMB-AS1,2,,98108788
3,121286777,22692,ARGFX,2,,121309469
12,12508341,1660,LOH12CR2,2,,12510001
19,57663093,15763,DUXA,2,,57678856
X,56755717,88287,LINC01420,2,,56844004
8,119633239,105067,SAMD12-AS1,2,,119738306
7,35120898,104876,DPY19L2P1,2,,35225774
1,210404803,2663,SERTAD4-AS1,2,,210407466
12,246576,11756,LOC574538,2,,258332
6,133136445,73,SNORD101,2,,133136518
6,133137940,76,SNORD100,2,,133138016
8,135610313,2619,ZFAT-AS1,2,,135612932
8,122651585,5979,HAS2-AS1,2,,122657564
1,54638026,27720,CYB5RL,2,,54665746
8,11839829,2270,DEFB135,2,,11842099
8,11831445,663,DEFB136,2,,11832108
8,81540685,246331,ZNF704,2,,81787016
11,93454679,353,SCARNA9,2,,93455032
X,140590842,147227,SPANXA2-OT1,2,,140738069
5,40832757,80,SNORD72,2,,40832837
5,180668817,72,SNORD96A,2,,180668889
1,161653494,1548,RPL31P11,2,,161655042
8,7847936,7107,DEFB109P1B,2,,7855043
4,109093275,4311,LEF1-AS1,2,,109097586
10,1568824,30355,ADARB2-AS1,2,,1599179
11,89603605,5580,TRIM64B,2,,89609185
10,48215723,21785,AGAP9,2,,48237508
1,209602167,3725,MIR205HG,2,,209605892
11,89819117,1182,UBTFL1,2,,89820299
21,46707966,9303,LOC642852,2,,46717269
21,31120493,15832,GRIK1-AS1,2,,31136325
4,185719450,750,SLED1,2,,185720200
5,175570087,56211,LOC643201,2,,175626298
9,140657473,1751,EHMT1-IT1,2,,140659224
5,145239295,13236,GRXCR2,2,,145252531
14,21387499,836,ECRP,2,,21388335
12,93397533,373979,LOC643339,2,,93771512
1,112533189,8274,LOC643355,2,,112541463
13,114598075,26215,LINC00452,2,,114624290
11,57510985,8268,BTBD18,2,,57519253
14,21567095,4788,TMEM253,2,,21571883
6,125995498,45866,LOC643623,2,,126041364
17,7384720,1663,SLC35G6,2,,7386383
19,39399619,3179,CCER2,2,,39402798
8,63890419,7041,UG0898H09,2,,63897460
21,31653626,1650,KRTAP24-1,2,,31655276
7,62751669,12765,ZNF733P,2,,62764434
19,36279777,9034,LINC01529,2,,36288811
10,48247661,4482,FAM25C,2,,48252143
12,55001970,2276,GLYCAM1,2,,55004246
1,120140324,1590,LINC00622,2,,120141914
3,99904667,8363,TMEM30C,2,,99913030
10,112696360,653,RPL13AP6,2,,112697013
X,134124967,1536,SMIM10,2,,134126503
1,143767143,738,PPIAL4G,2,,143767881
17,15668016,987,CDRT15P2,2,,15669003
4,68857529,5628,TMPRSS11GP,2,,68863157
15,40542865,2245,C15orf56,2,,40545110
15,40643233,5401,PHGR1,2,,40648634
14,41423915,71079,LOC644919,2,,41494994
1,27650364,2652,LOC644961,2,,27653016
3,129800673,16560,ALG1L2,2,,129817233
1,9712667,1977,PIK3CD-AS1,2,,9714644
1,61714616,4574,NFIA-AS1,2,,61719190
5,132083136,6959,CCNI2,2,,132090095
7,156803550,5568,MNX1-AS1,2,,156809118
18,5748817,47083,MIR3976HG,2,,5795900
2,91963367,6786,GGT8P,2,,91970153
18,5890183,1920,TMEM200C,2,,5892103
1,13736906,10897,PRAMEF20,2,,13747803
22,21821458,2766,TMEM191C,2,,21824224
14,65877310,2025,FUT8-AS1,2,,65879335
7,5160940,23237,ZNF890P,2,,5184177
2,89065418,40691,ANKRD36BP2,2,,89106109
16,1484388,10102,CCDC154,2,,1494490
X,16185603,3913,MAGEB17,2,,16189516
1,153409470,3033,S100A7L2,2,,153412503
10,30981202,24740,SVILP1,2,,31005942
6,149914751,969,RPS18P9,2,,149915720
X,72223351,2200,PABPC1L2B,2,,72225551
X,72345875,2044,NAP1L6,2,,72347919
5,179105558,2417,CBY3,2,,179107975
22,25041132,13982,POM121L10P,2,,25055114
15,20487996,8815,CHEK2P2,2,,20496811
14,62584074,16829,LINC00643,2,,62600903
2,216476285,231974,LINC00607,2,,216708259
13,25502892,39715,TPTE2P1,2,,25542607
3,48348335,21496,SPINK8,2,,48369831
3,48955220,1598,ARIH2OS,2,,48956818
19,14192443,4164,C19orf67,2,,14196607
1,248902716,435,LYPD8,2,,248903151
5,36871462,5334,NIPBL-AS1,2,,36876796
11,49075265,5399,TRIM64C,2,,49080664
7,29685537,39217,LOC646762,2,,29724754
15,78384926,11467,SH2D7,2,,78396393
1,121260909,52777,EMBP1,2,,121313686
13,51915167,21072,SERPINE3,2,,51936239
6,53199257,3158,RPS16P5,2,,53202415
3,193675160,46288,LOC647323,2,,193721448
20,34633539,5343,LINC00657,2,,34638882
1,104112025,1983,ACTG1P4,2,,104114008
6,5085719,1736,PPP1R3G,2,,5087455
18,3594111,3266,DLGAP1-AS1,2,,3597377
11,118873670,633,RPL23AP64,2,,118874303
5,10564434,93494,ANKRD33B,2,,10657928
15,23599894,13577,GOLGA8S,2,,23613471
16,67209504,8379,KIAA0895L,2,,67217883
17,45527592,42394,MRPL45P2,2,,45569986
6,168224569,2907,MLLT4-AS1,2,,168227476
11,193079,1421,SCGB1C2,2,,194500
1,13641972,7015,PRAMEF15,2,,13648987
17,58039723,56690,TBC1D3P1-DHX40P1,2,,58096413
16,22557018,31168,LOC653786,2,,22588186
17,75084724,6344,SNHG20,2,,75091068
9,34393,1471,FAM138C,2,,35864
14,95999691,275,SCARNA13,2,,95999966
18,47340392,421,SCARNA17,2,,47340813
1,155895748,129,SCARNA4,2,,155895877
9,19063653,131,SCARNA8,2,,19063784
3,108897011,7097,LINC00488,2,,108904108
12,67606,1473,FAM138D,2,,69079
17,74557714,74,SNORD1A,2,,74557788
17,74557189,86,SNORD1B,2,,74557275
12,6548166,12517,CD27-AS1,2,,6560683
14,21860309,103,SNORD9,2,,21860412
20,47897219,90,SNORD12,2,,47897309
2,203157773,84,SNORD11,2,,203157857
11,93466393,73,SNORD5,2,,93466466
11,93464668,71,SNORD6,2,,93464739
1,76252756,78,SNORD45C,2,,76252834
20,17943352,237,SNORD17,2,,17943589
17,16342822,48,SNORD49B,2,,16342870
12,57037463,75,SNORD59B,2,,57037538
19,48259109,110,SNORD23,2,,48259219
6,29550028,77,SNORD32B,2,,29550105
9,134365872,86,SNORD62B,2,,134365958
17,16344539,73,SNORD65,2,,16344612
3,184043483,76,SNORD66,2,,184043559
11,46783938,111,SNORD67,2,,46784049
2,203141153,88,SNORD70,2,,203141241
16,71792304,86,SNORD71,2,,71792390
20,2636742,86,SNORD86,2,,2636828
19,51302695,97,SNORD88A,2,,51302792
19,51302285,97,SNORD88B,2,,51302382
2,101889397,114,SNORD89,2,,101889511
9,125642491,107,SNORD90,2,,125642598
17,2233572,92,SNORD91A,2,,2233664
17,2232418,86,SNORD91B,2,,2232504
2,29136527,89,SNORD92,2,,29136616
7,22896231,74,SNORD93,2,,22896305
10,70514928,67,SNORD98,2,,70514995
1,28905254,80,SNORD99,2,,28905334
20,2634857,75,SNORD110,2,,2634932
16,70571907,94,SNORD111,2,,70572001
11,10823013,142,SNORD97,2,,10823155
15,76225023,448,FBXO22-AS1,2,,76225471
2,86362992,137,SNORD94,2,,86363129
X,109468216,72,SNORD96B,2,,109468288
17,62223437,80,SNORD104,2,,62223517
19,10218326,85,SNORD105,2,,10218411
1,31421964,88,SNORD103A,2,,31422052
1,31421964,88,SNORD103B,2,,31422052
15,81134318,96,MIR549A,2,,81134414
1,100746796,68,MIR553,2,,100746864
1,151518271,96,MIR554,2,,151518367
1,155316140,96,MIR555,2,,155316236
1,168344761,98,MIR557,2,,168344859
3,15915277,79,MIR563,2,,15915356
3,111831647,98,MIR567,2,,111831745
3,170824452,96,MIR569,2,,170824548
4,11370450,95,MIR572,2,,11370545
4,83674489,94,MIR575,2,,83674583
4,166307393,96,MIR578,2,,166307489
5,95414841,75,MIR583,2,,95414916
6,107231999,96,MIR587,2,,107232095
7,158325409,96,MIR595,2,,158325505
8,100548863,95,MIR599,2,,100548958
9,125873824,98,MIR600,2,,125873922
10,77312215,96,MIR606,2,,77312311
10,98588425,96,MIR607,2,,98588521
10,105978546,95,MIR609,2,,105978641
12,13068762,90,MIR614,2,,13068852
12,81226311,97,MIR617,2,,81226408
12,116586364,95,MIR620,2,,116586459
13,41384901,96,MIR621,2,,41384997
13,100008384,98,MIR623,2,,100008482
15,41983782,94,MIR626,2,,41983876
17,64783189,97,MIR634,2,,64783286
17,66420591,98,MIR635,2,,66420689
19,14640354,98,MIR639,2,,14640452
19,40788449,99,MIR641,2,,40788548
19,52785049,94,MIR643,2,,52785143
20,49202322,94,MIR645,2,,49202416
22,18463633,94,MIR648,2,,18463727
22,21388464,97,MIR649,2,,21388561
22,38240278,100,MIR658,2,,38240378
16,820182,95,MIR662,2,,820277
8,6886122,889,DEFA11P,2,,6887011
X,46746853,12286,LINC01545,2,,46759139
1,15494969,3151,C1orf195,2,,15498120
9,40700290,6247,SPATA31A3,2,,40706537
15,20737093,10021,GOLGA6L6,2,,20747114
17,1606083,7579,TLCD2,2,,1613662
15,86840064,20135,AGBL1-AS1,2,,86860199
15,22278031,93057,LOC727924,2,,22371088
3,72937384,87138,GXYLT2,2,,73024522
8,37604073,1491,LOC728024,2,,37605564
4,74374519,19731,LOC728040,2,,74394250
4,181985242,95060,LINC00290,2,,182080302
10,88985204,9529,NUTM2A,2,,88994733
Y,9365488,2797,TSPY3,2,,9368285
20,4173736,2864,LINC01433,2,,4176600
17,39346138,753,KRTAP9-1,2,,39346891
Y,9195451,2751,TSPY8,2,,9198202
1,37920479,19565,LINC01137,2,,37940044
2,98286205,33324,LINC01125,2,,98319529
5,1597671,36449,LOC728613,2,,1634120
1,43000559,119776,CCDC30,2,,43120335
10,47133294,542,HNRNPA1P33,2,,47133836
1,4000671,11972,LINC01346,2,,4012643
8,130228712,24774,LINC00977,2,,130253486
2,39664556,163928,LOC728730,2,,39828484
7,150102839,6719,LOC728743,2,,150109558
9,69381980,43129,ANKRD20A4,2,,69425109
15,44168023,2346,PIN4P1,2,,44170369
5,74907300,60371,ANKDD1B,2,,74967671
8,11946846,26179,ZNF705D,2,,11973025
10,75458908,31364,BMS1P4,2,,75490272
2,108439519,3064,RGPD4-AS1,2,,108442583
4,119551083,5097,LOC729218,2,,119556180
2,96676298,12586,FAHD2CP,2,,96688884
16,32264644,2605,TP53TG3D,2,,32267249
3,129816624,13652,FAM86HP,2,,129830276
X,49344551,7356,GAGE12E,2,,49351907
X,49344551,7356,GAGE12H,2,,49351907
2,17691985,7721,RAD51AP2,2,,17699706
5,178191861,53575,AACSP1,2,,178245436
7,101986191,10698,SPDYE6,2,,101996889
6,160514113,3131,LOC729603,2,,160517244
14,59971784,71765,CCDC175,2,,60043549
8,12030962,3814,FAM90A2P,2,,12034776
19,12154619,9163,ZNF878,2,,12163782
5,180794287,939,OR4F29,2,,180795226
5,28926976,444,LSP1P3,2,,28927420
19,52095035,2598,LINC01530,2,,52097633
6,52529198,4753,LOC730101,2,,52533951
9,35561826,2070,FAM166B,2,,35563896
6,52604260,5697,GSTA7P,2,,52609957
2,66650474,10128,MEIS1-AS3,2,,66660602
1,203267885,6568,LINC01136,2,,203274453
2,2323003,7877,MYT1L-AS1,2,,2330880
4,7099150,5953,FLJ36777,2,,7105103
14,75761106,2005,LINC01220,2,,75763111
8,142350647,4073,LINC01300,2,,142354720
7,135611502,50702,LUZP6,2,,135662204
14,101391157,70,SNORD113-1,2,,101391227
14,101393678,71,SNORD113-2,2,,101393749
14,101402827,74,SNORD113-4,2,,101402901
14,101404523,77,SNORD113-5,2,,101404600
14,101405892,74,SNORD113-6,2,,101405966
14,101407462,76,SNORD113-7,2,,101407538
14,101411985,71,SNORD113-9,2,,101412056
14,101416169,71,SNORD114-1,2,,101416240
14,101418192,77,SNORD114-2,2,,101418269
14,101420680,104,SNORD114-4,2,,101420784
14,101421706,69,SNORD114-5,2,,101421775
14,101423502,71,SNORD114-6,2,,101423573
14,101429390,76,SNORD114-7,2,,101429466
14,101431117,71,SNORD114-8,2,,101431188
14,101432365,71,SNORD114-9,2,,101432436
14,101433388,71,SNORD114-10,2,,101433459
14,101434447,74,SNORD114-11,2,,101434521
14,101435284,74,SNORD114-12,2,,101435358
14,101436215,73,SNORD114-13,2,,101436288
14,101438439,74,SNORD114-14,2,,101438513
14,101439006,71,SNORD114-15,2,,101439077
14,101439931,69,SNORD114-16,2,,101440000
14,101441142,74,SNORD114-17,2,,101441216
14,101442161,71,SNORD114-18,2,,101442232
14,101442813,74,SNORD114-19,2,,101442887
14,101447340,71,SNORD114-20,2,,101447411
14,101448311,71,SNORD114-21,2,,101448382
14,101449262,71,SNORD114-22,2,,101449333
14,101450212,71,SNORD114-23,2,,101450283
14,101451113,71,SNORD114-24,2,,101451184
14,101452393,71,SNORD114-25,2,,101452464
14,101453382,71,SNORD114-26,2,,101453453
14,101454497,69,SNORD114-27,2,,101454566
14,101455466,71,SNORD114-28,2,,101455537
14,101456427,69,SNORD114-29,2,,101456496
14,101458255,71,SNORD114-30,2,,101458326
1,144610814,1905,PFN1P2,2,,144612719
X,151561892,109,MIR767,2,,151562001
19,46522189,118,MIR769,2,,46522307
1,156905922,114,MIR765,2,,156906036
14,101318726,98,MIR770,2,,101318824
16,10860532,52119,TVP23A,2,,10912651
15,24409925,5128,PWRN2,2,,24415053
15,25458805,71,SNORD115-24,2,,25458876
15,25465649,76,SNORD115-27,2,,25465725
15,25467500,74,SNORD115-28,2,,25467574
15,25509673,53,SNORD115-45,2,,25509726
15,25513663,33,SNORD115-47,2,,25513696
19,57352269,7653,MIMT1,2,,57359922
Y,9555261,3644,TTTY21B,2,,9558905
Y,9590764,21164,TTTY1B,2,,9611928
Y,9573894,22191,TTTY2B,2,,9596085
Y,9528708,2600,TTTY8B,2,,9531308
Y,9544432,8439,TTTY7B,2,,9552871
Y,9748406,1165,TTTY23B,2,,9749571
7,72440212,3462,LOC100101148,2,,72443674
13,19836939,82174,ANKRD26P3,2,,19919113
20,2443597,96,SNORD119,2,,2443693
9,33952761,91,SNORD121A,2,,33952852
22,29729151,96,SNORD125,2,,29729247
19,10220424,92,SNORD105B,2,,10220516
14,45580077,99,SNORD127,2,,45580176
2,203156039,112,SNORD11B,2,,203156151
20,47896849,103,SNORD12B,2,,47896952
9,13927969,17637,LINC00583,2,,13945606
6,11538459,45298,TMEM170B,2,,11583757
15,102495087,1471,FAM138E,2,,102496558
9,95054742,133,SNORA84,2,,95054875
2,69747176,127,SNORA36C,2,,69747303
17,65736785,132,SNORA38B,2,,65736917
2,61644378,134,SNORA70B,2,,61644512
14,91592769,127,SNORA11B,2,,91592896
X,47248048,127,SNORA11C,2,,47248175
X,51933717,127,SNORA11D,2,,51933844
X,146990948,2387,FMR1-AS1,2,,146993335
14,101507699,82,MIR300,2,,101507781
X,145075792,77,MIR890,2,,145075869
X,145082570,79,MIR891B,2,,145082649
X,145078715,77,MIR892B,2,,145078792
8,100549013,76,MIR875,2,,100549089
9,28863623,81,MIR876,2,,28863704
15,45725247,80,MIR147B,2,,45725327
18,37202086,53,MIR924,2,,37202139
X,135633036,83,MIR934,2,,135633119
19,54485560,91,MIR935,2,,54485651
10,105807846,98,MIR936,2,,105807944
16,2321747,94,MIR940,2,,2321841
4,1988110,94,MIR943,2,,1988204
8,144895126,86,MIR937,2,,144895212
3,189547710,88,MIR944,2,,189547798
1,154166140,79,MIR190B,2,,154166219
2,176032360,77,MIR933,2,,176032437
11,19732479,3739,LOC100126784,2,,19736218
3,10322635,12498,GHRLOS,2,,10335133
10,97667721,30694,C10orf131,2,,97698415
8,91970705,26780,C8orf88,2,,91997485
1,32826870,974,FAM229A,2,,32827844
7,28220075,60921,JAZF1-AS1,2,,28280996
6,168376603,1016,HGC6.3,2,,168377619
12,98906750,3254,TMPO-AS1,2,,98910004
10,79686569,3014,DLG5-AS1,2,,79689583
8,144816309,12198,FAM83H-AS1,2,,144828507
9,95380331,2486,LOC100128361,2,,95382817
9,119266561,58011,ASTN2-AS1,2,,119324572
19,35563704,33471,HPN-AS1,2,,35597175
7,152161208,1422,LINC01003,2,,152162630
16,89778263,6310,VPS9D1-AS1,2,,89784573
22,49262581,31617,LINC01310,2,,49294198
19,51919159,1520,LOC100129083,2,,51920679
6,73933267,1908,KHDC1L,2,,73935175
9,32551141,1874,TOPORS-AS1,2,,32553015
9,16203932,49173,C9orf92,2,,16253105
15,50646370,4133,GABPB1-AS1,2,,50650503
17,16692056,1759,FAM106CP,2,,16693815
6,160181290,2074,LOC100129518,2,,160183364
8,67858735,16090,TCF24,2,,67874825
5,42756919,45620,CCDC152,2,,42802539
14,37641230,1768,SLC25A21-AS1,2,,37642998
11,10562782,58697,MRVI1-AS1,2,,10621479
15,52472222,25854,LOC100129973,2,,52498076
17,43973148,3016,MAPT-IT1,2,,43976164
12,132851976,5510,LOC100130238,2,,132857486
6,10412550,3852,TFAP2A-AS1,2,,10416402
X,24380877,2664,SUPT20HL1,2,,24383541
19,35136777,180,SCGB2B3P,2,,35136957
6,138144806,44564,LOC100130476,2,,138189370
10,44788197,1900,LOC100130539,2,,44790097
1,41154751,3182,NFYC-AS1,2,,41157933
17,41447212,19054,LINC00910,2,,41466266
2,178148235,109184,LOC100130691,2,,178257419
7,56943077,6762,LOC100130849,2,,56949839
17,73642645,1412,SMIM6,2,,73644057
11,67085309,73849,LOC100130987,2,,67159158
6,38874270,46613,LOC100131047,2,,38920883
5,80533383,64005,CKMT2-AS1,2,,80597388
17,76103482,4398,TNRC6C-AS1,2,,76107880
3,114070657,37168,ZBTB20-AS1,2,,114107825
7,151106246,3886,WDR86-AS1,2,,151110132
13,27825692,5007,RPL21P28,2,,27830699
20,10004459,195695,SNAP25-AS1,2,,10200154
1,198777131,129427,MIR181A1HG,2,,198906558
15,33010301,765,LOC100131315,2,,33011066
17,37213271,24433,LOC100131347,2,,37237704
3,194018988,11605,LINC00887,2,,194030593
18,74506687,27564,LOC100131655,2,,74534251
19,59070552,15612,MZF1-AS1,2,,59086164
8,7215497,4993,ZNF705G,2,,7220490
5,180750506,4690,LOC100132062,2,,180755196
9,68726540,21836,LOC100132352,2,,68748376
5,43065288,1785,LOC100132356,2,,43067073
17,39261640,1100,KRTAP4-9,2,,39262740
8,7783858,26077,ZNF705B,2,,7809935
9,141106636,27536,FAM157B,2,,141134172
12,96043030,24740,PGAM1P5,2,,96067770
Y,2620336,22701,XGY2,2,,2643037
7,154720226,20970,PAXIP1-AS2,2,,154741196
7,76668796,13559,PMS2P9,2,,76682355
10,47740303,4519,FAM25BP,2,,47744822
8,12219527,48983,FAM66A,2,,12268510
10,45594923,55121,RSU1P2,2,,45650044
7,27186781,8766,HOXA-AS3,2,,27195547
17,43325291,20706,MAP3K14-AS1,2,,43345997
7,102277471,5767,UPK3BL,2,,102283238
20,61669362,15853,LINC01056,2,,61685215
4,66535678,23426,EPHA5-AS1,2,,66559104
2,63344985,1692,DBIL5P2,2,,63346677
3,190595718,121,SNAR-I,2,,190595839
17,36827958,3229,C17orf96,2,,36831187
5,157098560,8602,C5orf52,2,,157107162
16,21443344,2432,LOC100190986,2,,21445776
8,77523113,72397,ZFHX4-AS1,2,,77595510
10,4692376,27886,LINC00704,2,,4720262
7,104650988,3600,KMT2E-AS1,2,,104654588
7,104622193,9419,LINC01004,2,,104631612
12,47602202,8024,PCED1B-AS1,2,,47610226
7,56549797,1215,LOC100240728,2,,56551012
20,18774692,2017,LOC100270804,2,,18776709
2,39146503,56087,ARHGEF33,2,,39202590
16,21458003,55599,SMG1P3,2,,21513602
7,29724387,1050,ZNRF2P2,2,,29725437
9,133452736,2145,LOC100272217,2,,133454881
1,11873,2536,DDX11L1,2,,14409
2,109743783,2792,SH3RF3-AS1,2,,109746575
18,48918411,170428,LOC100287225,2,,49088839
19,22469251,30727,ZNF729,2,,22499978
3,156390959,2543,TIPARP-AS1,2,,156393502
12,30948614,7031,LINC00941,2,,30955645
3,46761072,16849,PRSS46,2,,46777921
3,95373266,28771,MTHFD2P1,2,,95402037
7,62809447,2705,LOC100287704,2,,62812152
1,114399256,44603,AP4B1-AS1,2,,114443859
X,134254548,2981,LOC100287728,2,,134257529
X,102024094,116244,LINC00630,2,,102140338
18,13419497,8036,LDLRAD4-AS1,2,,13427533
3,8262833,280511,LMCD1-AS1,2,,8543344
15,102516760,2536,DDX11L9,2,,102519296
8,86839093,1078,REXO1L2P,2,,86840171
15,30938317,126892,LOC100288637,2,,31065209
20,2796947,1759,TMEM239,2,,2798706
9,123555774,5235,LOC100288842,2,,123561009
2,36581891,822,LOC100288911,2,,36582713
Y,9365488,2797,TSPY10,2,,9368285
Y,9316661,5602,FAM197Y5,2,,9322263
5,98264837,1876,LOC100289230,2,,98266713
17,10698229,9187,LINC00675,2,,10707416
13,113621797,1155,MCF2L-AS1,2,,113622952
8,7272384,1970,DEFB4B,2,,7274354
6,166756118,8839,LOC100289495,2,,166764957
7,102004307,16773,LOC100289561,2,,102021080
12,1609656,3934,LINC00942,2,,1613590
6,32861952,9583,LOC100294145,2,,32871535
X,154115634,99,MIR1184-1,2,,154115733
3,71591120,120,MIR1284,2,,71591240
7,36958961,76,MIR1200,2,,36959037
X,146271221,84,MIR513C,2,,146271305
10,14478574,86,MIR1265,2,,14478660
22,20236656,78,MIR1286,2,,20236734
16,69599710,61,MIR1538,2,,69599771
15,86313726,83,MIR1276,2,,86313809
7,21510675,89,MIR1183,2,,21510764
20,34041775,144,MIR1289-1,2,,34041919
2,232756951,57,MIR1471,2,,232757008
19,15560358,61,MIR1470,2,,15560419
2,114340535,138,MIR1302-3,2,,114340673
2,208133998,150,MIR1302-4,2,,208134148
18,27878875,51,MIR302F,2,,27878926
1,231155573,97,MIR1182,2,,231155670
5,132763287,111,MIR1289-2,2,,132763398
20,2633422,66,MIR1292,2,,2633488
7,18166842,90,MIR1302-6,2,,18166932
6,166922841,80,MIR1913,2,,166922921
20,49231172,150,MIR1302-5,2,,49231322
8,142867602,72,MIR1302-7,2,,142867674
3,163889258,86,MIR1263,2,,163889344
22,45596834,66,MIR1249,2,,45596900
2,179246804,294205,MIR548N,2,,179541009
5,179225277,69,MIR1229,2,,179225346
1,218610974,670478,MIR548F3,2,,219281452
8,128972878,63,MIR1205,2,,128972941
1,193105632,81,MIR1278,2,,193105713
8,101036209,103,MIR1273A,2,,101036312
9,69002238,83,MIR1299,2,,69002321
X,140008336,48,MIR320D2,2,,140008384
X,85090784,79,MIR1321,2,,85090863
4,67142541,105,MIR1269A,2,,67142646
1,171070868,79,MIR1295A,2,,171070947
19,20510080,83,MIR1270,2,,20510163
5,153726665,142,MIR1294,2,,153726807
20,30825597,53,MIR1825,2,,30825650
15,65054585,129,MIR1272,2,,65054714
8,7946462,149,MIR548I3,2,,7946611
4,114028018,93,MIR1243,2,,114028111
1,26881032,52,MIR1976,2,,26881084
X,83480759,77,MIR548I4,2,,83480836
4,102251458,113,MIR1255A,2,,102251571
18,21901649,50,MIR320C2,2,,21901699
22,20073580,85,MIR1306,2,,20073665
3,125509246,149,MIR548I1,2,,125509395
19,54261485,87,MIR1283-2,2,,54261572
17,2651371,105,MIR1253,2,,2651476
17,46233788,85,MIR1203,2,,46233873
3,75679913,96,MIR1324,2,,75680009
X,117520356,78,MIR1277,2,,117520434
12,50627924,71,MIR1293,2,,50627995
X,113997743,80,MIR1911,2,,113997823
9,100125835,128,MIR1302-8,2,,100125963
10,115933863,75,MIR2110,2,,115933938
8,113655721,91,MIR2053,2,,113655812
19,10662797,83,MIR1238,2,,10662880
12,113132838,143,MIR1302-1,2,,113132981
9,131114325,310090,MIR1268A,2,,131424415
22,41488516,54,MIR1281,2,,41488570
5,167987908,62,MIR103B1,2,,167987970
X,32659590,86,MIR548F5,2,,32659676
11,93466839,91,MIR1304,2,,93466930
14,101491900,88,MIR1197,2,,101491988
15,44085856,101,MIR1282,2,,44085957
18,47013742,50,MIR1539,2,,47013792
15,96876489,47,MIR1469,2,,96876536
8,75617927,55,MIR2052,2,,75617982
12,120151438,91,MIR1178,2,,120151529
11,94199660,86,MIR548L,2,,94199746
4,9557788,149,MIR548I2,2,,9557937
19,71972,138,MIR1302-2,2,,72110
1,68649200,93,MIR1262,2,,68649293
11,64136073,102,MIR1237,2,,64136175
20,3898148,62,MIR103B2,2,,3898210
19,2234060,88,MIR1227,2,,2234148
12,9392065,82,MIR1244-1,2,,9392147
13,108183518,78,MIR1267,2,,108183596
9,78118511,220233,MIR548H3,2,,78338744
5,100152185,84,MIR548P,2,,100152269
4,117220880,44,MIR1973,2,,117220924
3,106828636,130849,LINC00882,2,,106959485
20,5100231,384,PCNA-AS1,2,,5100615
10,90751180,1552,FAS-AS1,2,,90752732
14,57279900,117650,OTX2-AS1,2,,57397550
11,70130060,116,MIR548K,2,,70130176
2,213290986,98,MIR548F2,2,,213291084
3,151347319,195075,MIR548H2,2,,151542394
11,7255996,72,MIR302E,2,,7256068
17,41522173,80,MIR2117,2,,41522253
9,97572243,96,MIR2278,2,,97572339
4,36427987,63,MIR1255B1,2,,36428050
X,146280561,84,MIR513B,2,,146280645
2,133014538,115,MIR663B,2,,133014653
7,102046188,114,MIR548O,2,,102046302
14,64561741,102,MIR548H1,2,,64561843
1,167967897,67,MIR1255B2,2,,167967964
10,12767252,100,MIR548Q,2,,12767352
3,48616334,76,MIR711,2,,48616410
15,69116302,373560,MIR548H4,2,,69489862
15,59463381,80,MIR2116,2,,59463461
7,147075108,105,MIR548F4,2,,147075213
3,99273152,443907,MIR548G,2,,99717059
2,165544152,135,SNORA70F,2,,165544287
4,70999320,13101,CSN1S2BP,2,,71012421
19,44609491,7845,LOC100379224,2,,44617336
2,242483800,14758,BOK-AS1,2,,242498558
1,11900375,7298,NPPA-AS1,2,,11907673
21,30968359,34708,GRIK1-AS2,2,,31003067
11,81601782,96,MIR4300,2,,81601878
4,7461754,91,MIR4274,2,,7461845
8,27743555,78,MIR4287,2,,27743633
9,30143,138,MIR1302-9,2,,30281
19,47730200,76,MIR3191,2,,47730276
19,18392886,85,MIR3188,2,,18392971
9,30143,138,MIR1302-10,2,,30281
16,16403731,94,MIR3180-3,2,,16403825
14,101496388,78,MIR1193,2,,101496466
1,170120518,85,MIR3119-1,2,,170120603
18,6374359,65,MIR4317,2,,6374424
15,90549986,87,MIR3174,2,,90550073
10,14425198,78,MIR4293,2,,14425276
11,68850643,83,MIR3164,2,,68850726
7,63081467,80,MIR4283-2,2,,63081547
8,17539086,80,MIR548V,2,,17539166
17,75393065,71,MIR4316,2,,75393136
16,83541950,63,MIR3182,2,,83542013
1,241295571,75,MIR3123,2,,241295646
18,35237097,81,MIR4318,2,,35237178
9,139725408,67,MIR4292,2,,139725475
13,100295312,91,MIR4306,2,,100295403
2,11907569,82,MIR548S,2,,11907651
2,109757945,99,MIR4265,2,,109758044
3,124451285,78,MIR544B,2,,124451363
18,47652868,65,MIR4320,2,,47652933
10,132760850,81,MIR378C,2,,132760931
3,15537745,70,MIR4270,2,,15537815
12,9392065,82,MIR1244-3,2,,9392147
10,131641562,76,MIR4297,2,,131641638
5,31936207,58,MIR4279,2,,31936265
X,153246548,79,MIR3202-2,2,,153246627
13,41675154,82,MIR3168,2,,41675236
20,55896557,90,MIR4325,2,,55896647
6,57254929,81,MIR548U,2,,57255010
12,9392065,82,MIR1244-2,2,,9392147
5,86410695,76,MIR4280,2,,86410771
2,79876419,66,MIR4264,2,,79876485
21,31747611,85,MIR4327,2,,31747696
1,209796788,67,MIR4260,2,,209796855
10,50193556,76,MIR4294,2,,50193632
12,26026952,60,MIR4302,2,,26027012
1,37627163,72,MIR4255,2,,37627235
3,20179056,77,MIR3135A,2,,20179133
1,62544457,74,MIR3116-1,2,,62544531
8,28362632,67,MIR4288,2,,28362699
20,30194988,55,MIR3193,2,,30195043
15,66332570,100,MIR4311,2,,66332670
10,114393928,85,MIR4295,2,,114394013
1,23189651,68,MIR4253,2,,23189719
7,63081467,80,MIR4283-1,2,,63081547
15,102500661,138,MIR1302-11,2,,102500799
21,20058407,75,MIR548X,2,,20058482
16,26036557,74,MIR548W,2,,26036631
12,98389160,66,MIR4303,2,,98389226
19,10341088,73,MIR4322,2,,10341161
3,194855234,75,MIR3137,2,,194855309
9,96581638,65,MIR4291,2,,96581703
X,150336693,105,MIR4330,2,,150336798
X,78156690,56,MIR4328,2,,78156746
3,10371912,57,MIR378B,2,,10371969
15,21038123,75,MIR3118-4,2,,21038198
9,91927139,82,MIR3153,2,,91927221
4,28821203,87,MIR4275,2,,28821290
5,159901408,82,MIR3142,2,,159901490
7,57472730,66,MIR3147,2,,57472796
13,40238170,102,MIR4305,2,,40238272
3,67275887,64,MIR4272,2,,67275951
2,242417319,78,MIR3133,2,,242417397
20,61918159,59,MIR4326,2,,61918218
1,212250954,73,MIR3122,2,,212251027
7,73125646,81,MIR4284,2,,73125727
5,153975571,61,MIR3141,2,,153975632
3,49311552,67,MIR4271,2,,49311619
14,103005980,83,MIR4309,2,,103006063
3,75787430,84,MIR4273,2,,75787514
2,220771222,64,MIR4268,2,,220771286
17,43552728,73,MIR4315-2,2,,43552801
5,176056439,62,MIR4281,2,,176056501
9,92785722,95,MIR4290,2,,92785817
2,28219233,83,MIR4263,2,,28219316
5,1708899,84,MIR4277,2,,1708983
1,3044538,61,MIR4251,2,,3044599
17,35391041,69,MIR2909,2,,35391110
15,69094188,76,MIR4312,2,,69094264
13,61773931,83,MIR3169,2,,61774014
16,2581922,84,MIR3178,2,,2582006
1,6489893,63,MIR4252,2,,6489956
1,113004391,64,MIR4256,2,,113004455
X,154115634,99,MIR1184-3,2,,154115733
17,46801769,68,MIR3185,2,,46801837
19,49812053,72,MIR4324,2,,49812125
19,42637596,69,MIR4323,2,,42637665
8,10524487,93,MIR4286,2,,10524580
17,7991373,92,MIR4314,2,,7991465
14,55344830,81,MIR4308,2,,55344911
X,154687177,99,MIR1184-2,2,,154687276
2,12877492,78,MIR3125,2,,12877570
X,153246547,81,MIR3202-1,2,,153246628
10,6194158,82,MIR3155A,2,,6194240
2,110827537,82,MIR4267,2,,110827619
2,11977058,54,MIR4262,2,,11977112
1,150524404,86,MIR4257,2,,150524490
22,28316513,86,MIR3199-2,2,,28316599
5,6827965,69,MIR4278,2,,6828034
11,48118333,77,MIR3161,2,,48118410
17,28444103,75,MIR3184,2,,28444178
17,62818147,73,MIR4315-1,2,,62818220
6,73677409,67,MIR4282,2,,73677476
X,112023945,71,MIR4329,2,,112024016
1,170120518,85,MIR3119-2,2,,170120603
15,42158692,57,MIR4310,2,,42158749
20,61870130,64,MIR3196,2,,61870194
9,91360750,70,MIR4289,2,,91360820
4,144264612,76,MIR3139,2,,144264688
14,27377847,84,MIR4307,2,,27377931
11,1880693,73,MIR4298,2,,1880766
21,42539483,73,MIR3197,2,,42539556
11,11678197,72,MIR4299,2,,11678269
2,109930026,55,MIR4266,2,,109930081
1,32224260,76,MIR4254,2,,32224336
6,152469761,76506,MIR3163,2,,152546267
19,2250637,80,MIR4321,2,,2250717
22,28316512,88,MIR3199-1,2,,28316600
15,76054555,101,MIR4313,2,,76054656
2,220413794,75,MIR3132,2,,220413869
10,126721351,88,MIR4296,2,,126721439
4,175344945,70,MIR4276,2,,175345015
2,240227156,84,MIR4269,2,,240227240
12,10034087,14345,KLRF2,2,,10048432
13,33070350,2279,MINOS1P1,2,,33072629
2,14368997,172085,LINC00276,2,,14541082
8,104169217,15151,BAALC-AS1,2,,104184368
10,22724353,2505,LOC100499489,2,,22726858
12,95703698,62,MIR3685,2,,95703760
3,159000434,89,MIR3919,2,,159000523
7,132719619,56,MIR3654,2,,132719675
5,85916313,79,MIR3607,2,,85916392
X,73438383,70,MIR374C,2,,73438453
1,26232852,93,MIR3917,2,,26232945
X,20035205,100,MIR23C,2,,20035305
1,228284963,79,MIR3620,2,,228285042
9,140063637,85,MIR3621,2,,140063722
20,43036759,84,MIR3646,2,,43036843
20,45795608,92,MIR3616,2,,45795700
21,9826202,61,MIR3687-1,2,,9826263
12,1769480,66,MIR3649,2,,1769546
12,128778636,87,MIR3612,2,,128778723
4,185772166,98,MIR3945,2,,185772264
7,98479272,80,MIR3609,2,,98479352
5,140027428,83,MIR3655,2,,140027511
9,94398532,111,MIR3910-1,2,,94398643
X,39520469,106,MIR3937,2,,39520575
11,101390550,86,MIR3920,2,,101390636
5,38557603,60,MIR3650,2,,38557663
7,43190493,100,MIR3943,2,,43190593
7,32772592,97,MIR550B2,2,,32772689
1,165877157,56,MIR3658,2,,165877213
22,29729146,110,MIR3653,2,,29729256
10,59064238,81,MIR3924,2,,59064319
7,151130574,151,MIR3907,2,,151130725
2,189860355,63,MIR3606,2,,189860418
8,130496302,86,MIR3686,2,,130496388
11,118889653,69,MIR3656,2,,118889722
17,73402149,94,MIR3678,2,,73402243
12,104324202,131,MIR3652,2,,104324333
19,46178189,77,MIR642B,2,,46178266
17,72744751,87,MIR3615,2,,72744838
1,247365268,94,MIR3916,2,,247365362
6,159185692,93,MIR3918,2,,159185785
16,15248706,153,MIR3180-4,2,,15248859
1,65523437,88,MIR3671,2,,65523525
15,76878987,45,MIR3713,2,,76879032
12,65016288,97,MIR548Z,2,,65016385
3,99683157,85,MIR3921,2,,99683242
22,20073268,88,MIR3618,2,,20073356
21,9825831,180,MIR3648-1,2,,9826011
1,100154610,23903,MIR548AA1,2,,100178513
18,33514050,55,MIR3929,2,,33514105
10,124176480,103,MIR3941,2,,124176583
4,99918537,74,MIR3684,2,,99918611
12,69978502,100,MIR3913-2,2,,69978602
X,120504825,82,MIR3672,2,,120504907
8,12584740,73,MIR3926-1,2,,12584813
8,27559189,95,MIR3622B,2,,27559284
3,55886519,103,MIR3938,2,,55886622
1,17007749,74,MIR3675,2,,17007823
3,79557036,83,MIR3923,2,,79557119
6,140526388,75,MIR3668,2,,140526463
6,135300475,95,MIR3662,2,,135300570
22,49937040,74,MIR3667,2,,49937114
7,30329409,97,MIR550B1,2,,30329506
2,12339255,72,MIR3681,2,,12339327
7,7106594,82,MIR3683,2,,7106676
12,112475402,117,MIR3657,2,,112475519
10,35368525,83,MIR3611,2,,35368608
16,56279431,104,MIR3935,2,,56279535
Y,1362810,75,MIR3690,2,,1362885
17,65467604,97,MIR548AA2,2,,65467701
6,157950163,69,MIR3692,2,,157950232
9,94398548,79,MIR3910-2,2,,94398627
9,137741970,148,MIR3689B,2,,137742118
13,50570550,87,MIR3613,2,,50570637
12,124020955,126,MIR3908,2,,124021081
16,18499554,65,MIR3670-1,2,,18499619
8,1749290,68,MIR3674,2,,1749358
3,16974687,65,MIR3714,2,,16974752
8,117886966,73,MIR3610,2,,117887039
X,32601772,97,MIR3915,2,,32601869
16,2185977,153,MIR3180-5,2,,2186130
16,29610499,87,MIR3680-1,2,,29610586
14,48230197,110,MIR548Y,2,,48230307
19,41960074,46485,PCAT19,2,,42006559
8,61314729,11648,LINC01301,2,,61326377
13,79980443,18025,RBM26-AS1,2,,79998468
10,98862512,992,SLIT1-AS1,2,,98863504
17,37081420,4217,LINC00672,2,,37085637
10,34048640,12968,LINC00838,2,,34061608
1,159931013,17863,LINC01133,2,,159948876
5,139482506,5091,LINC01024,2,,139487597
1,155017667,5974,LOC100505666,2,,155023641
3,183165438,8362,LINC00888,2,,183173800
8,69824037,192388,LOC100505718,2,,70016425
17,39431949,510,KRTAP9-7,2,,39432459
5,8457799,5410,MIR4458HG,2,,8463209
21,46340949,8646,ITGB2-AS1,2,,46349595
18,69187199,58993,LINC01541,2,,69246192
1,164738352,5526,LOC100505795,2,,164743878
19,29493461,11401,LINC01532,2,,29504862
10,105506536,8631,SH3PXD2A-AS1,2,,105515167
16,66442426,2377,LINC00920,2,,66444803
10,106111058,2275,CCDC147-AS1,2,,106113333
10,106424365,1609,SORCS3-AS1,2,,106425974
10,111705316,62823,ADD3-AS1,2,,111768139
4,165675282,49665,LINC01207,2,,165724947
14,31345384,13630,LOC100506071,2,,31359014
4,170838911,58142,LOC100506085,2,,170897053
2,166790366,14465,TTC21B-AS1,2,,166804831
16,73420703,34592,LINC01568,2,,73455295
7,22602955,10662,LOC100506178,2,,22613617
22,34120971,25832,LARGE-AS1,2,,34146803
21,34100424,15009,PAXBP1-AS1,2,,34115433
4,185814153,6462,LINC01093,2,,185820615
2,8819938,2053,ID2-AS1,2,,8821991
7,27135712,4165,HOTAIRM1,2,,27139877
12,13132770,4806,LOC100506314,2,,13137576
17,45975751,43019,SP2-AS1,2,,46018770
2,102599926,2081,LINC01127,2,,102602007
14,46940561,30543,LINC00871,2,,46971104
7,111448560,13275,DOCK4-AS1,2,,111461835
2,105421882,46052,LINC01158,2,,105467934
22,39828164,4969,LOC100506472,2,,39833133
5,38400552,3021,EGFLAM-AS2,2,,38403573
9,138354564,9531,PPP1R26-AS1,2,,138364095
14,77248075,4992,LOC100506603,2,,77253067
12,29433348,37433,LOC100506606,2,,29470781
13,22784423,66236,LINC00540,2,,22850659
3,48885369,4046,PRKAR2A-AS1,2,,48889415
12,120928140,5609,DYNLL1-AS1,2,,120933749
5,44744429,64466,LOC100506674,2,,44808895
13,23993109,9899,SACS-AS1,2,,24003008
1,202780073,968,PCAT6,2,,202781041
9,37079892,10506,EBLN3,2,,37090398
7,35756046,3276,LOC100506725,2,,35759322
10,50329883,29709,FAM170B-AS1,2,,50359592
1,202955579,20814,LOC100506747,2,,202976393
X,133684053,10375,LINC00629,2,,133694428
13,42016699,1203,OR7E37P,2,,42017902
17,56402810,28278,BZRAP1-AS1,2,,56431088
12,58325231,4716,LOC100506844,2,,58329947
15,85114364,9048,LINC00933,2,,85123412
17,10619259,640,MAGOH2,2,,10619899
19,36810617,12003,LINC00665,2,,36822620
8,12294521,114037,LOC100506990,2,,12408558
19,49929687,2388,GFY,2,,49932075
10,60759277,2100,LINC00844,2,,60761377
11,74951949,2800,TPBGL,2,,74954749
10,4426437,26367,LINC00703,2,,4452804
13,31456971,49774,TEX26-AS1,2,,31506745
2,66801161,121559,LOC100507073,2,,66922720
15,91509598,22256,PRC1-AS1,2,,91531854
12,67913861,47050,LOC100507175,2,,67960911
15,93426072,15905,LINC01578,2,,93441977
13,42535304,20397,VWA8-AS1,2,,42555701
11,124670323,34060,LOC100507283,2,,124704383
9,72830974,42816,SMC5-AS1,2,,72873790
10,17256237,12660,VIM-AS1,2,,17268897
12,74526955,159456,LOC100507377,2,,74686411
11,45743857,2249,LOC100507384,2,,45746106
5,175546551,5617,LOC100507387,2,,175552168
3,142645516,15862,LOC100507389,2,,142661378
20,300330,5566,NRSN2-AS1,2,,305896
6,139046347,48469,LOC100507462,2,,139094816
6,32811862,2415,PSMB8-AS1,2,,32814277
15,35838395,312807,DPH6-AS1,2,,36151202
15,101847455,2054,LOC100507472,2,,101849509
19,32083186,1270,THEG5,2,,32084456
6,32120578,1564,LOC100507547,2,,32122142
6,33857287,7397,LINC01016,2,,33864684
16,28763755,20389,NPIPB9,2,,28784144
17,39421629,483,KRTAP9-6,2,,39422112
8,57430877,41505,LINC00968,2,,57472382
14,23707126,36368,RNF212B,2,,23743494
2,160625138,136129,LY75-CD302,2,,160761267
6,163834096,886,CAHM,2,,163834982
16,29466411,9890,SLX1B-SULT1A4,2,,29476301
1,39328161,19137,GJA9-MYCBP,2,,39347298
11,57479994,106658,TMX2-CTNND1,2,,57586652
11,18252901,17320,SAA2-SAA4,2,,18270221
11,64781584,26460,ARL2-SNX15,2,,64808044
11,111783459,14136,HSPB2-C11orf52,2,,111797595
17,73975297,26783,TEN1-CDK3,2,,74002080
17,33336130,112411,RAD51L3-RFFL,2,,33448541
17,7293046,14404,TMEM256-PLSCR3,2,,7307450
19,12242167,25379,ZNF625-ZNF20,2,,12267546
1,247108848,133267,ZNF670-ZNF695,2,,247242115
2,238875586,132468,UBE2F-SCLY,2,,239008054
4,110351118,3855,SEC24B-AS1,2,,110354973
10,124591670,47487,FAM24B-CUZD1,2,,124639157
15,55647420,143362,DYX1C1-CCPG1,2,,55790782
7,5085451,27403,RBAK-RBAKDN,2,,5112854
20,57603732,14169,SLMO2-ATP5E,2,,57617901
7,27202056,17824,HOXA10-HOXA9,2,,27219880
3,128806411,73662,ISY1-RAB43,2,,128880073
3,196042955,22336,TM4SF19-TCTEX1D2,2,,196065291
6,91022460,92,MIR4464,2,,91022552
13,102619991,105,MIR2681,2,,102620096
4,185859536,58,MIR4455,2,,185859594
3,48681626,87,MIR4793,2,,48681713
10,112657847,66,MIR4680,2,,112657913
9,114694379,70,MIR4668,2,,114694449
7,2566707,72,MIR4648,2,,2566779
7,100802753,83,MIR4653,2,,100802836
11,19596856,63,MIR4486,2,,19596919
11,133768398,78,MIR4697,2,,133768476
1,19209695,74,MIR4695,2,,19209769
17,27717679,69,MIR4523,2,,27717748
2,111042429,91,MIR4436B1,2,,111042520
6,44221942,80,MIR4647,2,,44222022
17,15154943,70,MIR4731,2,,15155013
11,2194292,76,MIR4686,2,,2194368
10,90823092,75,MIR4679-1,2,,90823167
3,109321674,70,MIR4445,2,,109321744
9,137741454,74,MIR3689D1,2,,137741528
17,37882747,67,MIR4728,2,,37882814
20,33578202,73,MIR499B,2,,33578275
14,106324292,52,MIR4507,2,,106324344
2,33643582,49,MIR4430,2,,33643631
13,97079482,64,MIR4501,2,,97079546
18,20513311,90,MIR4741,2,,20513401
14,94414571,77,MIR4506,2,,94414648
1,237634418,73,MIR4428,2,,237634491
5,8461037,75,MIR4458,2,,8461112
22,46509445,92,MIR4763,2,,46509537
1,53405985,100,MIR1273G,2,,53406085
22,38384800,60,MIR4534,2,,38384860
X,47446827,77,MIR4769,2,,47446904
21,41584278,80,MIR4760,2,,41584358
15,66789295,77,MIR4512,2,,66789372
16,81418622,76,MIR4720,2,,81418698
10,12620751,71,MIR4480,2,,12620822
5,72174417,73,MIR4804,2,,72174490
17,36875943,58,MIR4726,2,,36876001
6,157100811,54,MIR4466,2,,157100865
1,53394345,99,MIR1273F,2,,53394444
2,103048748,78,MIR4772,2,,103048826
14,74225449,73,MIR4505,2,,74225522
2,86420148,83,MIR4779,2,,86420231
7,1883815,74,MIR4655,2,,1883889
3,87275338,89,MIR4795,2,,87275427
10,115537751,62,MIR4483,2,,115537813
19,39900262,56,MIR4530,2,,39900318
1,31212002,77,MIR4420,2,,31212079
2,112528637,74,MIR4771-2,2,,112528711
3,114462291,81,MIR4796,2,,114462372
16,88782685,60,MIR4722,2,,88782745
19,58898136,89,MIR4754,2,,58898225
17,77680984,74,MIR4739,2,,77681058
19,54785963,72,MIR4752,2,,54786035
16,76902832,84,MIR4719,2,,76902916
6,92231377,78,MIR4643,2,,92231455
5,128433380,79,MIR4633,2,,128433459
14,65801835,66,MIR4708,2,,65801901
1,23384350,77,MIR4419A,2,,23384427
6,41566460,66,MIR4641,2,,41566526
12,120593237,66,MIR4498,2,,120593303
6,141004950,70,MIR4465,2,,141005020
15,81289757,57,MIR4514,2,,81289814
13,88270919,76,MIR4500,2,,88270995
15,75081012,86,MIR4513,2,,75081098
9,68415307,81,MIR4477A,2,,68415388
19,54290930,66,MIR371B,2,,54290996
11,90288941,84,MIR4490,2,,90289025
2,128181112,82,MIR4783,2,,128181194
1,17604383,87,MIR3972,2,,17604470
1,51525508,69,MIR4421,2,,51525577
20,37145205,70,MIR548O2,2,,37145275
6,132436331,72,MIR548AJ1,2,,132436403
10,90823091,77,MIR4679-2,2,,90823168
4,153457579,89,MIR4453,2,,153457668
9,68415307,81,MIR4477B,2,,68415388
16,12814177,51,MIR4718,2,,12814228
17,80626108,75,MIR4525,2,,80626183
4,5925001,54,MIR378D1,2,,5925055
5,174178736,54,MIR4634,2,,174178790
17,36858514,70,MIR4734,2,,36858584
17,57443443,72,MIR4729,2,,57443515
13,66792381,75,MIR4704,2,,66792456
2,225875177,80,MIR4439,2,,225875257
5,134263728,74,MIR4461,2,,134263802
17,58120385,81,MIR4737,2,,58120466
14,74946835,72,MIR4709,2,,74946907
9,137742587,66,MIR3689F,2,,137742653
2,182170319,60,MIR4437,2,,182170379
11,74110281,97,MIR548AL,2,,74110378
3,197020748,71,MIR4797,2,,197020819
10,23682333,63,MIR1254-2,2,,23682396
6,32717688,68,MIR3135B,2,,32717756
2,32860321,77,MIR4765,2,,32860398
17,56413336,47,MIR4736,2,,56413383
11,47422520,73,MIR4487,2,,47422593
15,28671636,94,MIR4509-1,2,,28671730
1,235353348,83,MIR4753,2,,235353431
20,52684946,78,MIR4756,2,,52685024
7,137808503,64,MIR4468,2,,137808567
13,115039302,81,MIR4502,2,,115039383
15,22675147,94,MIR4509-2,2,,22675241
9,20411145,91,MIR4473,2,,20411236
6,31668805,63,MIR4646,2,,31668868
16,30886586,58,MIR4519,2,,30886644
5,53371347,66,MIR4459,2,,53371413
X,109113629,52,MIR4454,2,,109113681
5,1309424,68,MIR4457,2,,1309492
9,137271256,62,MIR4669,2,,137271318
6,30858659,90,MIR4640,2,,30858749
15,89155077,78,MIR3529,2,,89155155
13,102698283,71,MIR4705,2,,102698354
12,109029585,61,MIR4496,2,,109029646
16,2324620,72,MIR4717,2,,2324692
9,139414019,59,MIR4673,2,,139414078
21,28326279,83,MIR4759,2,,28326362
18,5840693,139,MIR3976,2,,5840832
8,92217712,74,MIR4661,2,,92217786
4,148703745,74,MIR4799,2,,148703819
17,29861900,89,MIR4724,2,,29861989
X,17444003,74,MIR4768,2,,17444077
9,130548111,91,MIR3960,2,,130548202
X,37883147,92,MIR548AJ2,2,,37883239
22,46156403,75,MIR4762,2,,46156478
8,125834219,81,MIR4662B,2,,125834300
16,28855239,89,MIR4721,2,,28855328
18,33171700,70,MIR3975,2,,33171770
22,42319225,76,MIR378I,2,,42319301
8,124228027,76,MIR4663,2,,124228103
14,50766572,92,MIR4504,2,,50766664
12,49165757,63,MIR4701,2,,49165820
11,10529816,57,MIR4485,2,,10529873
18,44906866,70,MIR4527,2,,44906936
17,29421367,76,MIR4733,2,,29421443
2,213790980,80,MIR4776-1,2,,213791060
8,143257699,80,MIR4472-1,2,,143257779
6,16141786,69,MIR4639,2,,16141855
7,75544514,73,MIR4651,2,,75544587
17,27188388,68,MIR451B,2,,27188456
15,23807208,70,MIR4508,2,,23807278
17,25620935,87,MIR4522,2,,25621022
9,36864250,55,MIR4540,2,,36864305
12,17826232,96,MIR3974,2,,17826328
14,37421513,83,MIR4503,2,,37421596
3,134156668,80,MIR4788,2,,134156748
17,73780601,87,MIR4738,2,,73780688
22,41209886,76,MIR4766,2,,41209962
6,2854264,77,MIR4645,2,,2854341
10,74480786,72,MIR4676,2,,74480858
12,98332833,66,MIR4495,2,,98332899
9,6007825,79,MIR4665,2,,6007904
9,36823535,61,MIR4475,2,,36823596
3,19356339,84,MIR4791,2,,19356423
11,65403780,60,MIR4690,2,,65403840
15,36219056,68,MIR4510,2,,36219124
17,79374515,63,MIR4740,2,,79374578
22,33832567,88,MIR4764,2,,33832655
10,89263637,74,MIR4678,2,,89263711
5,82135973,70,MIR3977,2,,82136043
12,128729050,68,MIR4419B,2,,128729118
4,77494720,65,MIR4450,2,,77494785
14,105144030,56,MIR4710,2,,105144086
9,139440624,87,MIR4674,2,,139440711
13,66540461,100,MIR548X2,2,,66540561
4,160049956,87,MIR3688-2,2,,160050043
13,21007916,69,MIR4499,2,,21007985
2,185243701,70,MIR548AE1,2,,185243771
5,154209017,83,MIR378H,2,,154209100
2,19548189,77,MIR4757,2,,19548266
1,228649774,79,MIR4666A,2,,228649853
12,116866056,67,MIR4472-2,2,,116866123
7,72162873,76,MIR4650-1,2,,72162949
11,36031647,107,MIR3973,2,,36031754
9,124882360,86,MIR4478,2,,124882446
19,50357847,61,MIR4749,2,,50357908
19,50391431,56,MIR4750,2,,50391487
1,54519751,76,MIR4781,2,,54519827
2,232227418,86,MIR4777,2,,232227504
8,144815252,71,MIR4664,2,,144815323
11,123252147,73,MIR4493,2,,123252220
10,12695136,60,MIR4481,2,,12695196
1,95211415,41,MIR378G,2,,95211456
10,121718024,80,MIR4682,2,,121718104
2,189842819,68,MIR1245B,2,,189842887
5,128732754,86,MIR4460,2,,128732840
5,9053927,80,MIR4636,2,,9054007
10,127508308,83,MIR4484,2,,127508391
1,178646883,86,MIR4424,2,,178646969
11,111218481,66,MIR4491,2,,111218547
7,72162873,76,MIR4650-2,2,,72162949
15,49461266,84,MIR4716,2,,49461350
9,137741143,72,MIR3689C,2,,137741215
3,5291861,79,MIR4790,2,,5291940
3,103242876,84,MIR548AB,2,,103242960
19,4932698,54,MIR4747,2,,4932752
1,65045529,75,MIR4794,2,,65045604
5,57825869,67,MIR548AE2,2,,57825936
2,112078589,74,MIR4435-2,2,,112078663
5,180649565,68,MIR4638,2,,180649633
9,137742122,80,MIR3689D2,2,,137742202
1,192685457,63,MIR4426,2,,192685520
7,44150447,64,MIR4649,2,,44150511
6,99572484,88,MIR548AI,2,,99572572
8,6602684,81,MIR4659A,2,,6602765
4,86643620,66,MIR4451,2,,86643686
9,95290265,75,MIR4670,2,,95290340
6,44403377,82,MIR4642,2,,44403459
20,56470449,51,MIR4532,2,,56470500
19,45156955,47,MIR4531,2,,45157002
18,56118311,73,MIR3591,2,,56118384
4,2251803,80,MIR4800,2,,2251883
17,78393217,76,MIR4730,2,,78393293
2,208619530,75,MIR4775,2,,208619605
20,59053168,71,MIR4533,2,,59053239
1,196551542,69,MIR4735,2,,196551611
2,161264320,73,MIR4785,2,,161264393
1,25349993,84,MIR4425,2,,25350077
11,46397951,83,MIR4688,2,,46398034
2,112528637,74,MIR4771-1,2,,112528711
19,4445974,71,MIR4746,2,,4446045
8,6602688,73,MIR4659B,2,,6602761
X,6301946,58,MIR4770,2,,6302004
2,214622790,93,MIR4438,2,,214622883
11,118781416,80,MIR4492,2,,118781496
5,71465293,74,MIR4803,2,,71465367
2,132248732,77,MIR4784,2,,132248809
1,234442212,73,MIR4671,2,,234442285
5,535954,43,MIR4456,2,,535997
15,28735897,94,MIR4509-3,2,,28735991
10,20840898,77,MIR4675,2,,20840975
17,27188672,76,MIR4732,2,,27188748
1,162126896,76,MIR4654,2,,162126972
17,62496891,66,MIR3064,2,,62496957
6,76138122,67,MIR4463,2,,76138189
1,233759897,68,MIR4427,2,,233759965
2,152224847,78,MIR4773-1,2,,152224925
7,44921346,53,MIR4657,2,,44921399
3,75263626,73,MIR4444-1,2,,75263699
15,50652525,82,MIR4712,2,,50652607
2,239990512,98,MIR4440,2,,239990610
10,121137483,72,MIR4681,2,,121137555
11,74431312,70,MIR4696,2,,74431382
11,67801363,85,MIR4691,2,,67801448
15,83736086,81,MIR4515,2,,83736167
16,30515239,83,MIR4518,2,,30515322
17,8090262,60,MIR4521,2,,8090322
3,48238053,53,MIR4443,2,,48238106
17,62497331,100,MIR5047,2,,62497431
1,60198898,70,MIR4711,2,,60198968
11,72494574,63,MIR4692,2,,72494637
6,37523140,58,MIR4462,2,,37523198
22,19951275,82,MIR4761,2,,19951357
22,49176106,59,MIR4535,2,,49176165
17,36982090,55,MIR4727,2,,36982145
2,240882431,80,MIR4786,2,,240882511
2,152224847,78,MIR4773-2,2,,152224925
2,64752646,53,MIR4434,2,,64752699
18,46576056,82,MIR4744,2,,46576138
1,5922731,70,MIR4689,2,,5922801
13,52126724,79,MIR4703,2,,52126803
14,23426158,80,MIR4707,2,,23426238
19,10890929,82,MIR4748,2,,10891011
11,19781549,80,MIR4694,2,,19781629
4,79741905,70,MIR5096,2,,79741975
X,16645134,74,MIR548AM,2,,16645208
9,130631693,81,MIR4672,2,,130631774
6,170639848,84,MIR4644,2,,170639932
2,52929659,94,MIR4431,2,,52929753
15,99327654,77,MIR4714,2,,99327731
1,22592731,62,MIR4418,2,,22592793
4,37243531,82,MIR4801,2,,37243613
4,53578848,66,MIR4449,2,,53578914
1,12251769,61,MIR4632,2,,12251830
7,99754227,65,MIR4658,2,,99754292
20,59139619,64,MIR548AG2,2,,59139683
2,88382037,81,MIR4780,2,,88382118
17,29902287,90,MIR4725,2,,29902377
4,61788336,66,MIR548AG1,2,,61788402
11,3877291,80,MIR4687,2,,3877371
12,110271152,89,MIR4497,2,,110271241
6,132113311,60,MIR548H5,2,,132113371
9,36893458,70,MIR4476,2,,36893528
11,103720633,75,MIR4693,2,,103720708
16,48344528,313509,MIR5095,2,,48658037
19,804939,62,MIR4745,2,,805001
9,137742415,72,MIR3689E,2,,137742487
4,87463634,71,MIR4452,2,,87463705
7,4828195,75,MIR4656,2,,4828270
17,6558767,54,MIR4520-2,2,,6558821
X,7065900,78,MIR4767,2,,7065978
2,11680730,73,MIR4429,2,,11680803
11,61276067,62,MIR4488,2,,61276129
2,213790980,80,MIR4776-2,2,,213791060
2,60614496,84,MIR4432,2,,60614580
15,26093893,79,MIR4715,2,,26093972
3,25706363,67,MIR4442,2,,25706430
12,47757968,84,MIR4494,2,,47758052
5,1063010,79,MIR4635,2,,1063089
9,139781184,71,MIR4479,2,,139781255
10,100191048,69,MIR4685,2,,100191117
19,50436320,74,MIR4751,2,,50436394
8,62627346,72,MIR4470,2,,62627418
3,116569123,91,MIR4447,2,,116569214
12,47581594,80,MIR4698,2,,47581674
16,28969903,79,MIR4517,2,,28969982
10,12172758,57,MIR548AK,2,,12172815
1,5624130,73,MIR4417,2,,5624203
14,65511405,82,MIR4706,2,,65511487
X,109325345,101,MIR3978,2,,109325446
1,24255559,78,MIR378F,2,,24255637
2,240007522,100,MIR4441,2,,240007622
17,12820584,75,MIR1269B,2,,12820659
14,101280827,84,MIR2392,2,,101280911
5,169455491,79,MIR378E,2,,169455570
2,112078588,80,MIR4435-1,2,,112078668
10,35930099,81,MIR4683,2,,35930180
10,6194169,56,MIR3155B,2,,6194225
7,102004307,62822,LOC100630923,2,,102067129
19,38314362,31474,LOC100631378,2,,38345836
22,19159218,1127,LINC01311,2,,19160345
6,150184633,56011,RAET1E-AS1,2,,150240644
5,43573286,30046,NNT-AS1,2,,43603332
12,2785166,15157,CACNA1C-AS1,2,,2800323
13,21877650,41275,LINC00539,2,,21918925
10,4249067,37037,LINC00702,2,,4286104
17,76886661,12638,KIAA1731NL,2,,76899299
1,24822822,6028,RCAN3AS,2,,24828850
3,50137035,1386,RBM5-AS1,2,,50138421
5,143059424,112,MIR5197,2,,143059536
9,135821093,65,MIR548AW,2,,135821158
15,90427162,100,MIR5009,2,,90427262
16,18499554,65,MIR3670-2,2,,18499619
18,37256682,59,MIR5583-2,2,,37256741
6,10439949,78,MIR5689,2,,10440027
3,75263626,73,MIR4444-2,2,,75263699
11,79133212,58,MIR5579,2,,79133270
8,103137659,84,MIR5680,2,,103137743
18,64748820,103,MIR5011,2,,64748923
13,51922702,73,MIR5693,2,,51922775
12,125400092,113,MIR5188,2,,125400205
15,22156765,82,MIR5701-2,2,,22156847
2,101925911,85,MIR5696,2,,101925996
17,67095682,115,MIR4524B,2,,67095797
1,171070879,60,MIR1295B,2,,171070939
1,37966535,60,MIR5581,2,,37966595
6,33406107,107,MIR5004,2,,33406214
21,44371037,87,MIR5692B,2,,44371124
10,43493010,119,MIR5100,2,,43493129
6,126433836,9926,MIR5695,2,,126443762
7,97593716,77,MIR5692C2,2,,97593793
1,32552549,59,MIR5585,2,,32552608
5,54804677,77,MIR5687,2,,54804754
11,46774674,68,MIR5582,2,,46774742
3,123851775,97,MIR5002,2,,123851872
16,85339831,100,MIR5093,2,,85339931
4,13629488,93,MIR5091,2,,13629581
1,154076996,72,MIR5698,2,,154077068
18,37256684,59,MIR5583-1,2,,37256743
4,88221646,89,MIR5705,2,,88221735
16,585315,53,MIR5587,2,,585368
5,172089167,99,MIR5003,2,,172089266
12,94955564,71,MIR5700,2,,94955635
7,158384307,81,MIR5707,2,,158384388
2,110844009,91,MIR4436B2,2,,110844100
13,115009979,57,MIR548AR,2,,115010036
3,151283663,120,MIR5186,2,,151283783
8,12576640,59,MIR5692A2,2,,12576699
3,124870308,88,MIR5092,2,,124870396
3,131704698,77,MIR5704,2,,131704775
16,29610499,87,MIR3680-2,2,,29610586
15,80873443,137,MIR5572,2,,80873580
3,120768486,76,MIR5682,2,,120768562
1,147806602,76,MIR5087,2,,147806678
2,107766120,199861,MIR548AU,2,,107965981
X,29592394,81,MIR4666B,2,,29592475
6,35632493,73,MIR5690,2,,35632566
19,8454173,91,MIR4999,2,,8454264
1,201688635,120,MIR5191,2,,201688755
8,131020579,120,MIR5194,2,,131020699
X,153996870,61,MIR664B,2,,153996931
2,227523425,84,MIR5702,2,,227523509
3,184970997,63,MIR5588,2,,184971060
1,10027438,78,MIR5697,2,,10027516
8,81153623,85,MIR5708,2,,81153708
8,75460777,75,MIR5681A,2,,75460852
15,90393868,85,MIR5094,2,,90393953
15,22156765,82,MIR5701-1,2,,22156847
X,11336733,73,MIR548AX,2,,11336806
14,67908571,76,MIR5694,2,,67908647
4,39413529,65,MIR5591,2,,39413594
7,97592969,69,MIR5692A1,2,,97593038
8,41128566,96,MIR548AO,2,,41128662
2,135615389,54,MIR5590,2,,135615443
19,35836415,115,MIR5196,2,,35836530
19,12897941,65,MIR5684,2,,12898006
1,228129290,94,MIR5008,2,,228129384
7,102106188,85,MIR5090,2,,102106273
6,53141790,79,MIR5685,2,,53141869
14,54415144,58,MIR5580,2,,54415202
3,85434859,83,MIR5688,2,,85434942
3,185485634,58,MIR548AQ,2,,185485692
3,49843569,109,MIR5193,2,,49843678
18,13459945,80,MIR5190,2,,13460025
2,228336847,56,MIR5703,2,,228336903
5,135138673,91,MIR5692C1,2,,135138764
18,70520555,62,MIR548AV,2,,70520617
5,118490331,80,MIR5706,2,,118490411
2,62432960,92,MIR5192,2,,62433052
14,60113679,59,MIR5586,2,,60113738
1,45011164,60,MIR5584,2,,45011224
8,75460784,60,MIR5681B,2,,75460844
13,93142415,58,MIR548AS,2,,93142473
19,10149029,60,MIR5589,2,,10149089
1,72259914,42781,NEGR1-IT1,2,,72302695
1,71547006,156400,ZRANB2-AS2,2,,71703406
2,169628460,14479,CERS6-AS1,2,,169642939
17,27043010,1898,NARR,2,,27044908
5,101917071,36220,LINC00492,2,,101953291
5,37873526,2374,GDNF-AS1,2,,37875900
1,20969149,9537,PINK1-AS,2,,20978686
13,28403895,91646,PDX1-AS1,2,,28495541
13,54389553,60701,LINC00558,2,,54450254
13,46870579,1400,LINC00563,2,,46871979
19,36158849,5344,UPK1A-AS1,2,,36164193
3,29305684,16746,RBMS3-AS3,2,,29322430
17,19199908,9666,EPN2-AS1,2,,19209574
3,85849136,28064,CADM2-AS2,2,,85877200
1,150488232,2276,FALEC,2,,150490508
7,89511666,329283,STEAP2-AS1,2,,89840949
13,30050651,11236,MTUS2-AS1,2,,30061887
13,84714736,466167,LINC00333,2,,85180903
13,74993309,15987,LINC00381,2,,75009296
13,33383327,102463,LINC00423,2,,33485790
13,107306227,18301,LINC00443,2,,107324528
13,22446934,5365,LINC00424,2,,22452299
14,52013346,53324,FRMD6-AS2,2,,52066670
13,113399762,9283,ATP11A-AS1,2,,113409045
3,64173219,14017,PRICKLE2-AS3,2,,64187236
11,126810641,4345,KIRREL3-AS2,2,,126814986
17,41373436,7626,LINC00854,2,,41381062
21,41990432,12261,DSCAM-IT1,2,,42002693
6,21486291,25832,LINC00581,2,,21512123
4,39529458,66869,UGDH-AS1,2,,39596327
20,48657243,923,TRERNA1,2,,48658166
X,68399399,30368,LINC00269,2,,68429767
19,42927906,228601,LIPE-AS1,2,,43156507
7,66119505,15084,LOC100996437,2,,66134589
11,64216528,2600,LOC100996455,2,,64219128
9,102117621,19918,NAMA,2,,102137539
9,109378338,63743,LINC01505,2,,109442081
6,109557816,33901,LOC100996634,2,,109591717
X,101470279,11506,TCP11X2,2,,101481785
1,113362790,30475,LINC01356,2,,113393265
9,33677265,10743,PTENP1-AS,2,,33688008
X,51933717,127,SNORA11E,2,,51933844
9,33934294,79,SNORD121B,2,,33934373
X,149007562,18217,MAGEA8-AS1,2,,149025779
4,41222090,36654,UCHL1-AS1,2,,41258744
19,52452386,32234,ZNF350-AS1,2,,52484620
2,181556830,224836,SCHLAP1,2,,181781666
2,46656328,12644,LOC101805491,2,,46668972
20,25165307,12221,LOC101926889,2,,25177528
2,171556877,70399,LOC101926913,2,,171627276
14,24912158,59245,LOC101927045,2,,24971403
4,41881538,3090,LINC00682,2,,41884628
5,151998524,353385,LINC01470,2,,152351909
7,80000832,2923,LOC101927269,2,,80003755
2,59444842,61693,LOC101927285,2,,59506535
12,50305735,14387,LOC101927292,2,,50320122
7,7294784,22916,LOC101927354,2,,7317700
7,81638492,20779,LOC101927356,2,,81659271
20,46608836,10025,LINC01522,2,,46618861
2,197124747,4181,LOC101927482,2,,197128928
7,92465796,80705,LOC101927497,2,,92546501
7,15728002,8515,MEOX2-AS1,2,,15736517
2,198115581,51662,ANKRD44-IT1,2,,198167243
7,98610787,23315,LOC101927550,2,,98634102
2,2898819,230979,LINC01250,2,,3129798
17,55821841,849,CCDC182,2,,55822690
2,199164086,75735,LOC101927619,2,,199239821
7,17503068,95465,LOC101927630,2,,17598533
20,50448335,31117,LINC01429,2,,50479452
2,208051413,67627,LOC101927865,2,,208119040
9,93063177,132594,LINC01508,2,,93195771
7,112594689,41009,LOC101928036,2,,112635698
21,35772409,961,C21orf140,2,,35773370
5,173213792,4153,LINC01485,2,,173217945
20,60928065,3469,LAMA5-AS1,2,,60931534
2,134023766,18564,LOC101928161,2,,134042330
7,123977433,14717,LOC101928211,2,,123992150
2,136742745,22367,DARS-AS1,2,,136765112
7,124824622,194753,LOC101928283,2,,125019375
6,78359990,276769,MEI4,2,,78636759
14,86401021,195100,LOC101928767,2,,86596121
12,106097980,39861,CASC18,2,,106137841
5,5132197,7970,CTD-2297D10.2,2,,5140167
13,44716463,11748,SMIM2-AS1,2,,44728211
14,97925152,5344,LOC101929241,2,,97930496
20,6407378,101728,CASC20,2,,6509106
20,9485826,9819,LAMP5-AS1,2,,9495645
2,156877046,234397,LOC101929378,2,,157111443
5,86415964,127871,LOC101929380,2,,86543835
20,12845851,87316,LOC101929486,2,,12933167
2,38053389,3465,LINC00211,2,,38056854
2,38685779,57103,LOC101929596,2,,38742882
9,33167856,12125,B4GALT1-AS1,2,,33179981
1,168873142,183101,LINC00970,2,,169056243
12,54144230,6588,CISTR,2,,54150818
6,14280357,5328,LINC01108,2,,14285685
3,50264867,55,MIR5787,2,,50264922
1,63792595,60,MIR6068,2,,63792655
22,35732713,79,MIR6069,2,,35732792
21,45029767,103,MIR6070,2,,45029870
11,15991078,89,MIR6073,2,,15991167
12,66417399,107,MIR6074,2,,66417506
14,50433116,113,MIR6076,2,,50433229
10,4033351,100,MIR6078,2,,4033451
1,44304293,62,MIR6079,2,,44304355
17,62776876,66,MIR6080,2,,62776942
3,124093178,106,MIR6083,2,,124093284
1,20960171,110,MIR6084,2,,20960281
15,62635227,110,MIR6085,2,,62635337
X,108297771,49,MIR6087,2,,108297820
19,45939911,51,MIR6088,2,,45939962
Y,2477231,64,MIR6089,2,,2477295
12,62654139,96,MIR6125,2,,62654235
16,3535380,89,MIR6126,2,,3535469
11,56511348,109,MIR6128,2,,56511457
17,35974975,109,MIR378J,2,,35975084
17,47365707,109,MIR6129,2,,47365816
5,10478148,109,MIR6131,2,,10478257
7,132975634,108,MIR6133,2,,132975742
X,28513671,109,MIR6134,2,,28513780
17,47588178,84,MIR6165,2,,47588262
5,150901647,62,MIR6499,2,,150901709
3,32547774,107,MIR548AY,2,,32547881
21,34922967,67,MIR6501,2,,34923034
12,66644861,76,MIR6502,2,,66644937
11,59976543,86,MIR6503,2,,59976629
16,81644952,61,MIR6504,2,,81645013
16,15704886,66,MIR6506,2,,15704952
10,100684255,70,MIR6507,2,,100684325
2,178178533,77,MIR6512,2,,178178610
2,219144847,64,MIR6513,2,,219144911
11,62560173,70,MIR6514,2,,62560243
10,114059369,77,MIR6715B,2,,114059446
14,21491472,73,MIR6717,2,,21491545
16,2156669,85,MIR6511B1,2,,2156754
18,3885352,80,MIR6718,2,,3885432
9,139641344,78,MIR6722,2,,139641422
1,567704,89,MIR6723,2,,567793
1,1231489,61,MIR6726,2,,1231550
1,8926560,89,MIR6728,2,,8926649
1,25245835,72,MIR6731,2,,25245907
1,37945830,60,MIR6732,2,,37945890
1,43637322,61,MIR6733,2,,43637383
1,43914209,73,MIR6735,2,,43914282
1,153934826,70,MIR6737,2,,153934896
1,155921063,64,MIR6738,2,,155921127
1,201972251,113,MIR6740,2,,201972364
1,228584748,62,MIR6742,2,,228584810
11,209335,71,MIR6743,2,,209406
11,61645687,63,MIR6746,2,,61645750
11,62334482,61,MIR6747,2,,62334543
11,62557286,71,MIR6748,2,,62557357
11,64897387,63,MIR6751,2,,64897450
11,67257715,71,MIR6752,2,,67257786
11,67812260,164,MIR6753,2,,67812424
11,85989374,66,MIR6755,2,,85989440
11,119183659,63,MIR6756,2,,119183722
12,57906470,63,MIR6758,2,,57906533
12,111741945,68,MIR6760,2,,111742013
12,112237637,72,MIR6761,2,,112237709
12,113729327,86,MIR6762,2,,113729413
14,105617114,87,MIR6765,2,,105617201
16,2495392,66,MIR6767,2,,2495458
16,2513967,72,MIR6768,2,,2514039
16,50326526,60,MIR6771,2,,50326586
16,57806200,64,MIR6772,2,,57806264
16,87868197,69,MIR6775,2,,87868266
17,2596154,59,MIR6776,2,,2596213
17,17716793,66,MIR6777,2,,17716859
17,37071231,64,MIR6779,2,,37071295
17,40975897,64,MIR6781,2,,40975961
17,42285138,69,MIR6782,2,,42285207
17,43191734,67,MIR6784,2,,43191801
17,79660786,113,MIR6786,2,,79660899
17,80194543,61,MIR6787,2,,80194604
19,6392931,63,MIR6790,2,,6392994
19,6736722,67,MIR6791,2,,6736789
19,7682324,67,MIR6792,2,,7682391
19,15290093,68,MIR6795,2,,15290161
19,40875752,62,MIR6796,2,,40875814
19,42373696,72,MIR6797,2,,42373768
19,50295122,69,MIR6799,2,,50295191
19,50335274,82,MIR6800,2,,50335356
19,55751279,65,MIR6802,2,,55751344
19,55742252,68,MIR6804,2,,55742320
19,55899548,62,MIR6805,2,,55899610
19,58846053,64,MIR6806,2,,58846117
2,218765235,116,MIR6809,2,,218765351
2,238419573,58,MIR6811,2,,238419631
20,44054149,64,MIR6812,2,,44054213
21,43166931,70,MIR6814,2,,43167001
21,46898179,61,MIR6815,2,,46898240
22,20102208,66,MIR6816,2,,20102274
22,36682892,61,MIR6819,2,,36682953
22,38363569,62,MIR6820,2,,38363631
22,50356513,74,MIR6821,2,,50356587
3,48587393,61,MIR6823,2,,48587454
3,48671068,63,MIR6824,2,,48671131
3,128990988,98,MIR6826,2,,128991086
3,170140890,60,MIR6828,2,,170140950
5,131553541,70,MIR6830,2,,131553611
5,139943255,81,MIR6831,2,,139943336
6,32147592,61,MIR6833,2,,32147653
6,33258021,81,MIR6834,2,,33258102
6,34208449,64,MIR6835,2,,34208513
7,44112976,56,MIR6838,2,,44113032
7,64139441,113,MIR6839,2,,64139554
8,24811309,72,MIR6841,2,,24811381
8,27290886,65,MIR6842,2,,27290951
8,145112223,60,MIR6846,2,,145112283
8,145134776,69,MIR6847,2,,145134845
8,145540908,70,MIR6848,2,,145540978
9,33467866,67,MIR6851,2,,33467933
9,35710672,66,MIR6852,2,,35710738
9,100991430,69,MIR6854,2,,100991499
9,133501683,67,MIR6856,2,,133501750
X,53432604,93,MIR6857,2,,53432697
X,153678667,67,MIR6858,2,,153678734
11,66813113,66,MIR6860,2,,66813179
12,112601061,64,MIR6861,2,,112601125
16,28735572,70,MIR6862-1,2,,28735642
17,4872996,70,MIR6864,2,,4873066
17,4873380,65,MIR6865,2,,4873445
17,38349848,67,MIR6867,2,,38349915
20,1373543,62,MIR6869,2,,1373605
20,10630283,60,MIR6870,2,,10630343
3,50310666,62,MIR6872,2,,50310728
8,25202917,73,MIR6876,2,,25202990
9,135927382,64,MIR6877,2,,135927446
1,150464820,66,MIR6878,2,,150464886
15,74703697,76,MIR6881,2,,74703773
15,75132982,66,MIR6882,2,,75133048
17,8048311,78,MIR6883,2,,8048389
19,6389648,66,MIR6885,2,,6389714
19,11224149,61,MIR6886,2,,11224210
2,160043345,67,MIR6888,2,,160043412
3,49137286,61,MIR6890,2,,49137347
7,143079778,115,MIR6892,2,,143079893
X,53224592,78,MIR6895,2,,53224670
12,121882075,80,MIR7107,2,,121882155
22,32017452,65,MIR7109,2,,32017517
3,122880640,86,MIR7110,2,,122880726
6,35438284,72,MIR7111,2,,35438356
11,67800330,59,MIR7113,2,,67800389
10,73550503,54,MIR7152,2,,73550557
18,11654883,57,MIR7153,2,,11654940
11,45713253,73,MIR7154,2,,45713326
2,141344194,60,MIR7157,2,,141344254
6,159030738,84,MIR7161,2,,159030822
8,2024668,52,MIR7160,2,,2024720
8,41517961,64,MIR486-2,2,,41518025
8,93179689,50,MIR7641-2,2,,93179739
9,114033435,59,MIR7702,2,,114033494
14,24612697,77,MIR7703,2,,24612774
14,72983527,79,MIR7843,2,,72983606
2,64567880,102,MIR4433B,2,,64567982
12,94965006,122,MIR7844,2,,94965128
2,208031123,99,MIR7845,2,,208031222
1,12226999,96,MIR7846,2,,12227095
4,147329734,106,MIR7849,2,,147329840
19,2630712,79,MIR7850,2,,2630791
1,108439844,82,MIR7852,2,,108439926
16,81567506,65,MIR7854,2,,81567571
14,65252343,61,MIR7855,2,,65252404
1,86823314,56,MIR7856,2,,86823370
2,49286741,56,MIR548BA,2,,49286797
15,51606228,76,MIR7973-2,2,,51606304
19,11606358,79,MIR7974,2,,11606437
3,127305953,66,MIR7976,2,,127306019
3,176232890,49,MIR7977,2,,176232939
4,21466322,59,MIR7978,2,,21466381
11,23440650,86,MIR8054,2,,23440736
8,6479644,97,MIR8055,2,,6479741
5,172774457,82,MIR8056,2,,172774539
16,82722535,89,MIR8058,2,,82722624
3,96078807,76,MIR8060,2,,96078883
20,7352254,85,MIR8062,2,,7352339
3,52880478,90,MIR8064,2,,52880568
16,5682467,100,MIR8065,2,,5682567
4,102161951,78,MIR8066,2,,102162029
15,62596856,77,MIR8067,2,,62596933
11,11804681,88,MIR8070,2,,11804769
14,106106504,65,MIR8071-1,2,,106106569
13,110993304,72,MIR8073,2,,110993376
19,51710184,81,MIR8074,2,,51710265
13,113917233,80,MIR8075,2,,113917313
19,42855282,75,MIR8077,2,,42855357
13,44770264,72,MIR8079,2,,44770336
2,80093620,89,MIR8080,2,,80093709
4,114073437,81,MIR8082,2,,114073518
19,45261913,65,MIR8085,2,,45261978
10,28578186,93,MIR8086,2,,28578279
11,27536516,78,MIR8087,2,,27536594
5,180470402,82,MIR8089,2,,180470484
8,145486628,65,MIR7112,2,,145486693
16,28735572,70,MIR6862-2,2,,28735642
16,18473207,60,MIR6770-2,2,,18473267
15,102513726,68,MIR6859-2,2,,102513794
10,2118212,71,MIR6072,2,,2118283
19,40320355,87,MIR6719,2,,40320442
12,133158582,65,MIR6763,2,,133158647
19,59061651,92,MIR6807,2,,59061743
3,195609199,67,MIR6829,2,,195609266
8,146017315,61,MIR6850,2,,146017376
9,109363208,95,MIR8081,2,,109363303
22,28855856,80,MIR5739,2,,28855936
5,1510876,95,MIR6075,2,,1510971
11,128392284,60,MIR6090,2,,128392344
8,120337410,95,MIR548AZ,2,,120337505
10,114059369,79,MIR6715A,2,,114059448
6,32137806,87,MIR6721,2,,32137893
1,145584422,59,MIR6736,2,,145584481
11,64665834,75,MIR6750,2,,64665909
12,53450727,69,MIR6757,2,,53450796
16,68267328,74,MIR6773,2,,68267402
17,40860101,68,MIR6780A,2,,40860169
19,12963073,68,MIR6794,2,,12963141
2,219206633,70,MIR6810,2,,219206703
22,25851612,66,MIR6817,2,,25851678
3,127294108,66,MIR6825,2,,127294174
8,125520755,62,MIR6844,2,,125520817
9,35732918,74,MIR6853,2,,35732992
1,206648145,62,MIR6769B,2,,206648207
7,5751470,71,MIR6874,2,,5751541
12,124821726,62,MIR6880,2,,124821788
19,35613603,65,MIR6887,2,,35613668
12,113596917,65,MIR7106,2,,113596982
9,140344477,61,MIR7114,2,,140344538
1,147860433,82,MIR6077,2,,147860515
10,30657525,69,MIR7162,2,,30657594
2,6790504,67,MIR7515,2,,6790571
16,24214436,116,MIR1273H,2,,24214552
15,51606230,76,MIR7973-1,2,,51606306
19,55156759,75,MIR8061,2,,55156834
21,15096509,86,MIR8069-1,2,,15096595
3,113150964,83,MIR8076,2,,113151047
1,226109779,63,MIR6741,2,,226109842
8,145660933,69,MIR6893,2,,145661002
19,14184172,119,MIR1199,2,,14184291
2,86010722,78,MIR6071,2,,86010800
9,97827631,97,MIR6081,2,,97827728
X,13608410,55,MIR6086,2,,13608465
1,22959750,109,MIR6127,2,,22959859
7,116660264,109,MIR6132,2,,116660373
1,51525689,86,MIR6500,2,,51525775
12,48526579,71,MIR6505,2,,48526650
17,39673415,54,MIR6510,2,,39673469
11,118514717,80,MIR6716,2,,118514797
X,145074267,77,MIR892C,2,,145074344
3,94309655,21,MIR6730,2,,94309676
1,43830318,68,MIR6734,2,,43830386
1,201832500,75,MIR6739,2,,201832575
11,1277834,66,MIR6744,2,,1277900
11,47201161,127,MIR6745,2,,47201288
11,64669858,69,MIR6749,2,,64669927
11,71184548,66,MIR6754,2,,71184614
12,58142400,65,MIR6759,2,,58142465
14,100743693,61,MIR6764,2,,100743754
16,4721318,73,MIR6769A,2,,4721391
16,85951952,70,MIR6774,2,,85952022
17,18244127,73,MIR6778,2,,18244200
17,43011985,64,MIR6783,2,,43012049
19,2235827,98,MIR6789,2,,2235925
19,10939648,63,MIR6793,2,,10939711
19,49513162,67,MIR6798,2,,49513229
19,55756553,65,MIR6803,2,,55756618
1,1275029,59,MIR6808,2,,1275088
20,62708307,56,MIR6813,2,,62708363
22,30403037,65,MIR6818,2,,30403102
3,39179696,61,MIR6822,2,,39179757
3,134086645,59,MIR6827,2,,134086704
6,31601563,72,MIR6832,2,,31601635
6,43402279,79,MIR6780B,2,,43402358
7,99954273,71,MIR6840,2,,99954344
8,144919927,61,MIR6845,2,,144919988
8,145625670,69,MIR6849,2,,145625739
9,132631883,67,MIR6855,2,,132631950
16,67051,68,MIR6859-1,2,,67119
16,56938175,90,MIR6863,2,,56938265
17,74094099,58,MIR6868,2,,74094157
6,33255003,63,MIR6873,2,,33255066
7,100465657,72,MIR6875,2,,100465729
11,64785976,66,MIR6879,2,,64786042
17,38182584,78,MIR6884,2,,38182662
22,41648995,59,MIR6889,2,,41649054
X,53228070,57,MIR6894,2,,53228127
19,2434911,87,MIR7108,2,,2434998
10,69163108,60,MIR7151,2,,69163168
11,64109320,56,MIR7155,2,,64109376
6,33866911,66,MIR7159,2,,33866977
8,101715195,57,MIR7705,2,,101715252
17,75085498,81,MIR6516,2,,75085579
8,134058725,101,MIR7848,2,,134058826
19,55634592,68,MIR7975,2,,55634660
11,130536629,69,MIR8052,2,,130536698
18,24171430,69,MIR8057,2,,24171499
15,37265021,81,MIR8063,2,,37265102
11,28499027,68,MIR8068,2,,28499095
12,123849310,80,MIR8072,2,,123849390
18,112255,84,MIR8078,2,,112339
1,153662180,89,MIR8083,2,,153662269
X,52079698,86,MIR8088,2,,52079784
14,106087452,65,MIR8071-2,2,,106087517
11,12185229,85,MIR6124,2,,12185314
17,73494628,81,MIR6785,2,,73494709
20,39797662,56,MIR6871,2,,39797718
17,48846010,81,MIR8059,2,,48846091
21,24451605,109,MIR6130,2,,24451714
21,40818935,60,MIR6508,2,,40818995
1,12089214,65,MIR6729,2,,12089279
15,89869969,72,MIR6766,2,,89870041
19,52725272,79,MIR6801,2,,52725351
7,44091364,64,MIR6837,2,,44091428
17,38318185,69,MIR6866,2,,38318254
1,77525827,60,MIR7156,2,,77525887
12,42717501,160,MIR7851,2,,42717661
4,47654685,73,MIR8053,2,,47654758
8,94041978,89,MIR8084,2,,94042067
5,53955986,84100,LOC102467080,2,,54040086
5,106150897,195818,LOC102467213,2,,106346715
5,147647869,115544,LOC102546294,2,,147763413
5,163897284,72705,LOC102546299,2,,163969989
5,166332226,21149,CTB-7E3.1,2,,166353375
17,70026794,10644,LINC01152,2,,70037438
10,48155942,2749,CTSLP2,1,,48158691
19,58336666,2164,FKBP1AP1,1,,58338830
3,71802874,2657,GPR27,1,,71805531
7,54268916,1198,HPVC1,1,,54270114
17,30367354,2497,SH3GL1P1,1,,30369851
X,138528977,2155,SRD5A1P1,1,,138531132
1,171308034,2429,TOP1P1,1,,171310463
22,25160467,1519,TOP1P2,1,,25161986
20,45092298,1633,MKRN7P,1,,45093931
X,15803838,1874,INE2,1,,15805712
5,135465202,5377,SMAD5-AS1,1,,135470579
1,16972068,4847,MST1P2,1,,16976915
22,32517963,11493,AP1B1P1,1,,32529456
22,19033674,2214,DGCR11,1,,19035888
22,19005346,2415,DGCR9,1,,19007761
16,56226528,1909,DKFZP434H168,1,,56228437
15,30488238,18505,DKFZP434L187,1,,30506743
14,36007960,270390,RALGAPA1P,1,,36278350
1,248153568,925,OR2L1P,1,,248154493
3,97851541,942,OR5H1,1,,97852483
9,125423994,933,OR1L1,1,,125424927
1,220046618,246159,RNU5F-1,1,,220292777
5,80501461,245257,RNU5E-1,1,,80746718
5,80501462,245256,RNU5D-1,1,,80746718
X,68725077,27274,FAM155B,1,,68752351
22,17308363,1862,HSFY1P1,1,,17310225
22,17737749,9874,CECR3,1,,17747623
2,211482294,2305,CPS1-IT1,1,,211484599
8,131307600,1179,ASAP1-IT1,1,,131308779
21,36096104,13375,LINC00160,1,,36109479
21,29094697,28855,LINC00113,1,,29123552
21,43099461,18035,LINC00111,1,,43117496
21,23470935,17912,LINC00308,1,,23488847
4,153457415,3000,DKFZP434I0714,1,,153460415
9,97080477,10449,NUTM2F,1,,97090926
3,88188261,5553,ZNF654,1,,88193814
17,56234319,2161,MSX2P1,1,,56236480
9,124043045,4763,GSN-AS1,1,,124047808
11,86085777,48374,CCDC81,1,,86134151
16,576846,561,LINC00235,1,,577407
Y,14774297,29856,TTTY15,1,,14804153
2,202005011,17504,CFLAR-AS1,1,,202022515
13,44717286,18107,SMIM2,1,,44735393
1,168756178,5948,LINC00626,1,,168762126
14,20181062,1429,OR11H2,1,,20182491
1,64014650,1657,DLEU2L,1,,64016307
11,5809083,963,OR52N1,1,,5810046
1,69090,918,OR4F5,1,,70008
4,38614321,51928,KLF3-AS1,1,,38666249
1,761585,1317,LINC00115,1,,762902
19,14041999,22205,PODNL1,1,,14064204
4,38968365,65676,TMEM156,1,,39034041
11,55405833,939,OR4P4,1,,55406772
11,55321782,1113,OR4C15,1,,55322895
11,59516284,770,OR10V2P,1,,59517054
1,158746471,954,OR6N2,1,,158747425
1,248185249,939,OR2L5,1,,248186188
16,3160460,5139,ZNF205-AS1,1,,3165599
17,39411635,981,KRTAP9-9,1,,39412616
Y,20891767,9316,TTTY9A,1,,20901083
Y,8651358,34065,TTTY11,1,,8685423
Y,7672964,5759,TTTY12,1,,7678723
Y,23745485,11067,TTTY13,1,,23756552
19,38375462,21884,WDR87,1,,38397346
Y,27601457,4865,GOLGA2P2Y,1,,27606322
3,10326102,1328,LINC00852,1,,10327430
Y,24585739,1867,TTTY6,1,,24587606
1,203699704,1275,LINC00260,1,,203700979
1,47897806,2507,FOXD2-AS1,1,,47900313
1,116947335,13862,ATP1A1-AS1,1,,116961197
10,65224988,1334,JMJD1C-AS1,1,,65226322
17,72206134,3326,MGC16275,1,,72209460
19,57174019,9104,ZNF835,1,,57183123
16,30768743,4822,C16orf93,1,,30773565
1,120161999,28391,ZNF697,1,,120190390
15,98285845,131814,LINC00923,1,,98417659
17,79885704,2925,MAFG-AS1,1,,79888629
17,72920369,9637,OTOP2,1,,72930006
12,13153375,4389,HTR7P1,1,,13157764
19,46713498,4596,DKFZp434J0226,1,,46718094
7,116592500,1888,ST7-AS1,1,,116594388
8,133572744,982,HPYR1,1,,133573726
17,14934291,983,CDRT7,1,,14935274
17,15008301,1203,CDRT8,1,,15009504
1,102337567,22732,DNAJA1P5,1,,102360299
Y,27629054,3798,CSPG4P1Y,1,,27632852
Y,27874636,4899,TTTY3,1,,27879535
19,58878989,13400,ZNF837,1,,58892389
13,33078642,4890,N4BP2L2-IT2,1,,33083532
22,39712846,55,RNU86,1,,39712901
17,7657637,649,RPL29P2,1,,7658286
11,5079879,978,OR52E2,1,,5080857
11,5067755,936,OR52J3,1,,5068691
11,4824662,948,OR52R1,1,,4825610
11,114549199,28453,NXPE2,1,,114577652
12,55968198,930,OR2AP1,1,,55969128
12,98847618,3305,SLC9A7P1,1,,98850923
13,44596470,8129,LINC00284,1,,44604599
14,20528203,939,OR4L1,1,,20529142
14,20691868,993,OR11H6,1,,20692861
15,72968122,10368,HIGD2B,1,,72978490
17,58499864,8923,C17orf64,1,,58508787
1,13801444,38798,LRRC38,1,,13840242
1,12776117,12609,AADACL3,1,,12788726
1,248308449,939,OR2M5,1,,248309388
1,248524882,1047,OR2T4,1,,248525929
1,204337557,1290,LINC00628,1,,204338847
3,44903400,3759,TMEM42,1,,44907159
5,173416161,16982,C5orf47,1,,173433143
5,169659920,13315,C5orf58,1,,169673235
X,27478327,3131,SMEK3P,1,,27481458
3,138951833,531,PISRT1,1,,138952364
20,29637583,555,MLLT10P1,1,,29638138
20,35504523,18111,TLDC2,1,,35522634
17,17679999,2844,SMCR5,1,,17682843
20,62921737,12970,LINC00266-1,1,,62934707
10,90346518,20215,LIPJ,1,,90366733
10,89578069,27300,CFL1P1,1,,89605369
11,4592652,6398,C11orf40,1,,4599050
11,45928085,748,C11orf94,1,,45928833
12,9217772,2879,A2M-AS1,1,,9220651
13,45373639,10127,LINC00330,1,,45383766
13,106359178,54967,LINC00343,1,,106414145
14,102196773,2089,LINC00239,1,,102198862
14,104314057,10329,LINC00637,1,,104324386
14,97409915,1816,LINC00618,1,,97411731
14,71954577,1843,LOC145474,1,,71956420
16,610421,5108,PRR35,1,,615529
16,30034654,1369,C16orf92,1,,30036023
16,89262168,4361,SLC22A31,1,,89266529
16,34711784,3183,FRG2DP,1,,34714967
16,86588925,1980,FLJ30679,1,,86590905
16,4784288,15109,C16orf71,1,,4799397
17,72581056,9292,C17orf77,1,,72590348
17,39705857,4890,LINC00974,1,,39710747
19,51834794,10584,VSIG10L,1,,51845378
19,51891542,2286,C19orf84,1,,51893828
19,52934666,8033,ZNF534,1,,52942699
19,40146533,4754,LGALS16,1,,40151287
19,35715703,3925,FAM187B,1,,35719628
19,29456037,4018,LINC00906,1,,29460055
19,16144522,8423,LINC00905,1,,16152945
1,207991723,4218,LOC148696,1,,207995941
1,202830881,13488,LOC148709,1,,202844369
1,23695463,2867,ZNF436-AS1,1,,23698330
1,45274153,5648,BTBD19,1,,45279801
20,36888576,28772,LOC149684,1,,36917348
20,42354800,842,GTSF1L,1,,42355642
20,31175280,21414,LOC149950,1,,31196694
22,46449725,4677,PRR34-AS1,1,,46454402
2,131328418,13316,TISP43,1,,131341734
2,231555635,9609,LOC151475,1,,231565244
2,231751260,17972,LOC151484,1,,231769232
3,107560508,36407,LINC00635,1,,107596915
3,24141464,3274,LINC00691,1,,24144738
3,10059236,8584,CIDECP,1,,10067820
4,53656160,25471,LOC152578,1,,53681631
5,121772191,42591,MGC32805,1,,121814782
5,146939556,102016,JAKMIP2-AS1,1,,147041572
5,145463875,20071,PLAC8L1,1,,145483946
7,121943711,6420,FEZF1-AS1,1,,121950131
7,124417345,13519,LOC154872,1,,124430864
7,127937737,10079,MGC27345,1,,127947816
8,325930,7244,FAM87A,1,,333174
9,138235094,3310,C9orf62,1,,138238404
9,27245681,37110,LINC00032,1,,27282791
14,69446398,7782,ACTN1-AS1,1,,69454180
15,37091300,19407,CSNK1A1P1,1,,37110707
1,156549518,7044,TTC24,1,,156556562
7,9673899,1548,PER4,1,,9675447
10,50339200,2865,FAM170B,1,,50342065
12,93771701,24344,NUDT4P2,1,,93796045
12,6993845,1105,DSTNP2,1,,6994950
1,146649429,2099,PDIA3P1,1,,146651528
12,25146364,4009,C12orf77,1,,25150373
15,62929370,8010,MGC15885,1,,62937380
20,62714732,980,LKAAEAR1,1,,62715712
1,63624753,158175,LINC00466,1,,63782928
22,30774802,8500,RNF215,1,,30783302
2,207507141,7032,LOC200726,1,,207514173
17,7328934,1952,C17orf74,1,,7330886
3,72200407,23083,LINC00870,1,,72223490
7,154795142,2271,PAXIP1-AS1,1,,154797413
X,72161567,2022,FAM226A,1,,72163589
X,102965836,3124,TMEM31,1,,102968960
2,110969105,11412,LINC00116,1,,110980517
11,56143099,930,OR8U1,1,,56144029
11,55797894,975,OR5AS1,1,,55798869
11,56085782,939,OR8K3,1,,56086721
11,56184733,975,OR5R1,1,,56185708
10,11891606,45103,PROSER2-AS1,1,,11936709
11,123893719,936,OR10G9,1,,123894655
11,57957905,1085,OR9Q2,1,,57958990
11,57982216,978,OR1S1,1,,57983194
11,58125597,945,OR5B17,1,,58126542
18,68297754,20339,GTSCR1,1,,68318093
7,152133979,6121,FABP5P3,1,,152140100
6,41217114,213,TREML5P,1,,41217327
6,41068772,39801,ADCY10P1,1,,41108573
6,11094265,44704,SMIM13,1,,11138969
6,28183115,3592,TOB2P1,1,,28186707
Y,22627553,53561,TTTY10,1,,22681114
Y,9544432,8439,TTTY7,1,,9552871
21,19149720,15106,C21orf91-OT1,1,,19164826
17,54961462,812,MTVR2,1,,54962274
Y,9357274,5603,FAM197Y2,1,,9362877
Y,7567397,1891,TTTY16,1,,7569288
Y,27329789,1131,TTTY17A,1,,27330920
Y,8551410,509,TTTY18,1,,8551919
Y,9167488,4953,TTTY20,1,,9172441
Y,8572512,812,TTTY19,1,,8573324
Y,9555261,3644,TTTY21,1,,9558905
Y,9638761,12093,TTTY22,1,,9650854
Y,9748406,1165,TTTY23,1,,9749571
15,77934105,7476,LINGO1-AS1,1,,77941581
6,130152388,30028,TMEM244,1,,130182416
11,66742753,1726,C11orf86,1,,66744479
3,94657106,53063,LINC00879,1,,94710169
4,57975927,95538,IGFBP7-AS1,1,,58071465
12,49121217,38351,LINC00935,1,,49159568
17,20483036,1188,CDRT15L2,1,,20484224
17,21142183,14395,NATD1,1,,21156578
21,24733425,23731,D21S2088E,1,,24757156
21,31581468,2633,LINC00307,1,,31584101
14,35409127,575,IGBP1P1,1,,35409702
10,2047666,8876,LINC00700,1,,2056542
10,112628647,2015,PDCD4-AS1,1,,112630662
10,61717974,2697,LINC01553,1,,61720671
10,127371811,26435,LOC283038,1,,127398246
10,64099346,35540,LOC283045,1,,64134886
11,9115909,1828,KRT8P41,1,,9117737
11,119060962,5622,CCDC153,1,,119066584
11,133766329,5306,MIR4697HG,1,,133771635
11,58701115,124810,LOC283194,1,,58825925
11,75469499,10193,LOC283214,1,,75479692
11,33097695,3305,LINC00294,1,,33101000
11,7872297,55205,LOC283299,1,,7927502
12,53436972,11250,LOC283335,1,,53448222
12,55688071,945,OR6C6,1,,55689016
12,52604713,12884,LINC00592,1,,52617597
12,2870365,10470,LOC283440,1,,2880835
14,39218542,167544,LINC00639,1,,39386086
14,51800110,32165,LINC00640,1,,51832275
14,87372121,16978,LOC283585,1,,87389099
14,88490893,62795,LINC01146,1,,88553688
14,94371075,21643,FAM181A-AS1,1,,94392718
15,23094330,20924,LOC283683,1,,23115254
15,83394649,13883,LOC283693,1,,83408532
15,82555151,22116,FAM154B,1,,82577267
15,88795960,18337,NTRK3-AS1,1,,88814297
16,56126898,98108,LOC283856,1,,56225006
16,89225627,4456,LINC00304,1,,89230083
16,3039054,5456,LINC00514,1,,3044510
16,27458990,5724,IL21R-AS1,1,,27464714
16,34597901,27054,LINC01566,1,,34624955
17,41857802,4252,C17orf105,1,,41862054
17,48127712,5391,LOC284080,1,,48133103
17,79285071,19403,TMEM105,1,,79304474
18,14337421,5102,CYP4F35P,1,,14342523
19,43715942,36856,LOC284344,1,,43752798
19,54102884,3867,LOC284379,1,,54106751
19,37288451,30562,ZNF790-AS1,1,,37319013
19,7030593,2429,MBD3L5,1,,7033022
1,247978101,930,OR14A16,1,,247979031
1,205342379,14189,LEMD1-AS1,1,,205356568
1,205831206,34009,LOC284581,1,,205865215
1,24526729,11451,LOC284632,1,,24538180
1,182584274,1490,LOC284648,1,,182585764
1,183430010,11107,SMG7-AS1,1,,183441117
20,22380988,20293,LOC284788,1,,22401281
21,42513426,6565,LINC00323,1,,42519991
22,48934711,8488,LOC284933,1,,48943199
2,86042252,11659,LOC284950,1,,86053911
2,105363094,11083,LINC01114,1,,105374177
2,106209553,17463,LOC285000,1,,106227016
2,175190754,4616,LINC01305,1,,175195370
2,38358246,50747,CYP1B1-AS1,1,,38408993
3,128182436,8724,DNAJB8-AS1,1,,128191160
3,40432441,62358,ENTPD3-AS1,1,,40494799
3,25900022,15164,LINC00692,1,,25915186
3,101431277,983,PDCL3P4,1,,101432260
3,10801168,4709,LINC00606,1,,10805877
3,63088363,22374,LINC00698,1,,63110737
11,71505408,19497,ALG1L9P,1,,71524905
4,124573939,277579,LINC01091,1,,124851518
4,6202459,33204,LOC285484,1,,6235663
4,25162293,37834,SEPSECS-AS1,1,,25200127
4,13527942,5099,LINC01097,1,,13533041
4,13547699,1749,LINC01096,1,,13549448
5,158875563,17721,LOC285627,1,,158893284
6,133409218,18499,LINC00326,1,,133427717
6,119773711,38756,LOC285762,1,,119812467
6,961240,140327,LOC285768,1,,1101567
6,26472171,10566,LOC285819,1,,26482737
7,53103348,1270,POM121L12,1,,53104618
7,132333552,79976,FLJ40288,1,,132413528
8,144779284,1299,BREA2,1,,144780583
8,136246373,65589,LOC286094,1,,136311962
8,29779028,32095,FAM183CP,1,,29811123
8,58173784,5386,LOC286177,1,,58179170
8,71520811,54702,LOC286190,1,,71575513
9,42844369,14716,LOC286297,1,,42859085
9,92782935,20846,LOC286370,1,,92803781
X,103366999,2318,LOC286437,1,,103369317
X,39164209,22407,LINC01281,1,,39186616
14,70935595,14878,ADAM20P1,1,,70950473
21,31971004,189,KRTAP6-2,1,,31971193
21,31859508,159,KRTAP19-2,1,,31859667
21,32119268,252,KRTAP21-2,1,,32119520
10,45650109,31380,ANKRD30BP3,1,,45681489
10,4698347,6259,LINC00705,1,,4704606
11,68914695,24335,LOC338694,1,,68939030
12,11700963,16372,LINC01252,1,,11717335
12,21168629,74411,SLCO1B7,1,,21243040
13,69435416,24041,LINC00550,1,,69459457
17,5675553,158463,LOC339166,1,,5834016
18,73834952,22258,LOC339298,1,,73857210
1,43323292,31171,LOC339539,1,,43354463
21,26212863,217193,LOC339622,1,,26430056
22,32772650,7679,LOC339666,1,,32780329
2,174062440,84324,MLK7-AS1,1,,174146764
2,8062555,54390,LINC00298,1,,8116945
2,64834445,9171,LOC339807,1,,64843616
2,779836,84276,LINC01115,1,,864112
3,131043935,56384,LOC339874,1,,131100319
3,184880688,29055,EHHADH-AS1,1,,184909743
3,187868993,2883,LPP-AS2,1,,187871876
4,52859807,23979,LRRC66,1,,52883786
4,158493641,3662,LOC340017,1,,158497303
5,176864889,10056,PRR7-AS1,1,,176874945
5,134984371,5253,LOC340074,1,,134989624
5,5034471,35644,LINC01020,1,,5070115
5,24835388,5304,LOC340107,1,,24840692
5,32947548,15025,LOC340113,1,,32962573
6,137243378,3420,SLC35D3,1,,137246798
6,41176291,9394,TREML3P,1,,41185685
8,12623570,45340,LOC340357,1,,12668910
8,145576885,1706,TMEM249,1,,145578591
9,99837952,6275,GAS2L1P2,1,,99844227
X,71130937,232487,NHSL2,1,,71363424
11,5602106,1008,OR52B6,1,,5603114
12,27619742,35376,SMCO2,1,,27655118
17,37186158,23300,LRRC37A11P,1,,37209458
19,51152701,9866,C19orf81,1,,51162567
1,248084319,939,OR2T8,1,,248085258
1,109834986,14677,MYBPHL,1,,109849663
1,120377387,10116,NBPF7,1,,120387503
20,30555804,30452,XKR7,1,,30586256
3,185677757,20908,LOC344887,1,,185698665
4,40044536,14283,LOC344967,1,,40058819
4,3250766,7576,MSANTD1,1,,3258342
5,178450775,10613,ZNF879,1,,178461388
5,41307047,203683,PLCXD3,1,,41510730
X,54775331,49342,ITIH6,1,,54824673
X,40482817,574,MPC1L,1,,40483391
X,2924653,26773,ARSH,1,,2951426
X,26234285,2102,MAGEB5,1,,26236387
6,10671650,23189,C6orf52,1,,10694839
13,19582398,4376,LINC00442,1,,19586774
2,231849082,11665,SPATA3-AS1,1,,231860747
X,12920935,40484,TLR8-AS1,1,,12961419
12,7917811,8906,NANOGNB,1,,7926717
17,46800529,1591,PRAC2,1,,46802120
16,2848485,6648,PRSS41,1,,2855133
11,45792982,927,DKFZp779M0652,1,,45793909
13,25154345,17467,TPTE2P6,1,,25171812
1,47137504,1752,TEX38,1,,47139256
1,78347032,8192,NEXN-AS1,1,,78355224
2,39186428,1057,LOC375196,1,,39187485
2,177494308,7994,LINC01116,1,,177502302
19,60950,10016,WASH5P,1,,70966
17,55122838,1318,RNF126P1,1,,55124156
21,23095612,14027,LINC00317,1,,23109639
2,7052406,6407,RNF144A-AS1,1,,7058813
19,56905044,5495,ZNF582-AS1,1,,56910539
11,1628794,899,KRTAP5-3,1,,1629693
11,1642187,1181,KRTAP5-4,1,,1643368
10,131862161,46920,LINC00959,1,,131909081
11,43964105,1328,C11orf96,1,,43965433
11,93553734,29934,VSTM5,1,,93583668
11,112404944,21581,LOC387810,1,,112426525
15,85070426,43600,UBE2Q2P1,1,,85114026
16,52060263,47584,C16orf97,1,,52107847
16,57844548,6283,LOC388282,1,,57850831
16,67700716,1945,C16orf86,1,,67702661
17,8656423,5454,SPDYE4,1,,8661877
17,36991340,6302,C17orf98,1,,36997642
17,45055521,1093,RPRML,1,,45056614
17,72352554,5404,BTBD17,1,,72357958
17,79139306,17658,AATK-AS1,1,,79156964
19,12203077,22417,ZNF788,1,,12225494
19,45041044,19106,CEACAM22P,1,,45060150
19,55890611,5016,TMEM238,1,,55895627
21,46758504,3401,LINC00316,1,,46761905
2,46706703,4861,TMEM247,1,,46711564
2,47043806,5993,LINC01118,1,,47049799
2,74641302,3542,C2orf81,1,,74644844
2,130680434,11456,LOC389033,1,,130691890
3,138760943,2791,PRR23C,1,,138763734
4,68918915,76672,TMPRSS11F,1,,68995587
4,184415889,9779,LOC389247,1,,184425668
5,125967413,4561,TEX43,1,,125971974
5,138727634,3251,PROB1,1,,138730885
7,97595907,5731,MGC72080,1,,97601638
8,6666040,27126,XKR5,1,,6693166
12,8509559,33789,LINC00937,1,,8543348
8,38368351,17829,C8orf86,1,,38386180
9,43624501,6229,SPATA31A6,1,,43630730
9,84603686,6485,SPATA31D1,1,,84610171
X,139173825,1245,LOC389895,1,,139175070
X,3735575,26360,LOC389906,1,,3761935
11,5968576,948,OR56A3,1,,5969524
11,5988782,942,OR56A5,1,,5989724
11,7949264,945,OR10A6,1,,7950209
11,44069530,11997,ACCSL,1,,44081527
11,55540913,945,OR5D13,1,,55541858
11,55889848,939,OR8H3,1,,55890787
11,123908772,936,OR10G7,1,,123909708
11,124266305,942,OR8B3,1,,124267247
12,55758894,939,OR6C75,1,,55759833
12,55820037,939,OR6C76,1,,55820976
12,55862983,939,OR6C70,1,,55863922
14,20502002,915,OR4K13,1,,20502917
14,20585565,1032,OR4K17,1,,20586597
14,20611894,927,OR4N5,1,,20612821
15,23435069,13354,GOLGA8EP,1,,23448423
15,22413461,934,OR4N3P,1,,22414395
15,79575145,15436,ANKRD34C,1,,79590581
16,33298267,435,LOC390705,1,,33298702
19,44080951,5305,PINLYP,1,,44086256
19,53716200,3155,ZNF818P,1,,53719355
1,248223983,939,OR2L3,1,,248224922
2,207516344,66776,DYTN,1,,207583120
9,90472957,1014,LOC392364,1,,90473971
X,47566589,29438,CXXC1P1,1,,47596027
15,48483866,12085,CTXN2,1,,48495951
10,2342512,14756,LINC00701,1,,2357268
10,6368506,9437,LOC399715,1,,6377943
10,38717073,24008,LINC00999,1,,38741081
10,102989350,9266,LBX1-AS1,1,,102998616
10,127393858,14204,FLJ37035,1,,127408062
11,19532439,13186,NAV2-AS4,1,,19545625
11,47608229,2517,FAM180B,1,,47610746
11,89659929,6239,TRIM49D1,1,,89666168
11,111385509,22247,C11orf88,1,,111407756
12,46119502,2202,LINC00938,1,,46121704
12,65277553,93749,FLJ41278,1,,65371302
12,88176662,1826,MKRN9P,1,,88178488
13,24481422,42032,ANKRD20A19P,1,,24523454
13,38109076,16597,LINC00547,1,,38125673
13,113301357,37454,ATP11AUN,1,,113338811
14,89883697,2440,FOXN3-AS1,1,,89886137
16,85170755,12294,LOC400548,1,,85183049
17,48944039,1693,TOB1-AS1,1,,48945732
17,68163101,2442,KCNJ2-AS1,1,,68165543
17,71782960,13974,LOC400620,1,,71796934
18,14946265,27490,LINC01443,1,,14973755
18,61880317,46973,LINC01538,1,,61927290
19,50553845,16207,FLJ26850,1,,50570052
1,752750,2464,FAM87B,1,,755214
1,182173079,110117,LINC01344,1,,182283196
1,221503269,6369,C1orf140,1,,221509638
1,222910557,13445,FAM177B,1,,222924002
20,24180402,24822,FLJ33581,1,,24205224
22,21400248,18209,LRRC74B,1,,21418457
22,38740669,54262,LOC400927,1,,38794931
2,65128973,30608,LOC400958,1,,65159581
2,113399406,2351,FLJ42351,1,,113401757
3,10048101,4678,LOC401052,1,,10052779
3,75721541,6913,LINC00960,1,,75728454
3,195869506,18255,LINC00885,1,,195887761
4,39481874,1649,LOC401127,1,,39483523
4,65779998,90220,LOC401134,1,,65870218
5,17379014,8405,LOC401177,1,,17387419
5,126386995,22189,C5orf63,1,,126409184
6,3020389,4616,HTATSF1P2,1,,3025005
6,17102488,29115,STMND1,1,,17131603
6,28827401,4053,LOC401242,1,,28831454
6,33553882,7233,LINC00336,1,,33561115
6,52441999,6792,TRAM2-AS1,1,,52448791
6,170581561,6993,FLJ38122,1,,170588554
7,32797897,4639,LINC00997,1,,32802536
7,35353465,62621,LOC401324,1,,35416086
7,112756772,1865,LINC00998,1,,112758637
9,30388932,19520,LINC01242,1,,30408452
9,127615695,4475,WDR38,1,,127620170
9,139877444,2766,LCNL1,1,,139880210
Y,26356113,4865,GOLGA2P3Y,1,,26360978
11,4903048,1065,OR51T1,1,,4904113
11,4967388,942,OR51A4,1,,4968330
1,22138757,12957,LDLRAD2,1,,22151714
4,2420671,44019,CFAP99,1,,2464690
1,34334556,16503,CSMD2-AS1,1,,34351059
1,248813231,954,OR2T27,1,,248814185
12,55886161,939,OR6C68,1,,55887100
4,183958817,2455,FAM92A1P2,1,,183961272
6,49913813,3344,DEFB133,1,,49917157
5,147548108,7074,SPINK14,1,,147555182
10,73471457,8121,C10orf105,1,,73479578
10,51748077,22182,AGAP6,1,,51770259
10,42903621,64067,CCNYL2,1,,42967688
10,44124264,45883,ZNF32-AS3,1,,44170147
10,46897640,41505,FAM35BP,1,,46939145
10,80027084,12886,LINC00595,1,,80039970
22,45002207,19092,LINC00229,1,,45021299
8,145751602,2856,C8orf82,1,,145754458
15,70127572,7734,LINC00593,1,,70135306
1,62119913,1887,MGC34796,1,,62121800
9,34568009,15061,CNTFR-AS1,1,,34583070
13,28519342,368,ATP5EP2,1,,28519710
11,1651032,1127,KRTAP5-5,1,,1652159
4,83534265,8325,LINC00575,1,,83542590
10,81967465,11948,LINC00857,1,,81979413
11,49580079,251890,LOC440040,1,,49831969
11,55061178,4530,TRIM51HP,1,,55065708
12,130636137,10086,FZD10-AS1,1,,130646223
13,30510667,13958,LINC00544,1,,30524625
14,19377593,981,OR11H12,1,,19378574
14,66953088,12183,LINC00238,1,,66965271
18,14477953,20752,CXADRP3,1,,14498705
15,85045805,4444,DNM1P41,1,,85050249
15,95398591,1702,LOC440311,1,,95400293
16,4838397,8095,SMIM22,1,,4846492
16,31579087,1758,YBX3P1,1,,31580845
17,25745030,13619,TBC1D3P5,1,,25758649
17,66194800,1643,LOC440461,1,,66196443
1,16133656,538,UQCRHL,1,,16134194
1,43424719,24310,SLC2A1-AS1,1,,43449029
1,95940292,4620,FLJ31662,1,,95944912
1,110828998,52795,LOC440600,1,,110881793
1,157061834,7766,ETV3L,1,,157069600
1,165667986,11213,LOC440700,1,,165679199
1,190594019,176769,LOC440704,1,,190770788
20,18359692,2435,LINC00851,1,,18362127
22,21396680,1858,P2RX6P,1,,21398538
2,114737145,27742,LINC01191,1,,114764887
2,132036862,20530,LOC440910,1,,132057392
2,171568948,2129,LINC01124,1,,171571077
3,84687555,231171,LINC00971,1,,84918726
4,76279285,8491,LOC441025,1,,76287776
5,79646423,1362,CRSP8P,1,,79647785
6,42858002,552,C6orf226,1,,42858554
6,66011310,4194,LOC441155,1,,66015504
6,139012804,5621,FLJ46906,1,,139018425
7,32956426,26356,RP9P,1,,32982782
7,72333320,6336,SPDYE7P,1,,72339656
8,93725189,73099,FLJ46284,1,,93798288
9,99488102,1647,LOC441455,1,,99489749
9,99691285,13287,NUTM2G,1,,99704572
X,37060954,913,FTH1P18,1,,37061867
11,50238998,18635,LOC441601,1,,50257633
11,58169937,945,OR5B3,1,,58170882
10,42827313,36180,LOC441666,1,,42863493
14,64812190,2139,TEX21P,1,,64814329
18,30091625,2972,WBP11P1,1,,30094597
19,54573200,11434,TARM1,1,,54584634
5,7301442,5385,LOC442132,1,,7306827
6,66497771,1605,SLC25A51P1,1,,66499376
6,111367621,1136,GSTM2P1,1,,111368757
9,66494268,8762,PTGER4P2-CDK2AP2P2,1,,66503030
9,79634570,1299,FOXB2,1,,79635869
X,37026431,3308,FAM47C,1,,37029739
X,98716599,478242,XRCC6P5,1,,99194841
7,29724769,3090,DPY19L2P3,1,,29727859
9,96080480,28216,C9orf129,1,,96108696
8,6825662,973,DEFA10P,1,,6826635
Y,27874636,4899,TTTY3B,1,,27879535
Y,25082601,36830,TTTY4B,1,,25119431
Y,26716348,36824,TTTY4C,1,,26753172
Y,27329789,1131,TTTY17B,1,,27330920
Y,27329789,1131,TTTY17C,1,,27330920
1,90458823,1702,GEMIN8P4,1,,90460525
6,26521933,5679,HCG11,1,,26527612
9,89698800,1340,LOC494127,1,,89700140
11,18230684,2371,LOC494141,1,,18233055
9,72434320,1335,C9orf135-AS1,1,,72435655
19,7004963,1463,FLJ25758,1,,7006426
19,58863335,3214,A1BG-AS1,1,,58866549
17,30477386,1204,ARGFXP2,1,,30478590
17,29302352,665,DPRXP4,1,,29303017
19,54135309,4954,DPRX,1,,54140263
7,72440164,3510,LOC541473,1,,72443674
4,68919225,19726,LOC550113,1,,68938951
2,159023161,69520,CCDC148-AS1,1,,159092681
12,92813869,8055,CLLU1OS,1,,92821924
1,228780656,7503,DUSP5P1,1,,228788159
1,150533370,13658,ADAMTSL4-AS1,1,,150547028
1,228351786,763,IBA57-AS1,1,,228352549
6,112408673,15320,FAM229B,1,,112423993
8,687604,400173,ERICH1-AS1,1,,1087777
8,29578775,26850,LINC00589,1,,29605625
8,143279716,10648,LINC00051,1,,143290364
1,54702115,2621,SSBP3-AS1,1,,54704736
4,139010167,89164,SLC7A11-AS1,1,,139099331
4,138948576,103263,LINC00616,1,,139051839
19,21933546,2694,LOC641367,1,,21936240
13,45150031,4537,TSC22D1-AS1,1,,45154568
8,67834164,3613,SNHG6,1,,67837777
7,64042987,1142,LOC641746,1,,64044129
7,57233376,14487,GUSBP10,1,,57247863
9,68427783,27585,LOC642236,1,,68455368
5,50668570,10596,LOC642366,1,,50679166
11,89726708,8968,TRIM53AP,1,,89735676
18,5143671,53584,C18orf42,1,,5197255
16,14844669,14646,NPIPA3,1,,14859315
16,14805545,14640,NPIPA2,1,,14820185
8,94358694,353967,LINC00535,1,,94712661
9,43140536,4948,LOC642929,1,,43145484
10,128933689,60733,FAM196A,1,,128994422
1,213029945,1535,FLVCR1-AS1,1,,213031480
11,94245694,19595,C11orf97,1,,94265289
10,45406763,25695,TMEM72,1,,45432458
X,120006451,3328,CT47B1,1,,120009779
5,27472398,24110,LINC01021,1,,27496508
20,5451841,5939,LOC643406,1,,5457780
10,90484300,28213,LIPK,1,,90512513
6,94416800,69399,TSG1,1,,94486199
1,113739403,9472,LOC643441,1,,113748875
X,95592084,817,LOC643486,1,,95592901
9,46763790,69529,LINC01189,1,,46833319
10,47096453,54947,LINC00842,1,,47151400
15,32885656,13855,GOLGA8N,1,,32899511
12,98123825,26470,LOC643711,1,,98150295
19,35067637,100299,SCGB1B2P,1,,35167936
11,104772275,16627,LOC643733,1,,104788902
12,98879321,18312,LOC643770,1,,98897633
3,33131907,6386,TMPPE,1,,33138293
1,1361507,1660,TMEM88B,1,,1363167
5,42985500,7935,FLJ32255,1,,42993435
5,115387162,7665,ARL14EPL,1,,115394827
4,56686236,17194,LOC644145,1,,56703430
17,43677468,1760,LOC644172,1,,43679228
19,36912075,1724,LOC644189,1,,36913799
4,90757551,5591,SNCA-AS1,1,,90763142
19,38308050,9228,LOC644554,1,,38317278
11,9481102,1143,LOC644656,1,,9482245
8,117886662,2445,RAD21-AS1,1,,117889107
18,15313554,12364,LOC644669,1,,15325918
3,45719656,10718,LIMD1-AS1,1,,45730374
2,67350488,91963,LOC644838,1,,67442451
5,79594916,1381,LOC644936,1,,79596297
17,18281078,11882,EVPLL,1,,18292960
X,49335002,7358,GAGE12G,1,,49342360
18,2652168,3226,CBX3P2,1,,2655394
15,44826702,2419,EIF3J-AS1,1,,44829121
1,231611509,762,SNRPD2P2,1,,231612271
19,4890448,12431,ARRDC5,1,,4902879
7,104436953,7586,LHFPL3-AS1,1,,104444539
17,58160926,4902,WFDC21P,1,,58165828
16,2688982,7148,FLJ42627,1,,2696130
1,155531771,1964,ASH1L-AS1,1,,155533735
14,56247852,15540,LINC00520,1,,56263392
1,237167402,316,MT1HL1,1,,237167718
15,78206558,12630,LOC645752,1,,78219188
1,240170823,5737,RPS7P5,1,,240176560
9,90744219,5681,SPATA31C2,1,,90749900
18,11609556,1055,SLC35G4,1,,11610611
6,150319154,7126,RAET1K,1,,150326280
3,167613735,28062,LINC01330,1,,167641797
13,23471168,1152,BASP1P1,1,,23472320
15,21932513,8226,LOC646214,1,,21940739
15,29034979,66741,PDCD6IPP2,1,,29101720
1,26146444,3653,LOC646471,1,,26150097
19,53785542,2060,FAM90A27P,1,,53787602
13,28552242,10532,URAD,1,,28562774
3,149689065,1964,LOC646903,1,,149691029
15,79044378,1356,LOC646938,1,,79045734
9,35906188,950,HRCT1,1,,35907138
6,42068856,41859,C6orf132,1,,42110715
3,156527059,2751,PA2G4P4,1,,156529810
13,51656983,89541,LINC00371,1,,51746524
14,104406762,1883,RD3L,1,,104408645
14,105864919,15277,TEX22,1,,105880196
22,22901749,7255,LL22NC03-63E9.3,1,,22909004
15,84748938,46415,EFTUD1P1,1,,84795353
11,120120467,16174,LOC649133,1,,120136641
16,33961051,1452,LINC00273,1,,33962503
7,63894070,1825,YWHAEP1,1,,63895895
4,8951476,651,LOC650293,1,,8952127
10,81442730,5920,BEND3P3,1,,81448650
4,187110185,2459,FLJ38576,1,,187112644
1,35441299,3008,LOC653160,1,,35444307
2,96142714,7765,TRIM43B,1,,96150479
2,131350352,6899,CFC1B,1,,131357251
X,120087136,3318,CT47A7,1,,120090454
2,241615834,6483,AQP12B,1,,241622317
15,75550898,14898,GOLGA6C,1,,75565796
15,75575181,12967,GOLGA6D,1,,75588148
19,7037754,2430,MBD3L4,1,,7040184
19,7056215,2430,MBD3L3,1,,7058645
1,175937532,144,SCARNA3,1,,175937676
17,58308876,130,SCARNA20,1,,58309006
17,7809440,138,SCARNA21,1,,7809578
5,82360022,134,SCARNA18,1,,82360156
3,160232694,330,SCARNA7,1,,160233024
4,1976362,125,SCARNA22,1,,1976487
2,234197321,266,SCARNA6,1,,234197587
15,83424696,127,SCARNA15,1,,83424823
12,6619387,330,SCARNA10,1,,6619717
15,66639543,137,SCARNA14,1,,66639680
15,35529526,738,ANP32AP1,1,,35530264
21,46409778,4223,LINC00163,1,,46414001
9,65503362,6248,SPATA31A5,1,,65509610
2,4675807,28005,LINC01249,1,,4703812
X,120111460,3318,CT47A10,1,,120114778
X,120111460,3318,CT47A9,1,,120114778
X,120111460,3318,CT47A8,1,,120114778
X,120116320,3318,CT47A6,1,,120119638
7,92190367,29329,FAM133DP,1,,92219696
X,120111460,3318,CT47A5,1,,120114778
X,120111460,3318,CT47A4,1,,120114778
X,120111460,3318,CT47A3,1,,120114778
12,89404902,8567,LOC728084,1,,89413469
X,120111460,3318,CT47A2,1,,120114778
5,168440231,24772,CTB-174D11.1,1,,168465003
X,120116320,3318,CT47A1,1,,120119638
10,89117476,12976,NUTM2D,1,,89130452
10,88998423,103892,NUTM2A-AS1,1,,89102315
13,107028910,1232,LINC00460,1,,107030142
10,89156330,11127,LINC00864,1,,89167457
5,116751207,164232,LINC00992,1,,116915439
6,116359893,1214,TPI1P3,1,,116361107
5,177302261,9008,LOC728554,1,,177311269
5,1572072,22574,SDHAP3,1,,1594646
12,17141680,1882,SKP1P2,1,,17143562
19,49990864,4232,RPL13AP5,1,,49995096
12,108296926,622,LOC728739,1,,108297548
16,28353838,20343,NPIPB6,1,,28374181
5,77654587,1778,SCAMP1-AS1,1,,77656365
10,48844035,18653,FRMPD2B,1,,48862688
17,44668099,49941,NSFP1,1,,44718040
2,43902291,1170,LOC728819,1,,43903461
12,27233989,1466,C12orf71,1,,27235455
18,44554572,1641,TCEB3CL,1,,44556213
1,46111451,906,RPS15AP10,1,,46112357
10,72976980,1005,UNC5B-AS1,1,,72977985
1,146490894,23705,LOC728989,1,,146514599
10,75434032,23522,AGAP5,1,,75457554
16,60392358,1309,LOC729159,1,,60393667
6,147122804,2156,KATNBL1P6,1,,147124960
13,57741330,3022,PRR20B,1,,57744352
13,57741330,3022,PRR20C,1,,57744352
13,57741330,3022,PRR20D,1,,57744352
13,57741330,3022,PRR20E,1,,57744352
10,81462982,9531,NUTM2B,1,,81472513
20,58662740,13702,LOC729296,1,,58676442
11,89657231,8998,TRIM49D2P,1,,89666229
13,76445173,12775,LMO7DN,1,,76457948
X,49335002,7358,GAGE12C,1,,49342360
5,8333595,124082,LOC729506,1,,8457677
1,17060446,510,FAM231A,1,,17060956
6,28911560,755,LINC01556,1,,28912315
3,138722803,2307,PRR23A,1,,138725110
2,25194980,67583,DNAJC27-AS1,1,,25262563
15,74653892,490,LOC729739,1,,74654382
19,51981896,11963,CEACAM18,1,,51993859
18,22208145,34017,LOC729950,1,,22242162
19,18360759,5470,LOC729966,1,,18366229
1,95393583,35243,LOC729970,1,,95428826
19,56283170,1375,RFPL4AL1,1,,56284545
1,98676266,61948,LOC729987,1,,98738214
22,30920916,21753,SEC14L6,1,,30942669
3,159738435,10775,LINC01100,1,,159749210
16,30709024,786,LOC730183,1,,30709810
1,148201751,785,PPIAL4E,1,,148202536
22,46402495,4162,LOC730668,1,,46406657
10,26932036,10347,LINC00202-2,1,,26942383
X,103230501,2434,H2BFXP,1,,103232935
20,61726844,6827,HAR1B,1,,61733671
X,13328770,9282,GS1-600G8.3,1,,13338052
6,8086640,126,SCARNA27,1,,8086766
19,49540276,128,SNAR-G1,1,,49540404
19,51108219,123,SNAR-F,1,,51108342
19,48437437,122,SNAR-A1,1,,48437559
19,48437437,122,SNAR-A2,1,,48437559
19,48448178,122,SNAR-A12,1,,48448300
5,129083883,16873,KIAA1024L,1,,129100756
17,12663450,30151,LOC100128006,1,,12693601
3,193710882,1145,DPPA2P3,1,,193712027
3,149375996,3153,WWTR1-AS1,1,,149379149
10,17428934,21351,ST8SIA6-AS1,1,,17450285
8,74332308,21445,STAU2-AS1,1,,74353753
3,169672014,12508,LOC100128164,1,,169684522
6,149275396,10424,LOC100128176,1,,149285820
11,133902166,9070,LOC100128239,1,,133911236
19,56989242,17563,ZNF667-AS1,1,,57006805
7,154858778,4489,HTR5A-AS1,1,,154863267
17,8261730,2129,LOC100128288,1,,8263859
19,58514261,4313,LOC100128398,1,,58518574
X,135721701,2887,LINC00892,1,,135724588
20,18789994,20853,C20orf78,1,,18810847
10,21462918,934,NEBL-AS1,1,,21463852
22,25498383,10276,LOC100128531,1,,25508659
19,3539154,4874,C19orf71,1,,3544028
8,144077244,1836,CDC42P3,1,,144079080
19,35896508,11234,LINC01531,1,,35907742
8,30239634,3283,RBPMS-AS1,1,,30242917
16,2787076,7722,SRRM2-AS1,1,,2794798
10,25447000,18205,GPR158-AS1,1,,25465205
7,64035072,43895,LOC100128885,1,,64078967
8,7159132,53744,FAM66B,1,,7212876
21,47247754,8579,LOC100129027,1,,47256333
9,127115751,5712,LOC100129034,1,,127121463
10,38464598,38675,LOC100129055,1,,38503273
14,56042874,3936,KTN1-AS1,1,,56046810
1,104615644,4049,LOC100129138,1,,104619693
2,219866936,13508,LOC100129175,1,,219880444
6,28089572,15522,ZSCAN16-AS1,1,,28105094
1,31191618,7975,MATN1-AS1,1,,31199593
11,94963349,4219,LOC100129203,1,,94967568
10,18290714,8777,SLC39A12-AS1,1,,18299491
1,112141628,9312,LINC01160,1,,112150940
14,98098983,54012,LOC100129345,1,,98152995
7,102781716,1134,RPL19P12,1,,102782850
7,50599456,11705,DDC-AS1,1,,50611161
3,12581279,5684,MKRN2OS,1,,12586963
1,2281852,2248,LOC100129534,1,,2284100
19,23299776,30238,ZNF730,1,,23330014
X,137794268,4495,FGF13-AS1,1,,137798763
5,90676163,40369,ARRDC3-AS1,1,,90716532
9,140144670,3279,C9orf173-AS1,1,,140147949
2,43454349,1645,LINC01126,1,,43455994
7,100187023,14638,PCOLCE-AS1,1,,100201661
4,141204879,89667,SCOC-AS1,1,,141294546
4,773936,1700,LOC100129917,1,,775636
19,40129324,3717,LOC100129935,1,,40133041
12,69198216,1058,LOC100130075,1,,69199274
1,47139707,18062,EFCAB14-AS1,1,,47157769
8,126953375,10066,LINC00861,1,,126963441
20,19222945,42295,LOC100130264,1,,19265240
8,61878679,1628,LOC100130298,1,,61880307
8,74153658,18079,C8orf89,1,,74171737
1,238025474,66145,LOC100130331,1,,238091619
11,64855843,738,TMEM262,1,,64856581
6,13279526,16292,LOC100130357,1,,13295818
13,114451483,2579,LINC00552,1,,114454062
2,241388835,7282,PP14571,1,,241396117
16,34739458,2083,LOC100130700,1,,34741541
22,17640278,6057,CECR5-AS1,1,,17646335
7,137638093,4619,LOC100130880,1,,137642712
16,70788962,18192,VAC14-AS1,1,,70807154
X,151895977,7159,CSAG4,1,,151903136
9,138466770,12188,LINC01502,1,,138478958
16,77233348,13628,SYCE1L,1,,77246976
6,159309618,21767,C6orf99,1,,159331385
10,22541000,6477,LOC100130992,1,,22547477
14,103653557,1808,LINC00605,1,,103655365
11,33719653,2633,C11orf91,1,,33722286
2,175199820,2448,SP9,1,,175202268
20,45947245,2253,LOC100131496,1,,45949498
11,71525090,7503,ZNF705E,1,,71532593
1,93775665,35703,LOC100131564,1,,93811368
11,118251934,37596,LOC100131626,1,,118289530
3,187420153,30050,LOC100131635,1,,187450203
12,109489845,1925,USP30-AS1,1,,109491770
21,31661462,370,KRTAP25-1,1,,31661832
9,97094757,28473,LOC100132077,1,,97123230
11,111284966,3945,LOC100132078,1,,111288911
15,23390721,3222,HERC2P7,1,,23393943
8,7812534,53743,FAM66E,1,,7866277
1,151810944,5697,LOC100132111,1,,151816641
3,46653924,14109,LOC100132146,1,,46668033
X,18908413,4680,PHKA2-AS1,1,,18913093
2,63271099,3747,LOC100132215,1,,63274846
5,180750506,4690,LOC100132287,1,,180755196
X,49306324,7386,GAGE12D,1,,49313710
3,13974552,3892,FGD5P1,1,,13978444
16,71599691,6650,TAT-AS1,1,,71606341
1,71512188,20677,ZRANB2-AS1,1,,71532865
3,49586738,5061,BSN-AS2,1,,49591799
15,51236325,2437,DCAF13P3,1,,51238762
6,140092209,89399,LOC100132735,1,,140181608
1,44165408,7604,KDM4A-AS1,1,,44173012
9,99631181,3329,LOC100132781,1,,99634510
20,61475917,1626,DPH3P1,1,,61477543
5,63986134,27883,FAM159B,1,,64014017
7,76178657,78642,LOC100133091,1,,76257299
10,49203372,4453,FAM25G,1,,49207825
9,67792928,1261,FAM27B,1,,67794189
6,26924771,66982,LINC00240,1,,26991753
8,56361756,6125,SBF1P1,1,,56367881
8,7636112,2823,PRR23D2,1,,7638935
21,37441939,56999,LOC100133286,1,,37498938
5,180750506,4690,LOC100133331,1,,180755196
4,3675319,4263,LOC100133461,1,,3679582
11,2004438,6712,MRPL23-AS1,1,,2011150
1,3816967,15044,LINC01134,1,,3832011
8,144063447,36360,LOC100133669,1,,144099807
X,47518231,1279,UXT-AS1,1,,47519510
2,70351167,1281,LOC100133985,1,,70352448
20,3087556,43957,UBOX5-AS1,1,,3131513
7,139877060,2380,JHDM1D-AS1,1,,139879440
2,47055002,31143,LINC01119,1,,47086145
16,432240,10720,LOC100134368,1,,442960
20,25990434,13469,LOC100134868,1,,26003903
2,155292364,21586,LOC100144595,1,,155313950
22,51021454,906,CHKB-AS1,1,,51022360
21,31992945,224,KRTAP20-4,1,,31993169
X,20154183,348,SCARNA9L,1,,20154531
10,127262939,4075,TEX36-AS1,1,,127267014
19,50631658,121,SNAR-A3,1,,50631779
19,50631658,121,SNAR-A5,1,,50631779
19,50631658,121,SNAR-A7,1,,50631779
19,50631658,121,SNAR-A11,1,,50631779
19,50631658,121,SNAR-A9,1,,50631779
19,50631658,121,SNAR-A4,1,,50631779
19,50631658,121,SNAR-A6,1,,50631779
19,50631658,121,SNAR-A8,1,,50631779
19,48448178,122,SNAR-A13,1,,48448300
19,50631658,121,SNAR-A10,1,,50631779
19,50642374,120,SNAR-B2,1,,50642494
19,48416307,120,SNAR-C2,1,,48416427
19,48442797,120,SNAR-C4,1,,48442917
2,78182032,120,SNAR-H,1,,78182152
19,48432074,120,SNAR-C5,1,,48432194
19,50642374,120,SNAR-B1,1,,50642494
19,48416307,120,SNAR-C1,1,,48416427
19,48453552,119,SNAR-C3,1,,48453671
19,50643458,119,SNAR-D,1,,50643577
19,49534925,119,SNAR-G2,1,,49535044
19,41949062,1608,ERICH4,1,,41950670
13,30914402,33649,LINC00426,1,,30948051
10,101686965,31790,DNMBP-AS1,1,,101718755
2,74612844,8164,DCTN1-AS1,1,,74621008
1,151810338,2695,C2CD4D,1,,151813033
19,50631658,121,SNAR-A14,1,,50631779
10,15196720,626,PPIAP30,1,,15197346
18,8360817,6215,LOC100192426,1,,8367032
12,54495992,491,LOC100240734,1,,54496483
12,54472622,2985,LOC100240735,1,,54475607
6,26987144,941,LOC100270746,1,,26988085
12,2038367,7375,LINC00940,1,,2045742
2,33152193,19009,LOC100271832,1,,33171202
2,234662961,1030,LOC100286922,1,,234663991
16,61554,2536,DDX11L10,1,,64090
17,73267379,2597,LOC100287042,1,,73269976
8,145660550,4726,LOC100287098,1,,145665276
13,19919188,1701,LINC00421,1,,19920889
12,27915598,8611,MANSC4,1,,27924209
15,73075175,15365,ADPGK-AS1,1,,73090540
5,50265050,971,LOC100287592,1,,50266021
9,11986,2539,DDX11L5,1,,14525
6,119103870,711,LOC100287632,1,,119104581
6,46714653,12301,ANKRD66,1,,46726954
7,62856717,2702,LOC100287834,1,,62859419
1,236686368,1440,LGALS8-AS1,1,,236687808
1,181205523,2217,GM140,1,,181207740
1,700244,13824,LOC100288069,1,,714068
1,185292978,11193,GS1-279B7.1,1,,185304171
1,144146810,2320934,NBPF20,1,,146467744
6,79943390,3127,HMGN3-AS1,1,,79946517
15,32812048,13894,WHAMMP1,1,,32825942
13,28710979,2332,PAN3-AS1,1,,28713311
X,9935397,645,LOC100288814,1,,9936042
14,39734906,1359,LOC100288846,1,,39736265
16,28890277,965,ATP2A1-AS1,1,,28891242
9,38540563,4806,FAM95C,1,,38545369
19,12305829,12562,LOC100289333,1,,12318391
16,88797587,10246,LOC100289580,1,,88807833
19,43326014,5016,LOC100289650,1,,43331030
15,29033388,1150,LOC100289656,1,,29034538
5,109218882,2318,LOC100289673,1,,109221200
17,78325630,63338,LOC100294362,1,,78388968
6,137303295,11073,NHEG1,1,,137314368
1,178060642,2486,RASAL2-AS1,1,,178063128
Y,20551155,15777,FAM41AY2,1,,20566932
2,10586839,136,SNORA80B,1,,10586975
5,76008227,486,NCRUPAR,1,,76008713
2,145277180,1285,ZEB2-AS1,1,,145278465
5,65240632,769,LOC100303749,1,,65241401
15,49448494,2328,NDUFAF4P1,1,,49450822
7,102290771,11076,SPDYE2B,1,,102301847
7,6071006,5177,ANKRD61,1,,6076183
2,206980296,1000,GCSHP3,1,,206981296
12,69021013,142,SNORA70G,1,,69021155
16,71732469,135,SNORA70D,1,,71732604
11,82752505,135,SNORA70E,1,,82752640
1,163390859,2122,LOC100422212,1,,163392981
6,107165326,69974,LOC100422737,1,,107235300
3,156807669,11255,LINC00881,1,,156818924
2,114735245,2316,LOC100499194,1,,114737561
11,119252487,117457,USP2-AS1,1,,119369944
12,9392598,3047,LINC00987,1,,9395645
9,100000707,58889,LOC100499484,1,,100059596
8,96959212,1364,LOC100500773,1,,96960576
18,53750586,54181,LINC01539,1,,53804767
9,117428713,15656,LOC100505478,1,,117444369
7,151574126,2182,PRKAG2-AS1,1,,151576308
13,78393071,89492,EDNRB-AS1,1,,78482563
20,13218066,2268,ISM1-AS1,1,,13220334
16,52116976,2045,LINC00919,1,,52119021
15,40985952,1351,RAD51-AS1,1,,40987303
5,140937877,6950,LOC100505658,1,,140944827
8,67104348,5206,LINC00967,1,,67109554
20,38633102,4069,LINC01370,1,,38637171
5,110847923,227500,STARD4-AS1,1,,111075423
16,54073304,981,FTO-IT1,1,,54074285
19,44395955,10000,LOC100505715,1,,44405955
2,28530557,2769,LOC100505716,1,,28533326
17,39558667,10173,LOC100505782,1,,39568840
5,117618268,2204,LOC100505811,1,,117620472
18,70992175,24949,LOC100505817,1,,71017124
20,43592439,2660,STK4-AS1,1,,43595099
5,10440846,1117,ROPN1L-AS1,1,,10441963
7,77313167,13495,APTR,1,,77326662
4,79892901,337052,LINC01088,1,,80229953
5,86042634,2955,LOC100505878,1,,86045589
1,6784804,5268,LOC100505887,1,,6790072
4,20393811,2668,SLIT2-IT1,1,,20396479
1,168369426,22468,LOC100505918,1,,168391894
7,7989469,18914,LOC100505921,1,,8008383
16,67551608,11040,LOC100505942,1,,67562648
2,4005244,16378,LINC01304,1,,4021622
12,107074535,3943,LOC100505978,1,,107078478
2,161114229,14177,LOC100505984,1,,161128406
9,140065379,1119,TMEM210,1,,140066498
1,9485152,3903,LOC100506022,1,,9489055
7,16250110,60119,ISPD-AS1,1,,16310229
19,50341902,13031,PTOV1-AS1,1,,50354933
4,80413746,83868,LINC00989,1,,80497614
7,63484795,5685,LINC01005,1,,63490480
2,3605975,3365,RNASEH1-AS1,1,,3609340
16,70253483,6453,SMG1P7,1,,70259936
19,47164734,9864,DACT3-AS1,1,,47174598
2,98081675,13149,LOC100506076,1,,98094824
16,70349542,31108,LOC100506083,1,,70380650
9,131486740,8782,LOC100506100,1,,131495522
2,45167292,1354,SIX3-AS1,1,,45168646
4,171961752,18559,LOC100506122,1,,171980311
10,120116619,2096,LINC00867,1,,120118715
7,96250968,42682,LOC100506136,1,,96293650
2,46795395,11982,LOC100506142,1,,46807377
12,10089177,6917,LOC100506159,1,,10096094
6,57125321,2823,LOC100506188,1,,57128144
11,565656,2801,MIR210HG,1,,568457
11,82783107,1647,RAB30-AS1,1,,82784754
2,7561391,28990,LOC100506274,1,,7590381
11,13001080,10015,LINC00958,1,,13011095
14,65556635,4394,LOC100506321,1,,65561029
21,35303425,40062,LINC00649,1,,35343487
1,112282462,7958,FAM212B-AS1,1,,112290420
11,86666662,45327,LOC100506368,1,,86711989
17,33614,3428,LOC100506371,1,,37042
20,58201518,1826,LOC100506384,1,,58203344
21,36118121,39047,LINC01426,1,,36157168
1,113499036,7654,SLC16A1-AS1,1,,113506690
12,20167618,84184,LOC100506393,1,,20251802
13,114567149,2656,GAS6-AS2,1,,114569805
9,26066672,51734,LOC100506422,1,,26118406
14,48234155,30062,LINC00648,1,,48264217
1,226843780,18989,ITPKB-IT1,1,,226862769
4,56232767,18980,SRD5A3-AS1,1,,56251747
19,36031639,5292,TMEM147-AS1,1,,36036931
2,13106907,40231,LOC100506474,1,,13147138
5,38556887,52072,LIFR-AS1,1,,38608959
7,30430500,13170,LINC01176,1,,30443670
5,61028616,2909,LOC100506526,1,,61031525
11,18621350,10452,SPTY2D1-AS1,1,,18631802
3,110764162,24644,PVRL3-AS1,1,,110788806
4,57396774,72715,THEGL,1,,57469489
3,112315640,5176,LINC01279,1,,112320816
16,25151891,8462,LCMT1-AS2,1,,25160353
12,31173696,53085,DDX11-AS1,1,,31226781
17,31856805,3974,AA06,1,,31860779
7,127116936,8922,LOC100506682,1,,127125858
5,987291,10164,LOC100506688,1,,997455
13,24043650,17953,LINC00327,1,,24061603
4,87846045,9957,LOC100506746,1,,87856002
3,118661922,5166,IGSF11-AS1,1,,118667088
10,50504327,2611,C10orf71-AS1,1,,50506938
2,176999568,2258,HOXD-AS2,1,,177001826
1,234663636,3889,LINC01354,1,,234667525
6,75994729,6851,LOC100506804,1,,76001580
3,123304359,45307,MYLK-AS1,1,,123349666
9,89563612,53336,LOC100506834,1,,89616948
10,44354858,36023,LINC00840,1,,44390881
3,51851618,2033,IQCF4,1,,51853651
7,130598222,8483,LOC100506860,1,,130606705
18,44548657,1877,TCEB3CL2,1,,44550534
3,126111874,1767,CCDC37-AS1,1,,126113641
10,54056607,17281,PRKG1-AS1,1,,54073888
3,196729776,1839,MFI2-AS1,1,,196731615
3,63989697,8220,PSMD6-AS2,1,,63997917
3,197025117,5504,DLG1-AS1,1,,197030621
12,123565930,3361,LOC100507091,1,,123569291
4,107279339,9253,GIMD1,1,,107288592
13,32598195,7581,FRY-AS1,1,,32605776
8,131094983,2031,ASAP1-IT2,1,,131097014
10,6821559,63309,LINC00707,1,,6884868
13,36920567,23305,SPG20-AS1,1,,36943872
2,201577027,22873,LOC100507140,1,,201599900
10,8301294,8974,LINC00708,1,,8310268
10,9317575,11444,LINC00709,1,,9329019
X,120111460,3318,CT47A12,1,,120114778
6,27661857,15079,LINC01012,1,,27676936
12,127221552,9248,LINC00943,1,,127230800
17,74136636,14093,RNF157-AS1,1,,74150729
6,132455117,35397,LINC01013,1,,132490514
5,169618650,7495,LINC01187,1,,169626145
3,137490752,8967,LINC01210,1,,137499719
11,43930838,11656,ALKBH3-AS1,1,,43942494
2,111003214,20921,LOC100507334,1,,111024135
17,75543022,18081,LOC100507351,1,,75561103
3,194429149,73748,LOC100507391,1,,194502897
11,128561566,4352,SENCR,1,,128565918
13,52027480,1371,INTS6-AS1,1,,52028851
11,46867961,28006,LRP4-AS1,1,,46895967
17,77015290,8447,C1QTNF1-AS1,1,,77023737
1,47004367,31560,MKNK1-AS1,1,,47035927
12,2945981,22980,LOC100507424,1,,2968961
13,54698458,8548,LINC00458,1,,54707006
19,38039850,38398,ZNF571-AS1,1,,38078248
8,1513675,56155,DLGAP2-AS1,1,,1569830
2,208983852,37634,LOC100507443,1,,209021486
10,87337487,29485,GRID1-AS1,1,,87366972
6,143287558,71161,LINC01277,1,,143358719
7,55247442,9200,EGFR-AS1,1,,55256642
16,4295825,7965,LINC01569,1,,4303790
6,4136305,21314,LOC100507506,1,,4157619
3,153742189,96810,ARHGEF26-AS1,1,,153838999
4,136788137,21111,LINC00613,1,,136809248
13,95364969,3230,SOX21-AS1,1,,95368199
6,146136011,71710,LOC100507557,1,,146207721
1,53704281,4174,LOC100507564,1,,53708455
19,8439259,16316,RAB11B-AS1,1,,8455575
16,48389595,7315,LOC100507577,1,,48396910
3,4938492,83154,BHLHE40-AS1,1,,5021646
19,7981031,2949,TGFBR3L,1,,7983980
16,5083702,9270,NAGPA-AS1,1,,5092972
2,136577760,2897,LOC100507600,1,,136580657
5,180688212,3355,TRIM52-AS1,1,,180691567
20,5412602,13792,LINC00658,1,,5426394
10,93542595,15358,TNKS2-AS1,1,,93557953
1,55681080,2048,LOC100507634,1,,55683128
8,58130834,14679,LOC100507651,1,,58145513
10,94178417,946,MARK2P9,1,,94179363
13,46626982,48500,CPB2-AS1,1,,46675482
9,103204187,135731,MSANTD3-TMEFF1,1,,103339918
20,44164918,11147,EPPIN-WFDC6,1,,44176065
6,8013799,89029,EEF1E1-BLOC1S5,1,,8102828
20,35202956,38004,TGIF2-C20orf24,1,,35240960
15,80135888,79560,ST20-MTHFS,1,,80215448
12,89913189,6850,POC1B-GALNT4,1,,89920039
20,1290554,83262,FKBP1A-SDCBP2,1,,1373816
11,77726760,64505,NDUFC2-KCTD14,1,,77791265
10,22605311,15103,COMMD3-BMI1,1,,22620414
1,19923470,61479,MINOS1-NBL1,1,,19984949
X,15363712,145720,PIR-FIGF,1,,15509432
17,39458077,1026,KRTAP29-1,1,,39459103
Y,23544859,3387,PRORY,1,,23548246
10,98912798,139632,ARHGAP19-SLIT1,1,,99052430
17,3566186,33512,P2RX5-TAX1BP3,1,,3599698
1,151129104,13669,TNFAIP8L2-SCNM1,1,,151142773
20,57226308,64592,STX16-NPEPL1,1,,57290900
5,33987090,137543,C1QTNF3-AMACR,1,,34124633
21,33452793,5815,LINC00159,1,,33458608
3,64053639,35168,PRICKLE2-AS1,1,,64088807
18,29122108,14766,DSG2-AS1,1,,29136874
13,19479578,21303,LINC00408,1,,19500881
17,6561037,3664,ALOX15P1,1,,6564701
19,35382932,6915,LINC00904,1,,35389847
10,6816264,4878,LINC00706,1,,6821142
12,53907767,3625,LOC100652999,1,,53911392
7,23140846,4476,KLHL7-AS1,1,,23145322
3,177012229,28994,LINC00501,1,,177041223
5,38282370,8718,EGFLAM-AS4,1,,38291088
8,116962735,374562,LINC00536,1,,117337297
1,214098091,1905,LINC00538,1,,214099996
21,45870868,4299,LRRC3-AS1,1,,45875167
7,37037400,15835,ELMO1-AS1,1,,37053235
20,36247699,3822,LINC00489,1,,36251521
6,167317185,1372,RPS6KA2-AS1,1,,167318557
13,99738976,1903,DOCK9-AS2,1,,99740879
13,100647153,3010,LINC00554,1,,100650163
13,114629486,2478,LINC00565,1,,114631964
12,128399954,36143,LINC00507,1,,128436097
21,47882383,6835,DIP2A-IT1,1,,47889218
13,48870648,7149,LINC00441,1,,48877797
1,11203954,5641,MTOR-AS1,1,,11209595
3,193336387,8734,OPA1-AS1,1,,193345121
X,22180848,10252,PHEX-AS1,1,,22191100
1,108507064,30165,VAV3-AS1,1,,108537229
13,48651272,2857,MED4-AS1,1,,48654129
2,167979318,18147,XIRP2-AS1,1,,167997465
11,19524219,4557,NAV2-AS5,1,,19528776
3,188956474,1909,TPRG1-AS2,1,,188958383
3,113122844,29995,CFAP44-AS1,1,,113152839
4,139230864,114634,LINC00499,1,,139345498
2,74185094,23472,DGUOK-AS1,1,,74208566
2,11534106,9097,LINC00570,1,,11543203
Y,16905521,10392,NLGN4Y-AS1,1,,16915913
17,13932608,40167,COX10-AS1,1,,13972775
13,30446749,15793,LINC00297,1,,30462542
13,100342351,874,CLYBL-AS2,1,,100343225
13,51381990,42051,DLEU7-AS1,1,,51424041
13,47426274,4160,HTR2A-AS1,1,,47430434
3,11047783,13127,SLC6A1-AS1,1,,11060910
3,149095564,8806,TM4SF1-AS1,1,,149104370
21,40687632,7512,BRWD1-AS1,1,,40695144
3,42774066,12584,CCDC13-AS1,1,,42786650
22,29420986,6478,ZNRF3-AS1,1,,29427464
13,79361453,52732,LINC00331,1,,79414185
13,85937737,181060,LINC00351,1,,86118797
13,90201047,15620,LINC00353,1,,90216667
13,62577657,26024,LINC00358,1,,62603681
13,31377342,7440,LINC00398,1,,31384782
13,19312239,2000,LINC00417,1,,19314239
10,92805564,16352,LINC00502,1,,92821916
13,90712500,59471,LINC00559,1,,90771971
13,38624953,92416,LINC00571,1,,38717369
13,60586851,31639,DIAPH3-AS1,1,,60618490
13,60718831,8808,DIAPH3-AS2,1,,60727639
22,43912133,20352,EFCAB6-AS1,1,,43932485
11,70477198,4397,SHANK2-AS1,1,,70481595
13,77649648,12263,MYCBP2-AS1,1,,77661911
12,2329702,2945,CACNA1C-AS4,1,,2332647
3,54908631,26651,CACNA2D3-AS1,1,,54935282
12,31742856,25429,DENND5B-AS1,1,,31768285
1,47644921,1090,LINC00853,1,,47646011
2,70694516,14256,TGFA-IT1,1,,70708772
6,53863687,8263,MLIP-IT1,1,,53871950
3,178136988,38105,LINC01014,1,,178175093
6,166874150,4721,RPS6KA2-IT1,1,,166878871
17,46621712,6891,HOXB-AS1,1,,46628603
12,54329111,4316,HOXC13-AS,1,,54333427
13,108439708,48098,FAM155A-IT1,1,,108487806
13,101360578,351060,NALCN-AS1,1,,101711638
13,109816252,3399,MYO16-AS1,1,,109819651
3,45524186,26851,LARS2-AS1,1,,45551037
3,143061087,4826,SLC9A9-AS1,1,,143065913
14,36604915,40942,PTCSC3,1,,36645857
13,52741844,26758,MRPS31P5,1,,52768602
13,97593534,42892,LINC00359,1,,97636426
7,112258119,2585,LOC100996249,1,,112260704
1,113554308,61416,LOC100996251,1,,113615724
15,32828959,43851,LOC100996255,1,,32872810
17,76480991,18147,DNAH17-AS1,1,,76499138
22,17602484,10510,LOC100996342,1,,17612994
3,158263008,25847,LOC100996447,1,,158288855
3,181670151,58313,LINC01206,1,,181728464
10,47590260,50584,ANTXRLP1,1,,47640844
2,162101249,4312,LOC100996579,1,,162105561
3,16577824,5056,LINC00690,1,,16582880
7,54827005,45651,LOC100996654,1,,54872656
18,59415408,6520,LINC01544,1,,59421928
2,220361076,1933,LOC100996693,1,,220363009
10,47086724,1449,LOC100996758,1,,47088173
4,123540137,70174,IL21-AS1,1,,123610311
11,100999807,30194,LOC101054525,1,,101030001
12,29542226,75637,OVCH1-AS1,1,,29617863
16,18411775,14744,NPIPA7,1,,18426519
16,18411775,14744,NPIPA8,1,,18426519
2,114588759,59810,LOC101060091,1,,114648569
14,36539632,94862,LINC00609,1,,36634494
17,10633093,37276,TMEM220-AS1,1,,10670369
14,19670791,10225,BMS1P17,1,,19681016
16,86259185,60668,LINC01081,1,,86319853
6,36641397,1506,PANDAR,1,,36642903
5,61874561,49855,IPO11-LRRC70,1,,61924416
X,148958632,49967,LINC00850,1,,149008599
8,79635082,1527,LOC101241902,1,,79636609
3,161144214,21816,LOC101243545,1,,161166030
13,110380620,1761,LINC00676,1,,110382381
8,12651751,24049,LINC00681,1,,12675800
2,190627505,2777,OSGEPL1-AS1,1,,190630282
20,61431978,4961,OGFR-AS1,1,,61436939
11,27639172,17002,LINC00678,1,,27656174
3,194868599,4986,XXYLT1-AS2,1,,194873585
2,38177476,86008,RMDN2-AS1,1,,38263484
4,98288076,123239,STPG2-AS1,1,,98411315
9,137711260,53204,LOC101448202,1,,137764464
22,24666784,171544,SPECC1L-ADORA2A,1,,24838328
1,58326214,2572,DAB1-AS1,1,,58328786
9,34985408,3968,DNAJB5-AS1,1,,34989376
5,140425789,31820,LOC101926905,1,,140457609
15,91565851,8518,LOC101926911,1,,91574369
15,92006568,31512,LOC101926928,1,,92038080
14,23398817,25084,LOC101926933,1,,23423901
5,39520532,4278,LOC101926940,1,,39524810
20,25936447,13477,LOC101926955,1,,25949924
2,15830905,28180,LOC101926966,1,,15859085
22,38037838,16546,LOC101927051,1,,38054384
2,97584842,6732,LOC101927053,1,,97591574
12,43009304,30996,LOC101927058,1,,43040300
14,27244700,46626,LOC101927062,1,,27291326
5,44388833,25258,FGF10-AS1,1,,44414091
5,151056505,10963,CTB-113P19.1,1,,151067468
5,114937851,18265,LOC101927100,1,,114956116
5,151338458,311552,LOC101927115,1,,151650010
20,39726633,40007,PLCG1-AS1,1,,39766640
11,56615953,29601,LOC101927120,1,,56645554
14,31889963,32126,LOC101927124,1,,31922089
3,70048894,15557,LINC01212,1,,70064451
13,78553900,15008,LINC01069,1,,78568908
2,186584600,19220,LOC101927196,1,,186603820
11,58901445,8836,LOC101927204,1,,58910281
3,633787,253911,LINC01266,1,,887698
2,186898260,52784,LINC01473,1,,186951044
20,43006382,17964,HNF4A-AS1,1,,43024346
20,43077416,1781,LINC01430,1,,43079197
7,77044514,10246,LOC101927243,1,,77054760
22,40917803,4908,LOC101927257,1,,40922711
6,96023047,2280,MANEA-AS1,1,,96025327
2,242823513,197360,LINC01237,1,,243020873
3,79460876,23501,LOC101927374,1,,79484377
7,84161791,42368,LOC101927378,1,,84204159
3,7994491,63503,LOC101927394,1,,8057994
12,124065612,3262,LOC101927415,1,,124068874
2,195595318,30841,LOC101927431,1,,195626159
2,65073263,17502,LOC101927438,1,,65090765
9,81750337,10244,LOC101927450,1,,81760581
5,124828953,108967,LOC101927460,1,,124937920
X,45364632,21852,LINC01204,1,,45386484
20,48789106,4102,LINC01273,1,,48793208
20,48927247,10632,LINC01271,1,,48937879
12,127399773,145169,LOC101927592,1,,127544942
3,136560817,20088,NCK1-AS1,1,,136580905
12,127808699,15918,LOC101927616,1,,127824617
2,200472790,51065,LOC101927641,1,,200523855
4,146418200,5932,SMAD1-AS2,1,,146424132
11,2349978,49244,CD81-AS1,1,,2399222
20,51237376,29589,LINC01524,1,,51266965
16,66503698,6607,BEAN1-AS1,1,,66510305
5,158527490,16996,LOC101927740,1,,158544486
7,100951587,3032,LOC101927746,1,,100954619
7,20336330,15005,LOC101927769,1,,20351335
20,52169308,22539,LOC101927770,1,,52191847
2,201645217,31676,LOC101927795,1,,201676893
20,54036873,6862,LINC01441,1,,54043735
21,19933582,198548,LOC101927797,1,,20132130
5,162909609,11455,HMMR-AS1,1,,162921064
5,163875427,18981,LOC101927835,1,,163894408
21,23381476,89302,LOC101927843,1,,23470778
7,103085653,68801,LOC101927870,1,,103154454
12,68102826,20429,LOC101927901,1,,68123255
2,77213090,23824,LOC101927907,1,,77236914
7,157258924,33486,LOC101927914,1,,157292410
2,78315855,39077,LOC101927948,1,,78354932
5,134374520,1217,C5orf66-AS1,1,,134375737
2,132394597,12591,LINC01087,1,,132407188
12,70107412,24936,LOC101928002,1,,70132348
7,112262435,85687,LOC101928012,1,,112348122
2,210894645,34435,LOC101928020,1,,210929080
3,149983193,58341,LINC01214,1,,150041534
14,71075514,32501,LOC101928075,1,,71108015
1,95123088,162749,LINC01057,1,,95285837
2,215674952,153377,LOC101928103,1,,215828329
21,34484009,11997,LOC101928107,1,,34496006
5,173134601,38611,LINC01484,1,,173173212
12,73552969,49128,LOC101928137,1,,73602097
3,151468966,176997,AADACL2-AS1,1,,151645963
16,79804367,30873,LINC01229,1,,79835240
7,124869632,34713,LOC101928254,1,,124904345
7,126855180,14795,LOC101928333,1,,126869975
2,144694633,27089,LOC101928386,1,,144721722
7,56601922,3901,LOC101928401,1,,56605823
17,12575178,34274,LOC101928418,1,,12609452
21,40346354,3346,LOC101928435,1,,40349700
1,103960700,107405,LOC101928436,1,,104068105
9,102348067,234104,LOC101928438,1,,102582171
12,82347497,39415,LOC101928449,1,,82386912
5,57186157,8832,LOC101928539,1,,57194989
5,57403458,14710,LOC101928569,1,,57418168
12,133609244,4564,LOC101928597,1,,133613808
20,62439428,14932,ZBTB46-AS1,1,,62454360
7,36134919,5343,LOC101928618,1,,36140262
5,60458142,69765,CTC-436P18.1,1,,60527907
12,27542721,56846,ARNTL2-AS1,1,,27599567
5,180673540,11047,CTC-338M12.4,1,,180684587
5,60958984,35275,LOC101928651,1,,60994259
12,94101566,30033,LOC101928731,1,,94131599
3,179615981,23706,LOC101928790,1,,179639687
14,88484948,7708,LOC101928791,1,,88492656
9,120410883,8421,LOC101928797,1,,120419304
5,1173210,5510,CTD-3080P12.3,1,,1178720
14,91108972,6260,LOC101928909,1,,91115232
12,99487136,11653,LOC101928937,1,,99498789
3,184474176,16767,LOC101928992,1,,184490943
3,51907611,2172,IQCF5-AS1,1,,51909783
20,1614153,14966,SIRPG-AS1,1,,1629119
6,92338757,61389,CASC6,1,,92400146
12,103941571,12022,LOC101929084,1,,103953593
7,47661536,7955,LINC01447,1,,47669491
5,4773593,1385,LOC101929153,1,,4774978
8,21155749,11211,LOC101929172,1,,21166960
5,79362171,17317,CTD-2201I18.1,1,,79379488
8,49464126,146943,LOC101929268,1,,49611069
5,8839843,41793,LOC101929284,1,,8881636
11,94883702,8610,LOC101929295,1,,94892312
2,152194341,41544,LOC101929319,1,,152235885
5,9511444,6754,CTD-2201E9.1,1,,9518198
14,101433988,18999,SNHG24,1,,101452987
22,18062922,9036,LOC101929372,1,,18071958
2,6506141,9413,LINC01247,1,,6515554
20,10855980,33940,LOC101929413,1,,10889920
2,7202857,15154,LOC101929452,1,,7218011
5,15191754,74915,LOC101929454,1,,15266669
5,16616034,14044,LOC101929524,1,,16630078
20,18655038,24314,LOC101929526,1,,18679352
8,59168329,16331,LOC101929528,1,,59184660
2,8026897,12889,LOC101929551,1,,8039786
2,163625445,29037,LOC101929570,1,,163654482
20,21175043,23884,KIZ-AS1,1,,21198927
3,107149776,32983,LOC101929607,1,,107182759
20,21550661,45699,LOC101929625,1,,21596360
11,131403750,7011,LOC101929653,1,,131410761
13,52703030,3829,LOC101929657,1,,52706859
5,29380195,15888,LOC101929681,1,,29396083
20,22568159,19996,LINC01384,1,,22588155
3,112455295,12871,LOC101929694,1,,112468166
5,38693314,152617,OSMR-AS1,1,,38845931
1,145289769,80534,NBPF25P,1,,145370303
1,149514089,167,RNVU1-19,1,,149514256
10,32636291,27125,LOC102031319,1,,32663416
3,50374941,786,RASSF1-AS1,1,,50375727
12,53858251,590,PCBP2-OT1,1,,53858841
11,62430288,2400,C11orf98,1,,62432688
5,40052392,1034,LINC00603,1,,40053426
16,79755208,49221,LOC102467146,1,,79804429
5,55753621,23975,LOC102467147,1,,55777596
5,111964132,2486,LOC102467214,1,,111966618
5,117066055,535702,LOC102467224,1,,117601757
5,117931882,31905,LOC102467225,1,,117963787
5,71852903,14666,LOC102503427,1,,71867569
5,80243511,13215,RASGRF2-AS1,1,,80256726
5,87704798,30109,LOC102546226,1,,87734907
5,96840399,166356,LINC01340,1,,97006755
5,125515269,14274,LOC102546228,1,,125529543
5,133764741,5997,LOC102546229,1,,133770738
5,176170205,717,LINC01574,1,,176170922
20,12915525,2086,LOC102606466,1,,12917611